FID,Geocodigo,Nome,MoradDPPOColetDomicServLimpTot,MoradDPPOColetTot,MoradDPPODepCacambServLimpTot,MoradDPPOTot,PercMoradDPPOColetDomicServLimpTot,PercMoradDPPOColetTot,PercMoradDPPODepCacambServLimpTot
sidra_9541_PercMoradDPPOColetTot_munic_22_pol.fid-703dc0a5_191866d88cb_-1a9e,1100023,Ariquemes - RO,86646,86935,289,96152,90.11,90.41,0.3
sidra_9541_PercMoradDPPOColetTot_munic_22_pol.fid-703dc0a5_191866d88cb_-1a9d,1100031,Cabixi - RO,3185,3191,6,5351,59.52,59.63,0.11
sidra_9541_PercMoradDPPOColetTot_munic_22_pol.fid-703dc0a5_191866d88cb_-1a9c,1100049,Cacoal - RO,71431,73286,1855,86494,82.58,84.73,2.14
sidra_9541_PercMoradDPPOColetTot_munic_22_pol.fid-703dc0a5_191866d88cb_-1a9b,1100056,Cerejeiras - RO,13090,13636,546,15798,82.86,86.31,3.46
sidra_9541_PercMoradDPPOColetTot_munic_22_pol.fid-703dc0a5_191866d88cb_-1a9a,1100015,Alta Floresta D'Oeste - RO,12350,12759,409,21440,57.6,59.51,1.91
sidra_9541_PercMoradDPPOColetTot_munic_22_pol.fid-703dc0a5_191866d88cb_-1a99,1100064,Colorado do Oeste - RO,11903,11951,48,15663,75.99,76.3,0.31
sidra_9541_PercMoradDPPOColetTot_munic_22_pol.fid-703dc0a5_191866d88cb_-1a98,1100072,Corumbiara - RO,3566,3606,40,7503,47.53,48.06,0.53
sidra_9541_PercMoradDPPOColetTot_munic_22_pol.fid-703dc0a5_191866d88cb_-1a97,1100080,Costa Marques - RO,7507,7968,461,12526,59.93,63.61,3.68
sidra_9541_PercMoradDPPOColetTot_munic_22_pol.fid-703dc0a5_191866d88cb_-1a96,1100098,Espigão D'Oeste - RO,20893,21457,564,29329,71.24,73.16,1.92
sidra_9541_PercMoradDPPOColetTot_munic_22_pol.fid-703dc0a5_191866d88cb_-1a95,1100106,Guajará-Mirim - RO,28705,28901,196,38963,73.67,74.18,0.5
sidra_9541_PercMoradDPPOColetTot_munic_22_pol.fid-703dc0a5_191866d88cb_-1a94,1100114,Jaru - RO,39957,40114,157,50354,79.35,79.66,0.31
sidra_9541_PercMoradDPPOColetTot_munic_22_pol.fid-703dc0a5_191866d88cb_-1a93,1100122,Ji-Paraná - RO,113863,114776,913,123752,92.01,92.75,0.74
sidra_9541_PercMoradDPPOColetTot_munic_22_pol.fid-703dc0a5_191866d88cb_-1a92,1100130,Machadinho D'Oeste - RO,15350,16633,1283,30428,50.45,54.66,4.22
sidra_9541_PercMoradDPPOColetTot_munic_22_pol.fid-703dc0a5_191866d88cb_-1a90,1100148,Nova Brasilândia D'Oeste - RO,7289,7372,83,15674,46.5,47.03,0.53
sidra_9541_PercMoradDPPOColetTot_munic_22_pol.fid-703dc0a5_191866d88cb_-1a8f,1100155,Ouro Preto do Oeste - RO,27005,27793,788,34833,77.53,79.79,2.26
sidra_9541_PercMoradDPPOColetTot_munic_22_pol.fid-703dc0a5_191866d88cb_-1a8e,1100189,Pimenta Bueno - RO,29355,29751,396,34768,84.43,85.57,1.14
sidra_9541_PercMoradDPPOColetTot_munic_22_pol.fid-703dc0a5_191866d88cb_-1a8d,1100205,Porto Velho - RO,406477,420045,13568,457093,88.93,91.89,2.97
sidra_9541_PercMoradDPPOColetTot_munic_22_pol.fid-703dc0a5_191866d88cb_-1a8c,1100254,Presidente Médici - RO,12653,12801,148,19274,65.65,66.42,0.77
sidra_9541_PercMoradDPPOColetTot_munic_22_pol.fid-703dc0a5_191866d88cb_-1a8b,1100262,Rio Crespo - RO,1411,1462,51,3456,40.83,42.3,1.48
sidra_9541_PercMoradDPPOColetTot_munic_22_pol.fid-703dc0a5_191866d88cb_-1a8a,1100288,Rolim de Moura - RO,48322,48675,353,56137,86.08,86.71,0.63
sidra_9541_PercMoradDPPOColetTot_munic_22_pol.fid-703dc0a5_191866d88cb_-1a89,1100296,Santa Luzia D'Oeste - RO,3417,3657,240,7391,46.23,49.48,3.25
sidra_9541_PercMoradDPPOColetTot_munic_22_pol.fid-703dc0a5_191866d88cb_-1a88,1100304,Vilhena - RO,86922,90685,3763,95329,91.18,95.13,3.95
sidra_9541_PercMoradDPPOColetTot_munic_22_pol.fid-703dc0a5_191866d88cb_-1a87,1100320,São Miguel do Guaporé - RO,11560,11689,129,21548,53.65,54.25,0.6
sidra_9541_PercMoradDPPOColetTot_munic_22_pol.fid-703dc0a5_191866d88cb_-1a86,1100338,Nova Mamoré - RO,12001,12133,132,25363,47.32,47.84,0.52
sidra_9541_PercMoradDPPOColetTot_munic_22_pol.fid-703dc0a5_191866d88cb_-1a85,1100346,Alvorada D'Oeste - RO,7678,7827,149,13104,58.59,59.73,1.14
sidra_9541_PercMoradDPPOColetTot_munic_22_pol.fid-703dc0a5_191866d88cb_-1a84,1100379,Alto Alegre dos Parecis - RO,4861,4978,117,11460,42.42,43.44,1.02
sidra_9541_PercMoradDPPOColetTot_munic_22_pol.fid-703dc0a5_191866d88cb_-1a83,1100403,Alto Paraíso - RO,8469,8613,144,16289,51.99,52.88,0.88
sidra_9541_PercMoradDPPOColetTot_munic_22_pol.fid-703dc0a5_191866d88cb_-1a82,1100452,Buritis - RO,18833,19154,321,27827,67.68,68.83,1.15
sidra_9541_PercMoradDPPOColetTot_munic_22_pol.fid-703dc0a5_191866d88cb_-1a81,1100502,Novo Horizonte do Oeste - RO,3400,3440,40,7663,44.37,44.89,0.52
sidra_9541_PercMoradDPPOColetTot_munic_22_pol.fid-703dc0a5_191866d88cb_-1a80,1100601,Cacaulândia - RO,1920,1994,74,4145,46.32,48.11,1.79
sidra_9541_PercMoradDPPOColetTot_munic_22_pol.fid-703dc0a5_191866d88cb_-1a7f,1100700,Campo Novo de Rondônia - RO,2700,2736,36,8818,30.62,31.03,0.41
sidra_9541_PercMoradDPPOColetTot_munic_22_pol.fid-703dc0a5_191866d88cb_-1a7e,1100809,Candeias do Jamari - RO,14271,15662,1391,22282,64.05,70.29,6.24
sidra_9541_PercMoradDPPOColetTot_munic_22_pol.fid-703dc0a5_191866d88cb_-1a7d,1100908,Castanheiras - RO,1111,1165,54,3229,34.41,36.08,1.67
sidra_9541_PercMoradDPPOColetTot_munic_22_pol.fid-703dc0a5_191866d88cb_-1a7c,1100924,Chupinguaia - RO,6051,6151,100,9285,65.17,66.25,1.08
sidra_9541_PercMoradDPPOColetTot_munic_22_pol.fid-703dc0a5_191866d88cb_-1a7a,1100940,Cujubim - RO,9423,9531,108,14825,63.56,64.29,0.73
sidra_9541_PercMoradDPPOColetTot_munic_22_pol.fid-703dc0a5_191866d88cb_-1a79,1101005,Governador Jorge Teixeira - RO,2535,2558,23,7984,31.75,32.04,0.29
sidra_9541_PercMoradDPPOColetTot_munic_22_pol.fid-703dc0a5_191866d88cb_-1a77,1101104,Itapuã do Oeste - RO,5926,6021,95,8543,69.37,70.48,1.11
sidra_9541_PercMoradDPPOColetTot_munic_22_pol.fid-703dc0a5_191866d88cb_-1a76,1101203,Ministro Andreazza - RO,3074,3088,14,6466,47.54,47.76,0.22
sidra_9541_PercMoradDPPOColetTot_munic_22_pol.fid-703dc0a5_191866d88cb_-1a75,1101302,Mirante da Serra - RO,4874,4960,86,9235,52.78,53.71,0.93
sidra_9541_PercMoradDPPOColetTot_munic_22_pol.fid-703dc0a5_191866d88cb_-1a74,1101401,Monte Negro - RO,5262,5368,106,11516,45.69,46.61,0.92
sidra_9541_PercMoradDPPOColetTot_munic_22_pol.fid-703dc0a5_191866d88cb_-1a73,1101435,Nova União - RO,1683,1762,79,6180,27.23,28.51,1.28
sidra_9541_PercMoradDPPOColetTot_munic_22_pol.fid-703dc0a5_191866d88cb_-1a72,1101450,Parecis - RO,1485,1515,30,4078,36.41,37.15,0.74
sidra_9541_PercMoradDPPOColetTot_munic_22_pol.fid-703dc0a5_191866d88cb_-1a71,1101468,Pimenteiras do Oeste - RO,1331,1362,31,2108,63.14,64.61,1.47
sidra_9541_PercMoradDPPOColetTot_munic_22_pol.fid-703dc0a5_191866d88cb_-1a70,1101476,Primavera de Rondônia - RO,1969,1984,15,3076,64.01,64.5,0.49
sidra_9541_PercMoradDPPOColetTot_munic_22_pol.fid-703dc0a5_191866d88cb_-1a6f,1101484,São Felipe D'Oeste - RO,2105,2128,23,5256,40.05,40.49,0.44
sidra_9541_PercMoradDPPOColetTot_munic_22_pol.fid-703dc0a5_191866d88cb_-1a6e,1101492,São Francisco do Guaporé - RO,8457,9636,1179,16250,52.04,59.3,7.26
sidra_9541_PercMoradDPPOColetTot_munic_22_pol.fid-703dc0a5_191866d88cb_-1a6d,1101500,Seringueiras - RO,5164,5202,38,11158,46.28,46.62,0.34
sidra_9541_PercMoradDPPOColetTot_munic_22_pol.fid-703dc0a5_191866d88cb_-1a6c,1101559,Teixeirópolis - RO,1502,2101,599,4256,35.29,49.37,14.07
sidra_9541_PercMoradDPPOColetTot_munic_22_pol.fid-703dc0a5_191866d88cb_-1a6b,1101609,Theobroma - RO,2641,2758,117,8112,32.56,34,1.44
sidra_9541_PercMoradDPPOColetTot_munic_22_pol.fid-703dc0a5_191866d88cb_-1a6a,1101708,Urupá - RO,5216,5532,316,10722,48.65,51.59,2.95
sidra_9541_PercMoradDPPOColetTot_munic_22_pol.fid-703dc0a5_191866d88cb_-1a69,1101757,Vale do Anari - RO,3435,3497,62,7717,44.51,45.32,0.8
sidra_9541_PercMoradDPPOColetTot_munic_22_pol.fid-703dc0a5_191866d88cb_-1a67,1101807,Vale do Paraíso - RO,2514,2846,332,6473,38.84,43.97,5.13
sidra_9541_PercMoradDPPOColetTot_munic_22_pol.fid-703dc0a5_191866d88cb_-1a66,1200013,Acrelândia - AC,7626,7773,147,13978,54.56,55.61,1.05
sidra_9541_PercMoradDPPOColetTot_munic_22_pol.fid-703dc0a5_191866d88cb_-1a64,1200054,Assis Brasil - AC,4162,4815,653,8090,51.45,59.52,8.07
sidra_9541_PercMoradDPPOColetTot_munic_22_pol.fid-703dc0a5_191866d88cb_-1a62,1200104,Brasiléia - AC,16585,17081,496,25931,63.96,65.87,1.91
sidra_9541_PercMoradDPPOColetTot_munic_22_pol.fid-703dc0a5_191866d88cb_-1a61,1200138,Bujari - AC,4956,6133,1177,12917,38.37,47.48,9.11
sidra_9541_PercMoradDPPOColetTot_munic_22_pol.fid-703dc0a5_191866d88cb_-1a60,1200179,Capixaba - AC,4444,4538,94,10370,42.85,43.76,0.91
sidra_9541_PercMoradDPPOColetTot_munic_22_pol.fid-703dc0a5_191866d88cb_-1a5e,1200203,Cruzeiro do Sul - AC,22711,74164,51453,91147,24.92,81.37,56.45
sidra_9541_PercMoradDPPOColetTot_munic_22_pol.fid-703dc0a5_191866d88cb_-1a5d,1200252,Epitaciolândia - AC,10090,13196,3106,18739,53.84,70.42,16.58
sidra_9541_PercMoradDPPOColetTot_munic_22_pol.fid-703dc0a5_191866d88cb_-1a5c,1200302,Feijó - AC,16781,17531,750,35345,47.48,49.6,2.12
sidra_9541_PercMoradDPPOColetTot_munic_22_pol.fid-703dc0a5_191866d88cb_-1a5a,1200328,Jordão - AC,3452,3672,220,9201,37.52,39.91,2.39
sidra_9541_PercMoradDPPOColetTot_munic_22_pol.fid-703dc0a5_191866d88cb_-1a59,1200336,Mâncio Lima - AC,9189,12324,3135,19224,47.8,64.11,16.31
sidra_9541_PercMoradDPPOColetTot_munic_22_pol.fid-703dc0a5_191866d88cb_-1a58,1200344,Manoel Urbano - AC,5691,6093,402,11989,47.47,50.82,3.35
sidra_9541_PercMoradDPPOColetTot_munic_22_pol.fid-703dc0a5_191866d88cb_-1a57,1200351,Marechal Thaumaturgo - AC,155,6581,6426,17093,0.91,38.5,37.59
sidra_9541_PercMoradDPPOColetTot_munic_22_pol.fid-703dc0a5_191866d88cb_-1a55,1200385,Plácido de Castro - AC,10165,10513,348,16540,61.46,63.56,2.1
sidra_9541_PercMoradDPPOColetTot_munic_22_pol.fid-703dc0a5_191866d88cb_-1a54,1200393,Porto Walter - AC,1087,5124,4037,10735,10.13,47.73,37.61
sidra_9541_PercMoradDPPOColetTot_munic_22_pol.fid-703dc0a5_191866d88cb_-1a52,1200401,Rio Branco - AC,329118,342587,13469,361869,90.95,94.67,3.72
sidra_9541_PercMoradDPPOColetTot_munic_22_pol.fid-703dc0a5_191866d88cb_-1a51,1200427,Rodrigues Alves - AC,7633,8055,422,14919,51.16,53.99,2.83
sidra_9541_PercMoradDPPOColetTot_munic_22_pol.fid-703dc0a5_191866d88cb_-1a50,1200435,Santa Rosa do Purus - AC,1252,2825,1573,6717,18.64,42.06,23.42
sidra_9541_PercMoradDPPOColetTot_munic_22_pol.fid-703dc0a5_191866d88cb_-1a4f,1200450,Senador Guiomard - AC,13853,14304,451,20993,65.99,68.14,2.15
sidra_9541_PercMoradDPPOColetTot_munic_22_pol.fid-703dc0a5_191866d88cb_-1a4e,1200500,Sena Madureira - AC,21431,25300,3869,40874,52.43,61.9,9.47
sidra_9541_PercMoradDPPOColetTot_munic_22_pol.fid-703dc0a5_191866d88cb_-1a4d,1200609,Tarauacá - AC,22303,23609,1306,42871,52.02,55.07,3.05
sidra_9541_PercMoradDPPOColetTot_munic_22_pol.fid-703dc0a5_191866d88cb_-1a4b,1200708,Xapuri - AC,8848,10395,1547,18230,48.54,57.02,8.49
sidra_9541_PercMoradDPPOColetTot_munic_22_pol.fid-703dc0a5_191866d88cb_-1a4a,1200807,Porto Acre - AC,7091,9179,2088,16676,42.52,55.04,12.52
sidra_9541_PercMoradDPPOColetTot_munic_22_pol.fid-703dc0a5_191866d88cb_-1a49,1300029,Alvarães - AM,3957,9207,5250,15828,25,58.17,33.17
sidra_9541_PercMoradDPPOColetTot_munic_22_pol.fid-703dc0a5_191866d88cb_-1a47,1300060,Amaturá - AM,4376,4592,216,10812,40.47,42.47,2
sidra_9541_PercMoradDPPOColetTot_munic_22_pol.fid-703dc0a5_191866d88cb_-1a46,1300086,Anamã - AM,5845,5972,127,9944,58.78,60.06,1.28
sidra_9541_PercMoradDPPOColetTot_munic_22_pol.fid-703dc0a5_191866d88cb_-1a45,1300102,Anori - AM,10438,11006,568,17123,60.96,64.28,3.32
sidra_9541_PercMoradDPPOColetTot_munic_22_pol.fid-703dc0a5_191866d88cb_-1a44,1300144,Apuí - AM,8595,9596,1001,20528,41.87,46.75,4.88
sidra_9541_PercMoradDPPOColetTot_munic_22_pol.fid-703dc0a5_191866d88cb_-1a43,1300201,Atalaia do Norte - AM,6454,7056,602,15195,42.47,46.44,3.96
sidra_9541_PercMoradDPPOColetTot_munic_22_pol.fid-703dc0a5_191866d88cb_-1a41,1300300,Autazes - AM,19436,20333,897,41548,46.78,48.94,2.16
sidra_9541_PercMoradDPPOColetTot_munic_22_pol.fid-703dc0a5_191866d88cb_-1a40,1300409,Barcelos - AM,9475,10663,1188,18697,50.68,57.03,6.35
sidra_9541_PercMoradDPPOColetTot_munic_22_pol.fid-703dc0a5_191866d88cb_-1a3e,1300508,Barreirinha - AM,10453,10997,544,30872,33.86,35.62,1.76
sidra_9541_PercMoradDPPOColetTot_munic_22_pol.fid-703dc0a5_191866d88cb_-1a3d,1300607,Benjamin Constant - AM,16328,19962,3634,37538,43.5,53.18,9.68
sidra_9541_PercMoradDPPOColetTot_munic_22_pol.fid-703dc0a5_191866d88cb_-1a3b,1300631,Beruri - AM,2241,8989,6748,20671,10.84,43.49,32.64
sidra_9541_PercMoradDPPOColetTot_munic_22_pol.fid-703dc0a5_191866d88cb_-1a39,1300680,Boa Vista do Ramos - AM,11296,11509,213,23768,47.53,48.42,0.9
sidra_9541_PercMoradDPPOColetTot_munic_22_pol.fid-703dc0a5_191866d88cb_-1a38,1300706,Boca do Acre - AM,10598,13968,3370,35357,29.97,39.51,9.53
sidra_9541_PercMoradDPPOColetTot_munic_22_pol.fid-703dc0a5_191866d88cb_-1a37,1300805,Borba - AM,19643,20035,392,33021,59.49,60.67,1.19
sidra_9541_PercMoradDPPOColetTot_munic_22_pol.fid-703dc0a5_191866d88cb_-1a36,1300839,Caapiranga - AM,7063,8102,1039,13378,52.8,60.56,7.77
sidra_9541_PercMoradDPPOColetTot_munic_22_pol.fid-703dc0a5_191866d88cb_-1a34,1300904,Canutama - AM,3627,9029,5402,16862,21.51,53.55,32.04
sidra_9541_PercMoradDPPOColetTot_munic_22_pol.fid-703dc0a5_191866d88cb_-1a31,1301001,Carauari - AM,14312,19727,5415,28668,49.92,68.81,18.89
sidra_9541_PercMoradDPPOColetTot_munic_22_pol.fid-703dc0a5_191866d88cb_-1a30,1301100,Careiro - AM,14421,16412,1991,30740,46.91,53.39,6.48
sidra_9541_PercMoradDPPOColetTot_munic_22_pol.fid-703dc0a5_191866d88cb_-1a2e,1301159,Careiro da Várzea - AM,3996,4438,442,19602,20.39,22.64,2.25
sidra_9541_PercMoradDPPOColetTot_munic_22_pol.fid-703dc0a5_191866d88cb_-1a2d,1301209,Coari - AM,32721,52108,19387,70506,46.41,73.91,27.5
sidra_9541_PercMoradDPPOColetTot_munic_22_pol.fid-703dc0a5_191866d88cb_-1a2c,1301308,Codajás - AM,15750,17042,1292,23473,67.1,72.6,5.5
sidra_9541_PercMoradDPPOColetTot_munic_22_pol.fid-703dc0a5_191866d88cb_-1a2a,1301407,Eirunepé - AM,18020,18378,358,33061,54.51,55.59,1.08
sidra_9541_PercMoradDPPOColetTot_munic_22_pol.fid-703dc0a5_191866d88cb_-1a28,1301506,Envira - AM,12038,12063,25,17143,70.22,70.37,0.15
sidra_9541_PercMoradDPPOColetTot_munic_22_pol.fid-703dc0a5_191866d88cb_-1a27,1301605,Fonte Boa - AM,8270,14698,6428,25732,32.14,57.12,24.98
sidra_9541_PercMoradDPPOColetTot_munic_22_pol.fid-703dc0a5_191866d88cb_-1a25,1301654,Guajará - AM,8536,8939,403,13790,61.9,64.82,2.92
sidra_9541_PercMoradDPPOColetTot_munic_22_pol.fid-703dc0a5_191866d88cb_-1a24,1301704,Humaitá - AM,36861,39095,2234,57359,64.26,68.16,3.89
sidra_9541_PercMoradDPPOColetTot_munic_22_pol.fid-703dc0a5_191866d88cb_-1a22,1301803,Ipixuna - AM,9491,11936,2445,24038,39.48,49.65,10.17
sidra_9541_PercMoradDPPOColetTot_munic_22_pol.fid-703dc0a5_191866d88cb_-1a21,1301852,Iranduba - AM,43649,50365,6716,60904,71.67,82.7,11.03
sidra_9541_PercMoradDPPOColetTot_munic_22_pol.fid-703dc0a5_191866d88cb_-1a20,1301902,Itacoatiara - AM,71899,75167,3268,103209,69.66,72.83,3.17
sidra_9541_PercMoradDPPOColetTot_munic_22_pol.fid-703dc0a5_191866d88cb_-1a1f,1301951,Itamarati - AM,5231,5627,396,10910,47.95,51.58,3.63
sidra_9541_PercMoradDPPOColetTot_munic_22_pol.fid-703dc0a5_191866d88cb_-1a1d,1302009,Itapiranga - AM,7537,8130,593,10107,74.57,80.44,5.87
sidra_9541_PercMoradDPPOColetTot_munic_22_pol.fid-703dc0a5_191866d88cb_-1a1c,1302108,Japurá - AM,2922,3869,947,8767,33.33,44.13,10.8
sidra_9541_PercMoradDPPOColetTot_munic_22_pol.fid-703dc0a5_191866d88cb_-1a1a,1302207,Juruá - AM,3315,5186,1871,10729,30.9,48.34,17.44
sidra_9541_PercMoradDPPOColetTot_munic_22_pol.fid-703dc0a5_191866d88cb_-1a19,1302306,Jutaí - AM,11130,13793,2663,24981,44.55,55.21,10.66
sidra_9541_PercMoradDPPOColetTot_munic_22_pol.fid-703dc0a5_191866d88cb_-1a16,1302405,Lábrea - AM,24142,27050,2908,45339,53.25,59.66,6.41
sidra_9541_PercMoradDPPOColetTot_munic_22_pol.fid-703dc0a5_191866d88cb_-1a11,1302504,Manacapuru - AM,67205,71937,4732,101637,66.12,70.78,4.66
sidra_9541_PercMoradDPPOColetTot_munic_22_pol.fid-703dc0a5_191866d88cb_-1a0f,1302553,Manaquiri - AM,6743,7067,324,17089,39.46,41.35,1.9
sidra_9541_PercMoradDPPOColetTot_munic_22_pol.fid-703dc0a5_191866d88cb_-1a0e,1302603,Manaus - AM,1869549,2002022,132473,2058504,90.82,97.26,6.44
sidra_9541_PercMoradDPPOColetTot_munic_22_pol.fid-703dc0a5_191866d88cb_-1a0d,1302702,Manicoré - AM,27863,28795,932,53766,51.82,53.56,1.73
sidra_9541_PercMoradDPPOColetTot_munic_22_pol.fid-703dc0a5_191866d88cb_-1a0c,1302801,Maraã - AM,6248,7137,889,15388,40.6,46.38,5.78
sidra_9541_PercMoradDPPOColetTot_munic_22_pol.fid-703dc0a5_191866d88cb_-1a0b,1302900,Maués - AM,26677,28010,1333,60966,43.76,45.94,2.19
sidra_9541_PercMoradDPPOColetTot_munic_22_pol.fid-703dc0a5_191866d88cb_-1a0a,1303007,Nhamundá - AM,5418,7533,2115,20036,27.04,37.6,10.56
sidra_9541_PercMoradDPPOColetTot_munic_22_pol.fid-703dc0a5_191866d88cb_-1a09,1303106,Nova Olinda do Norte - AM,15607,16286,679,26925,57.96,60.49,2.52
sidra_9541_PercMoradDPPOColetTot_munic_22_pol.fid-703dc0a5_191866d88cb_-1a08,1303205,Novo Airão - AM,9116,11700,2584,15707,58.04,74.49,16.45
sidra_9541_PercMoradDPPOColetTot_munic_22_pol.fid-703dc0a5_191866d88cb_-1a06,1303304,Novo Aripuanã - AM,12753,16082,3329,23695,53.82,67.87,14.05
sidra_9541_PercMoradDPPOColetTot_munic_22_pol.fid-703dc0a5_191866d88cb_-1a05,1303403,Parintins - AM,63113,68542,5429,96063,65.7,71.35,5.65
sidra_9541_PercMoradDPPOColetTot_munic_22_pol.fid-703dc0a5_191866d88cb_-1a03,1303502,Pauini - AM,7572,8187,615,19304,39.23,42.41,3.19
sidra_9541_PercMoradDPPOColetTot_munic_22_pol.fid-703dc0a5_191866d88cb_-1a02,1303536,Presidente Figueiredo - AM,20237,22453,2216,30635,66.06,73.29,7.23
sidra_9541_PercMoradDPPOColetTot_munic_22_pol.fid-703dc0a5_191866d88cb_-1a00,1303569,Rio Preto da Eva - AM,7544,14461,6917,24880,30.32,58.12,27.8
sidra_9541_PercMoradDPPOColetTot_munic_22_pol.fid-703dc0a5_191866d88cb_-19fe,1303601,Santa Isabel do Rio Negro - AM,6811,6897,86,14099,48.31,48.92,0.61
sidra_9541_PercMoradDPPOColetTot_munic_22_pol.fid-703dc0a5_191866d88cb_-19fd,1303700,Santo Antônio do Içá - AM,7699,11883,4184,28142,27.36,42.23,14.87
sidra_9541_PercMoradDPPOColetTot_munic_22_pol.fid-703dc0a5_191866d88cb_-19fa,1303809,São Gabriel da Cachoeira - AM,17904,26010,8106,51258,34.93,50.74,15.81
sidra_9541_PercMoradDPPOColetTot_munic_22_pol.fid-703dc0a5_191866d88cb_-19f8,1303908,São Paulo de Olivença - AM,7999,10295,2296,32931,24.29,31.26,6.97
sidra_9541_PercMoradDPPOColetTot_munic_22_pol.fid-703dc0a5_191866d88cb_-19f7,1303957,São Sebastião do Uatumã - AM,9149,9204,55,11542,79.27,79.74,0.48
sidra_9541_PercMoradDPPOColetTot_munic_22_pol.fid-703dc0a5_191866d88cb_-19f5,1304005,Silves - AM,5042,5389,347,11534,43.71,46.72,3.01
sidra_9541_PercMoradDPPOColetTot_munic_22_pol.fid-703dc0a5_191866d88cb_-19f4,1304062,Tabatinga - AM,33374,45701,12327,66438,50.23,68.79,18.55
sidra_9541_PercMoradDPPOColetTot_munic_22_pol.fid-703dc0a5_191866d88cb_-19f3,1304104,Tapauá - AM,10362,12443,2081,19489,53.17,63.85,10.68
sidra_9541_PercMoradDPPOColetTot_munic_22_pol.fid-703dc0a5_191866d88cb_-19f1,1304203,Tefé - AM,52737,58720,5983,73546,71.71,79.84,8.14
sidra_9541_PercMoradDPPOColetTot_munic_22_pol.fid-703dc0a5_191866d88cb_-19ef,1304237,Tonantins - AM,4221,8811,4590,19232,21.95,45.81,23.87
sidra_9541_PercMoradDPPOColetTot_munic_22_pol.fid-703dc0a5_191866d88cb_-19ee,1304260,Uarini - AM,8400,8738,338,14261,58.9,61.27,2.37
sidra_9541_PercMoradDPPOColetTot_munic_22_pol.fid-703dc0a5_191866d88cb_-19ed,1304302,Urucará - AM,11260,12680,1420,18563,60.66,68.31,7.65
sidra_9541_PercMoradDPPOColetTot_munic_22_pol.fid-703dc0a5_191866d88cb_-19ec,1304401,Urucurituba - AM,13622,16129,2507,23539,57.87,68.52,10.65
sidra_9541_PercMoradDPPOColetTot_munic_22_pol.fid-703dc0a5_191866d88cb_-19eb,1400027,Amajari - RR,3958,4036,78,13715,28.86,29.43,0.57
sidra_9541_PercMoradDPPOColetTot_munic_22_pol.fid-703dc0a5_191866d88cb_-19ea,1400050,Alto Alegre - RR,5205,5298,93,21028,24.75,25.19,0.44
sidra_9541_PercMoradDPPOColetTot_munic_22_pol.fid-703dc0a5_191866d88cb_-19e9,1400100,Boa Vista - RR,377411,387519,10108,403025,93.64,96.15,2.51
sidra_9541_PercMoradDPPOColetTot_munic_22_pol.fid-703dc0a5_191866d88cb_-19e8,1400159,Bonfim - RR,5706,5814,108,13855,41.18,41.96,0.78
sidra_9541_PercMoradDPPOColetTot_munic_22_pol.fid-703dc0a5_191866d88cb_-19e7,1400175,Cantá - RR,5662,5742,80,18557,30.51,30.94,0.43
sidra_9541_PercMoradDPPOColetTot_munic_22_pol.fid-703dc0a5_191866d88cb_-19e5,1400209,Caracaraí - RR,11004,11428,424,20882,52.7,54.73,2.03
sidra_9541_PercMoradDPPOColetTot_munic_22_pol.fid-703dc0a5_191866d88cb_-19e4,1400233,Caroebe - RR,5878,5911,33,10512,55.92,56.23,0.31
sidra_9541_PercMoradDPPOColetTot_munic_22_pol.fid-703dc0a5_191866d88cb_-19e3,1400282,Iracema - RR,4289,4377,88,10018,42.81,43.69,0.88
sidra_9541_PercMoradDPPOColetTot_munic_22_pol.fid-703dc0a5_191866d88cb_-19e2,1400308,Mucajaí - RR,12144,12230,86,17937,67.7,68.18,0.48
sidra_9541_PercMoradDPPOColetTot_munic_22_pol.fid-703dc0a5_191866d88cb_-19e1,1400407,Normandia - RR,3086,3092,6,13893,22.21,22.26,0.04
sidra_9541_PercMoradDPPOColetTot_munic_22_pol.fid-703dc0a5_191866d88cb_-19e0,1400456,Pacaraima - RR,6670,7590,920,17365,38.41,43.71,5.3
sidra_9541_PercMoradDPPOColetTot_munic_22_pol.fid-703dc0a5_191866d88cb_-19de,1400472,Rorainópolis - RR,18202,18604,402,32559,55.9,57.14,1.23
sidra_9541_PercMoradDPPOColetTot_munic_22_pol.fid-703dc0a5_191866d88cb_-19dc,1400506,São João da Baliza - RR,5846,5923,77,8691,67.26,68.15,0.89
sidra_9541_PercMoradDPPOColetTot_munic_22_pol.fid-703dc0a5_191866d88cb_-19db,1400605,São Luiz - RR,4877,4877,,7127,68.43,68.43,
sidra_9541_PercMoradDPPOColetTot_munic_22_pol.fid-703dc0a5_191866d88cb_-19da,1400704,Uiramutã - RR,1203,1308,105,13695,8.78,9.55,0.77
sidra_9541_PercMoradDPPOColetTot_munic_22_pol.fid-703dc0a5_191866d88cb_-19d9,1500107,Abaetetuba - PA,107449,110683,3234,157761,68.11,70.16,2.05
sidra_9541_PercMoradDPPOColetTot_munic_22_pol.fid-703dc0a5_191866d88cb_-19d8,1500131,Abel Figueiredo - PA,5236,5317,81,6125,85.49,86.81,1.32
sidra_9541_PercMoradDPPOColetTot_munic_22_pol.fid-703dc0a5_191866d88cb_-19d7,1500206,Acará - PA,11720,15515,3795,58883,19.9,26.35,6.44
sidra_9541_PercMoradDPPOColetTot_munic_22_pol.fid-703dc0a5_191866d88cb_-19d6,1500305,Afuá - PA,3488,11743,8255,37658,9.26,31.18,21.92
sidra_9541_PercMoradDPPOColetTot_munic_22_pol.fid-703dc0a5_191866d88cb_-19d5,1500347,Água Azul do Norte - PA,9816,10090,274,17961,54.65,56.18,1.53
sidra_9541_PercMoradDPPOColetTot_munic_22_pol.fid-703dc0a5_191866d88cb_-19d4,1500404,Alenquer - PA,31813,31986,173,69250,45.94,46.19,0.25
sidra_9541_PercMoradDPPOColetTot_munic_22_pol.fid-703dc0a5_191866d88cb_-19d3,1500503,Almeirim - PA,19523,22652,3129,34173,57.13,66.29,9.16
sidra_9541_PercMoradDPPOColetTot_munic_22_pol.fid-703dc0a5_191866d88cb_-19d2,1500602,Altamira - PA,100454,103166,2712,125916,79.78,81.93,2.15
sidra_9541_PercMoradDPPOColetTot_munic_22_pol.fid-703dc0a5_191866d88cb_-19d1,1500701,Anajás - PA,9074,10683,1609,27905,32.52,38.28,5.77
sidra_9541_PercMoradDPPOColetTot_munic_22_pol.fid-703dc0a5_191866d88cb_-19cf,1500800,Ananindeua - PA,434312,468557,34245,477381,90.98,98.15,7.17
sidra_9541_PercMoradDPPOColetTot_munic_22_pol.fid-703dc0a5_191866d88cb_-19ce,1500859,Anapu - PA,14222,15535,1313,31548,45.08,49.24,4.16
sidra_9541_PercMoradDPPOColetTot_munic_22_pol.fid-703dc0a5_191866d88cb_-19cd,1500909,Augusto Corrêa - PA,20378,25582,5204,44524,45.77,57.46,11.69
sidra_9541_PercMoradDPPOColetTot_munic_22_pol.fid-703dc0a5_191866d88cb_-19cc,1500958,Aurora do Pará - PA,13211,13721,510,23672,55.81,57.96,2.15
sidra_9541_PercMoradDPPOColetTot_munic_22_pol.fid-703dc0a5_191866d88cb_-19cb,1501006,Aveiro - PA,3233,4309,1076,18188,17.78,23.69,5.92
sidra_9541_PercMoradDPPOColetTot_munic_22_pol.fid-703dc0a5_191866d88cb_-19ca,1501105,Bagre - PA,1096,11482,10386,31715,3.46,36.2,32.75
sidra_9541_PercMoradDPPOColetTot_munic_22_pol.fid-703dc0a5_191866d88cb_-19c9,1501204,Baião - PA,26876,28386,1510,51107,52.59,55.54,2.95
sidra_9541_PercMoradDPPOColetTot_munic_22_pol.fid-703dc0a5_191866d88cb_-19c8,1501253,Bannach - PA,1768,1811,43,3990,44.31,45.39,1.08
sidra_9541_PercMoradDPPOColetTot_munic_22_pol.fid-703dc0a5_191866d88cb_-19c7,1501303,Barcarena - PA,103451,107592,4141,126452,81.81,85.09,3.27
sidra_9541_PercMoradDPPOColetTot_munic_22_pol.fid-703dc0a5_191866d88cb_-19c6,1501402,Belém - PA,1166277,1265629,99352,1301368,89.62,97.25,7.63
sidra_9541_PercMoradDPPOColetTot_munic_22_pol.fid-703dc0a5_191866d88cb_-19c5,1501451,Belterra - PA,9782,10928,1146,18042,54.22,60.57,6.35
sidra_9541_PercMoradDPPOColetTot_munic_22_pol.fid-703dc0a5_191866d88cb_-19c4,1501501,Benevides - PA,49903,58542,8639,63381,78.73,92.37,13.63
sidra_9541_PercMoradDPPOColetTot_munic_22_pol.fid-703dc0a5_191866d88cb_-19c3,1501576,Bom Jesus do Tocantins - PA,11757,12141,384,17958,65.47,67.61,2.14
sidra_9541_PercMoradDPPOColetTot_munic_22_pol.fid-703dc0a5_191866d88cb_-19c2,1501600,Bonito - PA,7046,8065,1019,12602,55.91,64,8.09
sidra_9541_PercMoradDPPOColetTot_munic_22_pol.fid-703dc0a5_191866d88cb_-19c1,1501709,Bragança - PA,80773,88759,7986,122802,65.77,72.28,6.5
sidra_9541_PercMoradDPPOColetTot_munic_22_pol.fid-703dc0a5_191866d88cb_-19c0,1501725,Brasil Novo - PA,11758,12802,1044,24616,47.77,52.01,4.24
sidra_9541_PercMoradDPPOColetTot_munic_22_pol.fid-703dc0a5_191866d88cb_-19bf,1501758,Brejo Grande do Araguaia - PA,3685,4024,339,6775,54.39,59.39,5
sidra_9541_PercMoradDPPOColetTot_munic_22_pol.fid-703dc0a5_191866d88cb_-19be,1501782,Breu Branco - PA,31041,32969,1928,45630,68.03,72.25,4.23
sidra_9541_PercMoradDPPOColetTot_munic_22_pol.fid-703dc0a5_191866d88cb_-19bd,1501808,Breves - PA,39250,51611,12361,106633,36.81,48.4,11.59
sidra_9541_PercMoradDPPOColetTot_munic_22_pol.fid-703dc0a5_191866d88cb_-19bc,1501907,Bujaru - PA,7403,7916,513,24324,30.43,32.54,2.11
sidra_9541_PercMoradDPPOColetTot_munic_22_pol.fid-703dc0a5_191866d88cb_-19bb,1501956,Cachoeira do Piriá - PA,5974,7872,1898,19578,30.51,40.21,9.69
sidra_9541_PercMoradDPPOColetTot_munic_22_pol.fid-703dc0a5_191866d88cb_-19b9,1502004,Cachoeira do Arari - PA,9698,9883,185,23944,40.5,41.28,0.77
sidra_9541_PercMoradDPPOColetTot_munic_22_pol.fid-703dc0a5_191866d88cb_-19b8,1502103,Cametá - PA,64289,71876,7587,133949,48,53.66,5.66
sidra_9541_PercMoradDPPOColetTot_munic_22_pol.fid-703dc0a5_191866d88cb_-19b7,1502152,Canaã dos Carajás - PA,68713,71476,2763,76838,89.43,93.02,3.6
sidra_9541_PercMoradDPPOColetTot_munic_22_pol.fid-703dc0a5_191866d88cb_-19b6,1502202,Capanema - PA,56142,60148,4006,70224,79.95,85.65,5.7
sidra_9541_PercMoradDPPOColetTot_munic_22_pol.fid-703dc0a5_191866d88cb_-19b5,1502301,Capitão Poço - PA,38500,40041,1541,56462,68.19,70.92,2.73
sidra_9541_PercMoradDPPOColetTot_munic_22_pol.fid-703dc0a5_191866d88cb_-19b4,1502400,Castanhal - PA,172756,181684,8928,191716,90.11,94.77,4.66
sidra_9541_PercMoradDPPOColetTot_munic_22_pol.fid-703dc0a5_191866d88cb_-19b3,1502509,Chaves - PA,736,4398,3662,20704,3.55,21.24,17.69
sidra_9541_PercMoradDPPOColetTot_munic_22_pol.fid-703dc0a5_191866d88cb_-19b2,1502608,Colares - PA,8158,8456,298,12851,63.48,65.8,2.32
sidra_9541_PercMoradDPPOColetTot_munic_22_pol.fid-703dc0a5_191866d88cb_-19b1,1502707,Conceição do Araguaia - PA,33160,34583,1423,44534,74.46,77.66,3.2
sidra_9541_PercMoradDPPOColetTot_munic_22_pol.fid-703dc0a5_191866d88cb_-19b0,1502756,Concórdia do Pará - PA,14693,18214,3521,26852,54.72,67.83,13.11
sidra_9541_PercMoradDPPOColetTot_munic_22_pol.fid-703dc0a5_191866d88cb_-19af,1502764,Cumaru do Norte - PA,6239,6775,536,12863,48.5,52.67,4.17
sidra_9541_PercMoradDPPOColetTot_munic_22_pol.fid-703dc0a5_191866d88cb_-19ae,1502772,Curionópolis - PA,14765,16350,1585,19942,74.04,81.99,7.95
sidra_9541_PercMoradDPPOColetTot_munic_22_pol.fid-703dc0a5_191866d88cb_-19ad,1502806,Curralinho - PA,9932,10704,772,33830,29.36,31.64,2.28
sidra_9541_PercMoradDPPOColetTot_munic_22_pol.fid-703dc0a5_191866d88cb_-19ab,1502855,Curuá - PA,5306,6169,863,14105,37.62,43.74,6.12
sidra_9541_PercMoradDPPOColetTot_munic_22_pol.fid-703dc0a5_191866d88cb_-19aa,1502905,Curuçá - PA,29927,32304,2377,41136,72.75,78.53,5.78
sidra_9541_PercMoradDPPOColetTot_munic_22_pol.fid-703dc0a5_191866d88cb_-19a9,1502939,Dom Eliseu - PA,48969,49580,611,58380,83.88,84.93,1.05
sidra_9541_PercMoradDPPOColetTot_munic_22_pol.fid-703dc0a5_191866d88cb_-19a8,1502954,Eldorado do Carajás - PA,16092,16549,457,28117,57.23,58.86,1.63
sidra_9541_PercMoradDPPOColetTot_munic_22_pol.fid-703dc0a5_191866d88cb_-19a7,1503002,Faro - PA,6569,6854,285,8693,75.57,78.85,3.28
sidra_9541_PercMoradDPPOColetTot_munic_22_pol.fid-703dc0a5_191866d88cb_-19a6,1503044,Floresta do Araguaia - PA,9541,9700,159,17887,53.34,54.23,0.89
sidra_9541_PercMoradDPPOColetTot_munic_22_pol.fid-703dc0a5_191866d88cb_-19a5,1503077,Garrafão do Norte - PA,15390,15425,35,24692,62.33,62.47,0.14
sidra_9541_PercMoradDPPOColetTot_munic_22_pol.fid-703dc0a5_191866d88cb_-19a4,1503093,Goianésia do Pará - PA,17765,17944,179,26317,67.5,68.18,0.68
sidra_9541_PercMoradDPPOColetTot_munic_22_pol.fid-703dc0a5_191866d88cb_-19a3,1503101,Gurupá - PA,10355,12150,1795,31687,32.68,38.34,5.66
sidra_9541_PercMoradDPPOColetTot_munic_22_pol.fid-703dc0a5_191866d88cb_-19a2,1503200,Igarapé-Açu - PA,27926,28584,658,35600,78.44,80.29,1.85
sidra_9541_PercMoradDPPOColetTot_munic_22_pol.fid-703dc0a5_191866d88cb_-19a1,1503309,Igarapé-Miri - PA,25010,28054,3044,64706,38.65,43.36,4.7
sidra_9541_PercMoradDPPOColetTot_munic_22_pol.fid-703dc0a5_191866d88cb_-19a0,1503408,Inhangapi - PA,5798,6257,459,10313,56.22,60.67,4.45
sidra_9541_PercMoradDPPOColetTot_munic_22_pol.fid-703dc0a5_191866d88cb_-199f,1503457,Ipixuna do Pará - PA,17338,20837,3499,30206,57.4,68.98,11.58
sidra_9541_PercMoradDPPOColetTot_munic_22_pol.fid-703dc0a5_191866d88cb_-199e,1503507,Irituia - PA,10878,13012,2134,30934,35.17,42.06,6.9
sidra_9541_PercMoradDPPOColetTot_munic_22_pol.fid-703dc0a5_191866d88cb_-199d,1503606,Itaituba - PA,102720,105119,2399,122162,84.09,86.05,1.96
sidra_9541_PercMoradDPPOColetTot_munic_22_pol.fid-703dc0a5_191866d88cb_-199c,1503705,Itupiranga - PA,24046,29062,5016,49637,48.44,58.55,10.11
sidra_9541_PercMoradDPPOColetTot_munic_22_pol.fid-703dc0a5_191866d88cb_-199b,1503754,Jacareacanga - PA,9616,9715,99,23845,40.33,40.74,0.42
sidra_9541_PercMoradDPPOColetTot_munic_22_pol.fid-703dc0a5_191866d88cb_-1999,1503804,Jacundá - PA,32372,33194,822,37664,85.95,88.13,2.18
sidra_9541_PercMoradDPPOColetTot_munic_22_pol.fid-703dc0a5_191866d88cb_-1998,1503903,Juruti - PA,26059,31960,5901,50735,51.36,62.99,11.63
sidra_9541_PercMoradDPPOColetTot_munic_22_pol.fid-703dc0a5_191866d88cb_-1997,1504000,Limoeiro do Ajuru - PA,6346,6949,603,29525,21.49,23.54,2.04
sidra_9541_PercMoradDPPOColetTot_munic_22_pol.fid-703dc0a5_191866d88cb_-1996,1504059,Mãe do Rio - PA,29426,31646,2220,34288,85.82,92.29,6.47
sidra_9541_PercMoradDPPOColetTot_munic_22_pol.fid-703dc0a5_191866d88cb_-1995,1504109,Magalhães Barata - PA,6641,6717,76,8075,82.24,83.18,0.94
sidra_9541_PercMoradDPPOColetTot_munic_22_pol.fid-703dc0a5_191866d88cb_-1994,1504208,Marabá - PA,227165,238288,11123,265617,85.52,89.71,4.19
sidra_9541_PercMoradDPPOColetTot_munic_22_pol.fid-703dc0a5_191866d88cb_-1993,1504307,Maracanã - PA,7932,11361,3429,25856,30.68,43.94,13.26
sidra_9541_PercMoradDPPOColetTot_munic_22_pol.fid-703dc0a5_191866d88cb_-1992,1504406,Marapanim - PA,15113,17293,2180,26496,57.04,65.27,8.23
sidra_9541_PercMoradDPPOColetTot_munic_22_pol.fid-703dc0a5_191866d88cb_-1991,1504422,Marituba - PA,100005,108043,8038,110593,90.43,97.69,7.27
sidra_9541_PercMoradDPPOColetTot_munic_22_pol.fid-703dc0a5_191866d88cb_-1990,1504455,Medicilândia - PA,10510,11770,1260,27027,38.89,43.55,4.66
sidra_9541_PercMoradDPPOColetTot_munic_22_pol.fid-703dc0a5_191866d88cb_-198f,1504505,Melgaço - PA,1739,7864,6125,27714,6.27,28.38,22.1
sidra_9541_PercMoradDPPOColetTot_munic_22_pol.fid-703dc0a5_191866d88cb_-198e,1504604,Mocajuba - PA,17732,19184,1452,27120,65.38,70.74,5.35
sidra_9541_PercMoradDPPOColetTot_munic_22_pol.fid-703dc0a5_191866d88cb_-198d,1504703,Moju - PA,33848,36050,2202,83890,40.35,42.97,2.62
sidra_9541_PercMoradDPPOColetTot_munic_22_pol.fid-703dc0a5_191866d88cb_-198c,1504752,Mojuí dos Campos - PA,10144,10251,107,23482,43.2,43.65,0.46
sidra_9541_PercMoradDPPOColetTot_munic_22_pol.fid-703dc0a5_191866d88cb_-198b,1504802,Monte Alegre - PA,26835,27258,423,59946,44.77,45.47,0.71
sidra_9541_PercMoradDPPOColetTot_munic_22_pol.fid-703dc0a5_191866d88cb_-198a,1504901,Muaná - PA,16317,17551,1234,45181,36.11,38.85,2.73
sidra_9541_PercMoradDPPOColetTot_munic_22_pol.fid-703dc0a5_191866d88cb_-1989,1504950,Nova Esperança do Piriá - PA,10940,12538,1598,20437,53.53,61.35,7.82
sidra_9541_PercMoradDPPOColetTot_munic_22_pol.fid-703dc0a5_191866d88cb_-1988,1504976,Nova Ipixuna - PA,7296,7429,133,13903,52.48,53.43,0.96
sidra_9541_PercMoradDPPOColetTot_munic_22_pol.fid-703dc0a5_191866d88cb_-1986,1505007,Nova Timboteua - PA,7993,9956,1963,12772,62.58,77.95,15.37
sidra_9541_PercMoradDPPOColetTot_munic_22_pol.fid-703dc0a5_191866d88cb_-1985,1505031,Novo Progresso - PA,27485,28633,1148,33474,82.11,85.54,3.43
sidra_9541_PercMoradDPPOColetTot_munic_22_pol.fid-703dc0a5_191866d88cb_-1984,1505064,Novo Repartimento - PA,30232,33502,3270,60607,49.88,55.28,5.4
sidra_9541_PercMoradDPPOColetTot_munic_22_pol.fid-703dc0a5_191866d88cb_-1983,1505106,Óbidos - PA,20360,24670,4310,51953,39.19,47.49,8.3
sidra_9541_PercMoradDPPOColetTot_munic_22_pol.fid-703dc0a5_191866d88cb_-1982,1505205,Oeiras do Pará - PA,13190,14273,1083,33694,39.15,42.36,3.21
sidra_9541_PercMoradDPPOColetTot_munic_22_pol.fid-703dc0a5_191866d88cb_-1981,1505304,Oriximiná - PA,42059,44657,2598,68115,61.75,65.56,3.81
sidra_9541_PercMoradDPPOColetTot_munic_22_pol.fid-703dc0a5_191866d88cb_-1980,1505403,Ourém - PA,15295,15460,165,17836,85.75,86.68,0.93
sidra_9541_PercMoradDPPOColetTot_munic_22_pol.fid-703dc0a5_191866d88cb_-197f,1505437,Ourilândia do Norte - PA,25527,26091,564,32431,78.71,80.45,1.74
sidra_9541_PercMoradDPPOColetTot_munic_22_pol.fid-703dc0a5_191866d88cb_-197e,1505486,Pacajá - PA,15419,18778,3359,41045,37.57,45.75,8.18
sidra_9541_PercMoradDPPOColetTot_munic_22_pol.fid-703dc0a5_191866d88cb_-197d,1505494,Palestina do Pará - PA,3518,5063,1545,6884,51.1,73.55,22.44
sidra_9541_PercMoradDPPOColetTot_munic_22_pol.fid-703dc0a5_191866d88cb_-197c,1505502,Paragominas - PA,94176,95844,1668,105048,89.65,91.24,1.59
sidra_9541_PercMoradDPPOColetTot_munic_22_pol.fid-703dc0a5_191866d88cb_-197b,1505536,Parauapebas - PA,244459,254636,10177,267248,91.47,95.28,3.81
sidra_9541_PercMoradDPPOColetTot_munic_22_pol.fid-703dc0a5_191866d88cb_-197a,1505551,Pau D'Arco - PA,4113,4166,53,6920,59.44,60.2,0.77
sidra_9541_PercMoradDPPOColetTot_munic_22_pol.fid-703dc0a5_191866d88cb_-1979,1505601,Peixe-Boi - PA,5280,6474,1194,8280,63.77,78.19,14.42
sidra_9541_PercMoradDPPOColetTot_munic_22_pol.fid-703dc0a5_191866d88cb_-1978,1505635,Piçarra - PA,6356,6485,129,12822,49.57,50.58,1.01
sidra_9541_PercMoradDPPOColetTot_munic_22_pol.fid-703dc0a5_191866d88cb_-1977,1505650,Placas - PA,7550,8425,875,18637,40.51,45.21,4.69
sidra_9541_PercMoradDPPOColetTot_munic_22_pol.fid-703dc0a5_191866d88cb_-1976,1505700,Ponta de Pedras - PA,9522,14395,4873,24945,38.17,57.71,19.53
sidra_9541_PercMoradDPPOColetTot_munic_22_pol.fid-703dc0a5_191866d88cb_-1974,1505809,Portel - PA,23463,28303,4840,61905,37.9,45.72,7.82
sidra_9541_PercMoradDPPOColetTot_munic_22_pol.fid-703dc0a5_191866d88cb_-1973,1505908,Porto de Moz - PA,13167,18490,5323,40564,32.46,45.58,13.12
sidra_9541_PercMoradDPPOColetTot_munic_22_pol.fid-703dc0a5_191866d88cb_-1972,1506005,Prainha - PA,12349,13596,1247,35427,34.86,38.38,3.52
sidra_9541_PercMoradDPPOColetTot_munic_22_pol.fid-703dc0a5_191866d88cb_-1971,1506104,Primavera - PA,8965,8997,32,10818,82.87,83.17,0.3
sidra_9541_PercMoradDPPOColetTot_munic_22_pol.fid-703dc0a5_191866d88cb_-1970,1506112,Quatipuru - PA,8741,9837,1096,11520,75.88,85.39,9.51
sidra_9541_PercMoradDPPOColetTot_munic_22_pol.fid-703dc0a5_191866d88cb_-196f,1506138,Redenção - PA,79459,80464,1005,85146,93.32,94.5,1.18
sidra_9541_PercMoradDPPOColetTot_munic_22_pol.fid-703dc0a5_191866d88cb_-196e,1506161,Rio Maria - PA,14119,14292,173,18370,76.86,77.8,0.94
sidra_9541_PercMoradDPPOColetTot_munic_22_pol.fid-703dc0a5_191866d88cb_-196d,1506187,Rondon do Pará - PA,34155,35573,1418,52884,64.58,67.27,2.68
sidra_9541_PercMoradDPPOColetTot_munic_22_pol.fid-703dc0a5_191866d88cb_-196c,1506195,Rurópolis - PA,20694,22344,1650,35625,58.09,62.72,4.63
sidra_9541_PercMoradDPPOColetTot_munic_22_pol.fid-703dc0a5_191866d88cb_-196b,1506203,Salinópolis - PA,37133,39844,2711,44544,83.36,89.45,6.09
sidra_9541_PercMoradDPPOColetTot_munic_22_pol.fid-703dc0a5_191866d88cb_-196a,1506302,Salvaterra - PA,12520,13886,1366,24043,52.07,57.75,5.68
sidra_9541_PercMoradDPPOColetTot_munic_22_pol.fid-703dc0a5_191866d88cb_-1969,1506351,Santa Bárbara do Pará - PA,16126,16751,625,21063,76.56,79.53,2.97
sidra_9541_PercMoradDPPOColetTot_munic_22_pol.fid-703dc0a5_191866d88cb_-1968,1506401,Santa Cruz do Arari - PA,4821,5275,454,7427,64.91,71.02,6.11
sidra_9541_PercMoradDPPOColetTot_munic_22_pol.fid-703dc0a5_191866d88cb_-1967,1506500,Santa Izabel do Pará - PA,56023,59317,3294,66485,84.26,89.22,4.95
sidra_9541_PercMoradDPPOColetTot_munic_22_pol.fid-703dc0a5_191866d88cb_-1966,1506559,Santa Luzia do Pará - PA,11392,13437,2045,20329,56.04,66.1,10.06
sidra_9541_PercMoradDPPOColetTot_munic_22_pol.fid-703dc0a5_191866d88cb_-1965,1506583,Santa Maria das Barreiras - PA,8923,9259,336,16451,54.24,56.28,2.04
sidra_9541_PercMoradDPPOColetTot_munic_22_pol.fid-703dc0a5_191866d88cb_-1964,1506609,Santa Maria do Pará - PA,18091,18996,905,24551,73.69,77.37,3.69
sidra_9541_PercMoradDPPOColetTot_munic_22_pol.fid-703dc0a5_191866d88cb_-1963,1506708,Santana do Araguaia - PA,25747,26888,1141,32281,79.76,83.29,3.53
sidra_9541_PercMoradDPPOColetTot_munic_22_pol.fid-703dc0a5_191866d88cb_-1962,1506807,Santarém - PA,249582,266082,16500,330460,75.53,80.52,4.99
sidra_9541_PercMoradDPPOColetTot_munic_22_pol.fid-703dc0a5_191866d88cb_-1961,1506906,Santarém Novo - PA,5556,5561,5,6098,91.11,91.19,0.08
sidra_9541_PercMoradDPPOColetTot_munic_22_pol.fid-703dc0a5_191866d88cb_-1960,1507003,Santo Antônio do Tauá - PA,21118,21916,798,27410,77.04,79.96,2.91
sidra_9541_PercMoradDPPOColetTot_munic_22_pol.fid-703dc0a5_191866d88cb_-195f,1507102,São Caetano de Odivelas - PA,11929,12282,353,16651,71.64,73.76,2.12
sidra_9541_PercMoradDPPOColetTot_munic_22_pol.fid-703dc0a5_191866d88cb_-195e,1507151,São Domingos do Araguaia - PA,15214,15916,702,21053,72.27,75.6,3.33
sidra_9541_PercMoradDPPOColetTot_munic_22_pol.fid-703dc0a5_191866d88cb_-195d,1507201,São Domingos do Capim - PA,11506,11722,216,30585,37.62,38.33,0.71
sidra_9541_PercMoradDPPOColetTot_munic_22_pol.fid-703dc0a5_191866d88cb_-195c,1507300,São Félix do Xingu - PA,36869,37585,716,65124,56.61,57.71,1.1
sidra_9541_PercMoradDPPOColetTot_munic_22_pol.fid-703dc0a5_191866d88cb_-195b,1507409,São Francisco do Pará - PA,8132,9300,1168,14882,54.64,62.49,7.85
sidra_9541_PercMoradDPPOColetTot_munic_22_pol.fid-703dc0a5_191866d88cb_-195a,1507458,São Geraldo do Araguaia - PA,15155,18063,2908,24153,62.75,74.79,12.04
sidra_9541_PercMoradDPPOColetTot_munic_22_pol.fid-703dc0a5_191866d88cb_-1959,1507466,São João da Ponta - PA,3890,3944,54,4426,87.89,89.11,1.22
sidra_9541_PercMoradDPPOColetTot_munic_22_pol.fid-703dc0a5_191866d88cb_-1958,1507474,São João de Pirabas - PA,14226,15497,1271,20670,68.82,74.97,6.15
sidra_9541_PercMoradDPPOColetTot_munic_22_pol.fid-703dc0a5_191866d88cb_-1957,1507508,São João do Araguaia - PA,4791,5609,818,13612,35.2,41.21,6.01
sidra_9541_PercMoradDPPOColetTot_munic_22_pol.fid-703dc0a5_191866d88cb_-1956,1507607,São Miguel do Guamá - PA,33383,35199,1816,52853,63.16,66.6,3.44
sidra_9541_PercMoradDPPOColetTot_munic_22_pol.fid-703dc0a5_191866d88cb_-1955,1507706,São Sebastião da Boa Vista - PA,7514,9401,1887,25539,29.42,36.81,7.39
sidra_9541_PercMoradDPPOColetTot_munic_22_pol.fid-703dc0a5_191866d88cb_-1954,1507755,Sapucaia - PA,3624,5387,1763,5812,62.35,92.69,30.33
sidra_9541_PercMoradDPPOColetTot_munic_22_pol.fid-703dc0a5_191866d88cb_-1953,1507805,Senador José Porfírio - PA,7560,8210,650,22231,34.01,36.93,2.92
sidra_9541_PercMoradDPPOColetTot_munic_22_pol.fid-703dc0a5_191866d88cb_-1952,1507904,Soure - PA,20927,21138,211,24176,86.56,87.43,0.87
sidra_9541_PercMoradDPPOColetTot_munic_22_pol.fid-703dc0a5_191866d88cb_-1951,1507953,Tailândia - PA,56869,62191,5322,72364,78.59,85.94,7.35
sidra_9541_PercMoradDPPOColetTot_munic_22_pol.fid-703dc0a5_191866d88cb_-1950,1507961,Terra Alta - PA,8860,8959,99,10393,85.25,86.2,0.95
sidra_9541_PercMoradDPPOColetTot_munic_22_pol.fid-703dc0a5_191866d88cb_-194f,1507979,Terra Santa - PA,14034,15967,1933,18747,74.86,85.17,10.31
sidra_9541_PercMoradDPPOColetTot_munic_22_pol.fid-703dc0a5_191866d88cb_-194e,1508001,Tomé-Açu - PA,44567,46569,2002,67373,66.15,69.12,2.97
sidra_9541_PercMoradDPPOColetTot_munic_22_pol.fid-703dc0a5_191866d88cb_-194d,1508035,Tracuateua - PA,11724,11807,83,28579,41.02,41.31,0.29
sidra_9541_PercMoradDPPOColetTot_munic_22_pol.fid-703dc0a5_191866d88cb_-194c,1508050,Trairão - PA,9554,10083,529,15210,62.81,66.29,3.48
sidra_9541_PercMoradDPPOColetTot_munic_22_pol.fid-703dc0a5_191866d88cb_-194b,1508084,Tucumã - PA,32993,33450,457,39484,83.56,84.72,1.16
sidra_9541_PercMoradDPPOColetTot_munic_22_pol.fid-703dc0a5_191866d88cb_-194a,1508100,Tucuruí - PA,80553,82922,2369,90701,88.81,91.42,2.61
sidra_9541_PercMoradDPPOColetTot_munic_22_pol.fid-703dc0a5_191866d88cb_-1949,1508126,Ulianópolis - PA,25566,27389,1823,37862,67.52,72.34,4.81
sidra_9541_PercMoradDPPOColetTot_munic_22_pol.fid-703dc0a5_191866d88cb_-1948,1508159,Uruará - PA,22173,23996,1823,43410,51.08,55.28,4.2
sidra_9541_PercMoradDPPOColetTot_munic_22_pol.fid-703dc0a5_191866d88cb_-1946,1508209,Vigia - PA,42385,44946,2561,50779,83.47,88.51,5.04
sidra_9541_PercMoradDPPOColetTot_munic_22_pol.fid-703dc0a5_191866d88cb_-1945,1508308,Viseu - PA,23026,27047,4021,58608,39.29,46.15,6.86
sidra_9541_PercMoradDPPOColetTot_munic_22_pol.fid-703dc0a5_191866d88cb_-1944,1508357,Vitória do Xingu - PA,9398,11199,1801,15562,60.39,71.96,11.57
sidra_9541_PercMoradDPPOColetTot_munic_22_pol.fid-703dc0a5_191866d88cb_-1943,1508407,Xinguara - PA,46850,47097,247,52546,89.16,89.63,0.47
sidra_9541_PercMoradDPPOColetTot_munic_22_pol.fid-703dc0a5_191866d88cb_-1942,1600055,Serra do Navio - AP,4362,4408,46,4631,94.19,95.18,0.99
sidra_9541_PercMoradDPPOColetTot_munic_22_pol.fid-703dc0a5_191866d88cb_-1941,1600105,Amapá - AP,6804,6829,25,7911,86.01,86.32,0.32
sidra_9541_PercMoradDPPOColetTot_munic_22_pol.fid-703dc0a5_191866d88cb_-1940,1600154,Pedra Branca do Amapari - AP,9007,10603,1596,12807,70.33,82.79,12.46
sidra_9541_PercMoradDPPOColetTot_munic_22_pol.fid-703dc0a5_191866d88cb_-193f,1600204,Calçoene - AP,9017,9021,4,10432,86.44,86.47,0.04
sidra_9541_PercMoradDPPOColetTot_munic_22_pol.fid-703dc0a5_191866d88cb_-193e,1600212,Cutias - AP,3446,3919,473,4426,77.86,88.54,10.69
sidra_9541_PercMoradDPPOColetTot_munic_22_pol.fid-703dc0a5_191866d88cb_-193d,1600238,Ferreira Gomes - AP,4949,5058,109,6657,74.34,75.98,1.64
sidra_9541_PercMoradDPPOColetTot_munic_22_pol.fid-703dc0a5_191866d88cb_-193c,1600253,Itaubal - AP,3779,3779,,5583,67.69,67.69,
sidra_9541_PercMoradDPPOColetTot_munic_22_pol.fid-703dc0a5_191866d88cb_-193b,1600279,Laranjal do Jari - AP,20035,31829,11794,35059,57.15,90.79,33.64
sidra_9541_PercMoradDPPOColetTot_munic_22_pol.fid-703dc0a5_191866d88cb_-193a,1600303,Macapá - AP,388396,415852,27456,439881,88.3,94.54,6.24
sidra_9541_PercMoradDPPOColetTot_munic_22_pol.fid-703dc0a5_191866d88cb_-1939,1600402,Mazagão - AP,15490,15935,445,21802,71.05,73.09,2.04
sidra_9541_PercMoradDPPOColetTot_munic_22_pol.fid-703dc0a5_191866d88cb_-1938,1600501,Oiapoque - AP,20335,20636,301,27092,75.06,76.17,1.11
sidra_9541_PercMoradDPPOColetTot_munic_22_pol.fid-703dc0a5_191866d88cb_-1936,1600535,Porto Grande - AP,12324,12458,134,17794,69.26,70.01,0.75
sidra_9541_PercMoradDPPOColetTot_munic_22_pol.fid-703dc0a5_191866d88cb_-1935,1600550,Pracuúba - AP,3269,3274,5,3800,86.03,86.16,0.13
sidra_9541_PercMoradDPPOColetTot_munic_22_pol.fid-703dc0a5_191866d88cb_-1934,1600600,Santana - AP,87947,98213,10266,107334,81.94,91.5,9.56
sidra_9541_PercMoradDPPOColetTot_munic_22_pol.fid-703dc0a5_191866d88cb_-1933,1600709,Tartarugalzinho - AP,7522,7899,377,12900,58.31,61.23,2.92
sidra_9541_PercMoradDPPOColetTot_munic_22_pol.fid-703dc0a5_191866d88cb_-1932,1600808,Vitória do Jari - AP,7715,9517,1802,11244,68.61,84.64,16.03
sidra_9541_PercMoradDPPOColetTot_munic_22_pol.fid-703dc0a5_191866d88cb_-1931,1700251,Abreulândia - TO,923,1511,588,2575,35.84,58.68,22.83
sidra_9541_PercMoradDPPOColetTot_munic_22_pol.fid-703dc0a5_191866d88cb_-192f,1700301,Aguiarnópolis - TO,3885,3900,15,4494,86.45,86.78,0.33
sidra_9541_PercMoradDPPOColetTot_munic_22_pol.fid-703dc0a5_191866d88cb_-192e,1700350,Aliança do Tocantins - TO,4281,4402,121,5147,83.17,85.53,2.35
sidra_9541_PercMoradDPPOColetTot_munic_22_pol.fid-703dc0a5_191866d88cb_-192c,1700400,Almas - TO,5018,5073,55,6475,77.5,78.35,0.85
sidra_9541_PercMoradDPPOColetTot_munic_22_pol.fid-703dc0a5_191866d88cb_-192a,1700707,Alvorada - TO,8227,8267,40,8782,93.68,94.14,0.46
sidra_9541_PercMoradDPPOColetTot_munic_22_pol.fid-703dc0a5_191866d88cb_-1929,1701002,Ananás - TO,7295,8274,979,10151,71.86,81.51,9.64
sidra_9541_PercMoradDPPOColetTot_munic_22_pol.fid-703dc0a5_191866d88cb_-1927,1701051,Angico - TO,2055,2111,56,2872,71.55,73.5,1.95
sidra_9541_PercMoradDPPOColetTot_munic_22_pol.fid-703dc0a5_191866d88cb_-1926,1701101,Aparecida do Rio Negro - TO,3578,3802,224,4826,74.14,78.78,4.64
sidra_9541_PercMoradDPPOColetTot_munic_22_pol.fid-703dc0a5_191866d88cb_-1925,1701309,Aragominas - TO,2178,2827,649,5283,41.23,53.51,12.28
sidra_9541_PercMoradDPPOColetTot_munic_22_pol.fid-703dc0a5_191866d88cb_-1923,1701903,Araguacema - TO,4049,4055,6,5914,68.46,68.57,0.1
sidra_9541_PercMoradDPPOColetTot_munic_22_pol.fid-703dc0a5_191866d88cb_-1921,1702000,Araguaçu - TO,5876,5973,97,8058,72.92,74.13,1.2
sidra_9541_PercMoradDPPOColetTot_munic_22_pol.fid-703dc0a5_191866d88cb_-191f,1702109,Araguaína - TO,160628,163233,2605,170778,94.06,95.58,1.53
sidra_9541_PercMoradDPPOColetTot_munic_22_pol.fid-703dc0a5_191866d88cb_-191d,1702158,Araguanã - TO,3652,3690,38,4300,84.93,85.81,0.88
sidra_9541_PercMoradDPPOColetTot_munic_22_pol.fid-703dc0a5_191866d88cb_-1919,1702208,Araguatins - TO,22370,22600,230,31834,70.27,70.99,0.72
sidra_9541_PercMoradDPPOColetTot_munic_22_pol.fid-703dc0a5_191866d88cb_-1917,1702307,Arapoema - TO,4527,4799,272,5542,81.69,86.59,4.91
sidra_9541_PercMoradDPPOColetTot_munic_22_pol.fid-703dc0a5_191866d88cb_-1915,1702406,Arraias - TO,6645,7004,359,10194,65.19,68.71,3.52
sidra_9541_PercMoradDPPOColetTot_munic_22_pol.fid-703dc0a5_191866d88cb_-1914,1702554,Augustinópolis - TO,13876,15659,1783,17405,79.72,89.97,10.24
sidra_9541_PercMoradDPPOColetTot_munic_22_pol.fid-703dc0a5_191866d88cb_-1913,1702703,Aurora do Tocantins - TO,2123,2310,187,3340,63.56,69.16,5.6
sidra_9541_PercMoradDPPOColetTot_munic_22_pol.fid-703dc0a5_191866d88cb_-1911,1702901,Axixá do Tocantins - TO,7812,8013,201,10259,76.15,78.11,1.96
sidra_9541_PercMoradDPPOColetTot_munic_22_pol.fid-703dc0a5_191866d88cb_-1910,1703008,Babaçulândia - TO,4526,4568,42,7875,57.47,58.01,0.53
sidra_9541_PercMoradDPPOColetTot_munic_22_pol.fid-703dc0a5_191866d88cb_-190f,1703057,Bandeirantes do Tocantins - TO,2260,2377,117,3397,66.53,69.97,3.44
sidra_9541_PercMoradDPPOColetTot_munic_22_pol.fid-703dc0a5_191866d88cb_-190c,1703073,Barra do Ouro - TO,2049,3295,1246,4475,45.79,73.63,27.84
sidra_9541_PercMoradDPPOColetTot_munic_22_pol.fid-703dc0a5_191866d88cb_-190a,1703107,Barrolândia - TO,3255,4111,856,4797,67.85,85.7,17.84
sidra_9541_PercMoradDPPOColetTot_munic_22_pol.fid-703dc0a5_191866d88cb_-1909,1703206,Bernardo Sayão - TO,2814,2886,72,4221,66.67,68.37,1.71
sidra_9541_PercMoradDPPOColetTot_munic_22_pol.fid-703dc0a5_191866d88cb_-1907,1703305,Bom Jesus do Tocantins - TO,3229,3307,78,4037,79.99,81.92,1.93
sidra_9541_PercMoradDPPOColetTot_munic_22_pol.fid-703dc0a5_191866d88cb_-1906,1703602,Brasilândia do Tocantins - TO,1552,1571,19,1974,78.62,79.58,0.96
sidra_9541_PercMoradDPPOColetTot_munic_22_pol.fid-703dc0a5_191866d88cb_-1904,1703701,Brejinho de Nazaré - TO,3775,3791,16,4723,79.93,80.27,0.34
sidra_9541_PercMoradDPPOColetTot_munic_22_pol.fid-703dc0a5_191866d88cb_-1903,1703800,Buriti do Tocantins - TO,9312,9316,4,10303,90.38,90.42,0.04
sidra_9541_PercMoradDPPOColetTot_munic_22_pol.fid-703dc0a5_191866d88cb_-1902,1703826,Cachoeirinha - TO,1530,1540,10,1961,78.02,78.53,0.51
sidra_9541_PercMoradDPPOColetTot_munic_22_pol.fid-703dc0a5_191866d88cb_-1901,1703842,Campos Lindos - TO,5688,5787,99,8623,65.96,67.11,1.15
sidra_9541_PercMoradDPPOColetTot_munic_22_pol.fid-703dc0a5_191866d88cb_-18ff,1703867,Cariri do Tocantins - TO,2589,2706,117,3628,71.36,74.59,3.22
sidra_9541_PercMoradDPPOColetTot_munic_22_pol.fid-703dc0a5_191866d88cb_-18fd,1703883,Carmolândia - TO,1879,1916,37,2198,85.49,87.17,1.68
sidra_9541_PercMoradDPPOColetTot_munic_22_pol.fid-703dc0a5_191866d88cb_-18fc,1703891,Carrasco Bonito - TO,1778,2564,786,3318,53.59,77.28,23.69
sidra_9541_PercMoradDPPOColetTot_munic_22_pol.fid-703dc0a5_191866d88cb_-18fb,1703909,Caseara - TO,3189,3194,5,4818,66.19,66.29,0.1
sidra_9541_PercMoradDPPOColetTot_munic_22_pol.fid-703dc0a5_191866d88cb_-18fa,1704105,Centenário - TO,1392,1392,,2131,65.32,65.32,
sidra_9541_PercMoradDPPOColetTot_munic_22_pol.fid-703dc0a5_191866d88cb_-18f8,1704600,Chapada de Areia - TO,878,997,119,1499,58.57,66.51,7.94
sidra_9541_PercMoradDPPOColetTot_munic_22_pol.fid-703dc0a5_191866d88cb_-18f6,1705102,Chapada da Natividade - TO,1794,1830,36,3117,57.56,58.71,1.15
sidra_9541_PercMoradDPPOColetTot_munic_22_pol.fid-703dc0a5_191866d88cb_-18f4,1705508,Colinas do Tocantins - TO,32560,32832,272,34092,95.51,96.3,0.8
sidra_9541_PercMoradDPPOColetTot_munic_22_pol.fid-703dc0a5_191866d88cb_-18f3,1705557,Combinado - TO,3694,4134,440,4732,78.06,87.36,9.3
sidra_9541_PercMoradDPPOColetTot_munic_22_pol.fid-703dc0a5_191866d88cb_-18f2,1705607,Conceição do Tocantins - TO,2653,2749,96,3874,68.48,70.96,2.48
sidra_9541_PercMoradDPPOColetTot_munic_22_pol.fid-703dc0a5_191866d88cb_-18f1,1706001,Couto Magalhães - TO,3294,3546,252,5327,61.84,66.57,4.73
sidra_9541_PercMoradDPPOColetTot_munic_22_pol.fid-703dc0a5_191866d88cb_-18f0,1706100,Cristalândia - TO,4904,5153,249,6330,77.47,81.41,3.93
sidra_9541_PercMoradDPPOColetTot_munic_22_pol.fid-703dc0a5_191866d88cb_-18ee,1706258,Crixás do Tocantins - TO,992,992,,1462,67.85,67.85,
sidra_9541_PercMoradDPPOColetTot_munic_22_pol.fid-703dc0a5_191866d88cb_-18ed,1706506,Darcinópolis - TO,4125,4172,47,5807,71.03,71.84,0.81
sidra_9541_PercMoradDPPOColetTot_munic_22_pol.fid-703dc0a5_191866d88cb_-18ec,1707009,Dianópolis - TO,15178,15426,248,17679,85.85,87.26,1.4
sidra_9541_PercMoradDPPOColetTot_munic_22_pol.fid-703dc0a5_191866d88cb_-18ea,1707108,Divinópolis do Tocantins - TO,5204,5303,99,7011,74.23,75.64,1.41
sidra_9541_PercMoradDPPOColetTot_munic_22_pol.fid-703dc0a5_191866d88cb_-18e9,1707207,Dois Irmãos do Tocantins - TO,3106,3415,309,6327,49.09,53.98,4.88
sidra_9541_PercMoradDPPOColetTot_munic_22_pol.fid-703dc0a5_191866d88cb_-18e8,1707306,Dueré - TO,2824,3026,202,4241,66.59,71.35,4.76
sidra_9541_PercMoradDPPOColetTot_munic_22_pol.fid-703dc0a5_191866d88cb_-18e6,1707405,Esperantina - TO,3656,5288,1632,7525,48.58,70.27,21.69
sidra_9541_PercMoradDPPOColetTot_munic_22_pol.fid-703dc0a5_191866d88cb_-18e5,1707553,Fátima - TO,2893,2959,66,3452,83.81,85.72,1.91
sidra_9541_PercMoradDPPOColetTot_munic_22_pol.fid-703dc0a5_191866d88cb_-18e4,1707652,Figueirópolis - TO,4097,4170,73,5205,78.71,80.12,1.4
sidra_9541_PercMoradDPPOColetTot_munic_22_pol.fid-703dc0a5_191866d88cb_-18e2,1707702,Filadélfia - TO,4825,4906,81,7707,62.61,63.66,1.05
sidra_9541_PercMoradDPPOColetTot_munic_22_pol.fid-703dc0a5_191866d88cb_-18e1,1708205,Formoso do Araguaia - TO,12666,13686,1020,18814,67.32,72.74,5.42
sidra_9541_PercMoradDPPOColetTot_munic_22_pol.fid-703dc0a5_191866d88cb_-18df,1708254,Tabocão - TO,2812,2821,9,3451,81.48,81.74,0.26
sidra_9541_PercMoradDPPOColetTot_munic_22_pol.fid-703dc0a5_191866d88cb_-18de,1708304,Goianorte - TO,3125,3272,147,4738,65.96,69.06,3.1
sidra_9541_PercMoradDPPOColetTot_munic_22_pol.fid-703dc0a5_191866d88cb_-18dd,1709005,Goiatins - TO,5982,6015,33,12411,48.2,48.47,0.27
sidra_9541_PercMoradDPPOColetTot_munic_22_pol.fid-703dc0a5_191866d88cb_-18db,1709302,Guaraí - TO,22483,22588,105,24646,91.22,91.65,0.43
sidra_9541_PercMoradDPPOColetTot_munic_22_pol.fid-703dc0a5_191866d88cb_-18d9,1709500,Gurupi - TO,82593,83325,732,85026,97.14,98,0.86
sidra_9541_PercMoradDPPOColetTot_munic_22_pol.fid-703dc0a5_191866d88cb_-18d8,1709807,Ipueiras - TO,1022,1027,5,1586,64.44,64.75,0.32
sidra_9541_PercMoradDPPOColetTot_munic_22_pol.fid-703dc0a5_191866d88cb_-18d7,1710508,Itacajá - TO,4719,4838,119,6819,69.2,70.95,1.75
sidra_9541_PercMoradDPPOColetTot_munic_22_pol.fid-703dc0a5_191866d88cb_-18d5,1710706,Itaguatins - TO,2873,3030,157,5167,55.6,58.64,3.04
sidra_9541_PercMoradDPPOColetTot_munic_22_pol.fid-703dc0a5_191866d88cb_-18d4,1710904,Itapiratins - TO,2398,2413,15,3575,67.08,67.5,0.42
sidra_9541_PercMoradDPPOColetTot_munic_22_pol.fid-703dc0a5_191866d88cb_-18d3,1711100,Itaporã do Tocantins - TO,1559,1563,4,2366,65.89,66.06,0.17
sidra_9541_PercMoradDPPOColetTot_munic_22_pol.fid-703dc0a5_191866d88cb_-18d1,1711506,Jaú do Tocantins - TO,1844,1925,81,3332,55.34,57.77,2.43
sidra_9541_PercMoradDPPOColetTot_munic_22_pol.fid-703dc0a5_191866d88cb_-18cf,1711803,Juarina - TO,1177,1325,148,2243,52.47,59.07,6.6
sidra_9541_PercMoradDPPOColetTot_munic_22_pol.fid-703dc0a5_191866d88cb_-18ce,1711902,Lagoa da Confusão - TO,12391,12405,14,15244,81.28,81.38,0.09
sidra_9541_PercMoradDPPOColetTot_munic_22_pol.fid-703dc0a5_191866d88cb_-18cd,1711951,Lagoa do Tocantins - TO,2488,2500,12,3516,70.76,71.1,0.34
sidra_9541_PercMoradDPPOColetTot_munic_22_pol.fid-703dc0a5_191866d88cb_-18cb,1712009,Lajeado - TO,2991,2998,7,3334,89.71,89.92,0.21
sidra_9541_PercMoradDPPOColetTot_munic_22_pol.fid-703dc0a5_191866d88cb_-18ca,1712157,Lavandeira - TO,1080,1101,21,1626,66.42,67.71,1.29
sidra_9541_PercMoradDPPOColetTot_munic_22_pol.fid-703dc0a5_191866d88cb_-18c9,1712405,Lizarda - TO,1692,1765,73,2994,56.51,58.95,2.44
sidra_9541_PercMoradDPPOColetTot_munic_22_pol.fid-703dc0a5_191866d88cb_-18c8,1712454,Luzinópolis - TO,1551,2142,591,2699,57.47,79.36,21.9
sidra_9541_PercMoradDPPOColetTot_munic_22_pol.fid-703dc0a5_191866d88cb_-18c7,1712504,Marianópolis do Tocantins - TO,2901,2906,5,4533,64,64.11,0.11
sidra_9541_PercMoradDPPOColetTot_munic_22_pol.fid-703dc0a5_191866d88cb_-18c5,1712702,Mateiros - TO,1730,1795,65,2718,63.65,66.04,2.39
sidra_9541_PercMoradDPPOColetTot_munic_22_pol.fid-703dc0a5_191866d88cb_-18c4,1712801,Maurilândia do Tocantins - TO,1459,2126,667,3094,47.16,68.71,21.56
sidra_9541_PercMoradDPPOColetTot_munic_22_pol.fid-703dc0a5_191866d88cb_-18c3,1713205,Miracema do Tocantins - TO,15145,15527,382,18439,82.14,84.21,2.07
sidra_9541_PercMoradDPPOColetTot_munic_22_pol.fid-703dc0a5_191866d88cb_-18c2,1713304,Miranorte - TO,11269,11391,122,12663,88.99,89.95,0.96
sidra_9541_PercMoradDPPOColetTot_munic_22_pol.fid-703dc0a5_191866d88cb_-18c1,1713601,Monte do Carmo - TO,2716,2995,279,5686,47.77,52.67,4.91
sidra_9541_PercMoradDPPOColetTot_munic_22_pol.fid-703dc0a5_191866d88cb_-18bf,1713700,Monte Santo do Tocantins - TO,1056,1351,295,2395,44.09,56.41,12.32
sidra_9541_PercMoradDPPOColetTot_munic_22_pol.fid-703dc0a5_191866d88cb_-18be,1713809,Palmeiras do Tocantins - TO,3107,3113,6,4869,63.81,63.94,0.12
sidra_9541_PercMoradDPPOColetTot_munic_22_pol.fid-703dc0a5_191866d88cb_-18bd,1713957,Muricilândia - TO,2118,2160,42,3353,63.17,64.42,1.25
sidra_9541_PercMoradDPPOColetTot_munic_22_pol.fid-703dc0a5_191866d88cb_-18bc,1714203,Natividade - TO,6163,7241,1078,8737,70.54,82.88,12.34
sidra_9541_PercMoradDPPOColetTot_munic_22_pol.fid-703dc0a5_191866d88cb_-18b9,1714302,Nazaré - TO,3123,3613,490,4515,69.17,80.02,10.85
sidra_9541_PercMoradDPPOColetTot_munic_22_pol.fid-703dc0a5_191866d88cb_-18b8,1714880,Nova Olinda - TO,7609,7666,57,10352,73.5,74.05,0.55
sidra_9541_PercMoradDPPOColetTot_munic_22_pol.fid-703dc0a5_191866d88cb_-18b7,1715002,Nova Rosalândia - TO,2703,2801,98,3353,80.61,83.54,2.92
sidra_9541_PercMoradDPPOColetTot_munic_22_pol.fid-703dc0a5_191866d88cb_-18b6,1715101,Novo Acordo - TO,3116,3134,18,3956,78.77,79.22,0.46
sidra_9541_PercMoradDPPOColetTot_munic_22_pol.fid-703dc0a5_191866d88cb_-18b4,1715150,Novo Alegre - TO,1373,1378,5,1843,74.5,74.77,0.27
sidra_9541_PercMoradDPPOColetTot_munic_22_pol.fid-703dc0a5_191866d88cb_-18b3,1715259,Novo Jardim - TO,1827,1835,8,2210,82.67,83.03,0.36
sidra_9541_PercMoradDPPOColetTot_munic_22_pol.fid-703dc0a5_191866d88cb_-18b1,1715507,Oliveira de Fátima - TO,983,983,,1164,84.45,84.45,
sidra_9541_PercMoradDPPOColetTot_munic_22_pol.fid-703dc0a5_191866d88cb_-18af,1715705,Palmeirante - TO,2332,2402,70,4786,48.73,50.19,1.46
sidra_9541_PercMoradDPPOColetTot_munic_22_pol.fid-703dc0a5_191866d88cb_-18ac,1715754,Palmeirópolis - TO,5775,5915,140,6940,83.21,85.23,2.02
sidra_9541_PercMoradDPPOColetTot_munic_22_pol.fid-703dc0a5_191866d88cb_-18ab,1716109,Paraíso do Tocantins - TO,47983,50269,2286,52134,92.04,96.42,4.38
sidra_9541_PercMoradDPPOColetTot_munic_22_pol.fid-703dc0a5_191866d88cb_-18a9,1716208,Paranã - TO,6121,6164,43,10521,58.18,58.59,0.41
sidra_9541_PercMoradDPPOColetTot_munic_22_pol.fid-703dc0a5_191866d88cb_-18a5,1716307,Pau D'Arco - TO,2842,2862,20,4040,70.35,70.84,0.5
sidra_9541_PercMoradDPPOColetTot_munic_22_pol.fid-703dc0a5_191866d88cb_-18a2,1716505,Pedro Afonso - TO,12430,12638,208,13966,89,90.49,1.49
sidra_9541_PercMoradDPPOColetTot_munic_22_pol.fid-703dc0a5_191866d88cb_-18a0,1716604,Peixe - TO,5684,5870,186,9286,61.21,63.21,2
sidra_9541_PercMoradDPPOColetTot_munic_22_pol.fid-703dc0a5_191866d88cb_-189d,1716653,Pequizeiro - TO,2557,2645,88,4921,51.96,53.75,1.79
sidra_9541_PercMoradDPPOColetTot_munic_22_pol.fid-703dc0a5_191866d88cb_-189b,1716703,Colméia - TO,6863,7197,334,8892,77.18,80.94,3.76
sidra_9541_PercMoradDPPOColetTot_munic_22_pol.fid-703dc0a5_191866d88cb_-1899,1717008,Pindorama do Tocantins - TO,2877,2926,49,4469,64.38,65.47,1.1
sidra_9541_PercMoradDPPOColetTot_munic_22_pol.fid-703dc0a5_191866d88cb_-1895,1717206,Piraquê - TO,1083,1157,74,2281,47.48,50.72,3.24
sidra_9541_PercMoradDPPOColetTot_munic_22_pol.fid-703dc0a5_191866d88cb_-1892,1717503,Pium - TO,4220,4246,26,7115,59.31,59.68,0.37
sidra_9541_PercMoradDPPOColetTot_munic_22_pol.fid-703dc0a5_191866d88cb_-1890,1717800,Ponte Alta do Bom Jesus - TO,2356,2733,377,4212,55.94,64.89,8.95
sidra_9541_PercMoradDPPOColetTot_munic_22_pol.fid-703dc0a5_191866d88cb_-188f,1717909,Ponte Alta do Tocantins - TO,5053,5173,120,7536,67.05,68.64,1.59
sidra_9541_PercMoradDPPOColetTot_munic_22_pol.fid-703dc0a5_191866d88cb_-188d,1718006,Porto Alegre do Tocantins - TO,2087,2113,26,2865,72.84,73.75,0.91
sidra_9541_PercMoradDPPOColetTot_munic_22_pol.fid-703dc0a5_191866d88cb_-188c,1718204,Porto Nacional - TO,56337,58759,2422,64233,87.71,91.48,3.77
sidra_9541_PercMoradDPPOColetTot_munic_22_pol.fid-703dc0a5_191866d88cb_-188a,1718303,Praia Norte - TO,4570,5119,549,9031,50.6,56.68,6.08
sidra_9541_PercMoradDPPOColetTot_munic_22_pol.fid-703dc0a5_191866d88cb_-1889,1718402,Presidente Kennedy - TO,2531,2602,71,3045,83.12,85.45,2.33
sidra_9541_PercMoradDPPOColetTot_munic_22_pol.fid-703dc0a5_191866d88cb_-1887,1718451,Pugmil - TO,1751,1813,62,2187,80.06,82.9,2.83
sidra_9541_PercMoradDPPOColetTot_munic_22_pol.fid-703dc0a5_191866d88cb_-1885,1718501,Recursolândia - TO,1780,1780,,3419,52.06,52.06,
sidra_9541_PercMoradDPPOColetTot_munic_22_pol.fid-703dc0a5_191866d88cb_-1884,1718550,Riachinho - TO,542,2536,1994,3953,13.71,64.15,50.44
sidra_9541_PercMoradDPPOColetTot_munic_22_pol.fid-703dc0a5_191866d88cb_-1882,1718659,Rio da Conceição - TO,1600,1615,15,1751,91.38,92.23,0.86
sidra_9541_PercMoradDPPOColetTot_munic_22_pol.fid-703dc0a5_191866d88cb_-1881,1718709,Rio dos Bois - TO,1485,1652,167,2738,54.24,60.34,6.1
sidra_9541_PercMoradDPPOColetTot_munic_22_pol.fid-703dc0a5_191866d88cb_-1880,1718758,Rio Sono - TO,2420,2834,414,4841,49.99,58.54,8.55
sidra_9541_PercMoradDPPOColetTot_munic_22_pol.fid-703dc0a5_191866d88cb_-187e,1718808,Sampaio - TO,3306,3327,21,4205,78.62,79.12,0.5
sidra_9541_PercMoradDPPOColetTot_munic_22_pol.fid-703dc0a5_191866d88cb_-187d,1718840,Sandolândia - TO,2460,2496,36,3703,66.43,67.4,0.97
sidra_9541_PercMoradDPPOColetTot_munic_22_pol.fid-703dc0a5_191866d88cb_-187b,1718865,Santa Fé do Araguaia - TO,5680,5861,181,7149,79.45,81.98,2.53
sidra_9541_PercMoradDPPOColetTot_munic_22_pol.fid-703dc0a5_191866d88cb_-1879,1718881,Santa Maria do Tocantins - TO,1808,1839,31,2657,68.05,69.21,1.17
sidra_9541_PercMoradDPPOColetTot_munic_22_pol.fid-703dc0a5_191866d88cb_-1878,1718899,Santa Rita do Tocantins - TO,1012,1044,32,2210,45.79,47.24,1.45
sidra_9541_PercMoradDPPOColetTot_munic_22_pol.fid-703dc0a5_191866d88cb_-1876,1718907,Santa Rosa do Tocantins - TO,3097,3105,8,4653,66.56,66.73,0.17
sidra_9541_PercMoradDPPOColetTot_munic_22_pol.fid-703dc0a5_191866d88cb_-1874,1719004,Santa Tereza do Tocantins - TO,2092,2203,111,2781,75.22,79.22,3.99
sidra_9541_PercMoradDPPOColetTot_munic_22_pol.fid-703dc0a5_191866d88cb_-1873,1720002,Santa Terezinha do Tocantins - TO,1564,1571,7,2406,65,65.3,0.29
sidra_9541_PercMoradDPPOColetTot_munic_22_pol.fid-703dc0a5_191866d88cb_-1872,1720101,São Bento do Tocantins - TO,3380,3754,374,5631,60.02,66.67,6.64
sidra_9541_PercMoradDPPOColetTot_munic_22_pol.fid-703dc0a5_191866d88cb_-1870,1720150,São Félix do Tocantins - TO,1376,1386,10,1771,77.7,78.26,0.56
sidra_9541_PercMoradDPPOColetTot_munic_22_pol.fid-703dc0a5_191866d88cb_-186e,1720200,São Miguel do Tocantins - TO,9707,10272,565,13233,73.35,77.62,4.27
sidra_9541_PercMoradDPPOColetTot_munic_22_pol.fid-703dc0a5_191866d88cb_-186d,1720259,São Salvador do Tocantins - TO,1520,1522,2,2382,63.81,63.9,0.08
sidra_9541_PercMoradDPPOColetTot_munic_22_pol.fid-703dc0a5_191866d88cb_-186b,1720309,São Sebastião do Tocantins - TO,3121,3121,,4100,76.12,76.12,
sidra_9541_PercMoradDPPOColetTot_munic_22_pol.fid-703dc0a5_191866d88cb_-1869,1720499,São Valério - TO,2941,2995,54,4413,66.64,67.87,1.22
sidra_9541_PercMoradDPPOColetTot_munic_22_pol.fid-703dc0a5_191866d88cb_-1868,1720655,Silvanópolis - TO,4242,4249,7,5108,83.05,83.18,0.14
sidra_9541_PercMoradDPPOColetTot_munic_22_pol.fid-703dc0a5_191866d88cb_-1867,1720804,Sítio Novo do Tocantins - TO,6201,6581,380,10814,57.34,60.86,3.51
sidra_9541_PercMoradDPPOColetTot_munic_22_pol.fid-703dc0a5_191866d88cb_-1866,1720853,Sucupira - TO,1138,1138,,1577,72.16,72.16,
sidra_9541_PercMoradDPPOColetTot_munic_22_pol.fid-703dc0a5_191866d88cb_-1864,1720903,Taguatinga - TO,10303,10412,109,13957,73.82,74.6,0.78
sidra_9541_PercMoradDPPOColetTot_munic_22_pol.fid-703dc0a5_191866d88cb_-1862,1720937,Taipas do Tocantins - TO,1561,1561,,2019,77.32,77.32,
sidra_9541_PercMoradDPPOColetTot_munic_22_pol.fid-703dc0a5_191866d88cb_-1861,1720978,Talismã - TO,1589,1603,14,2436,65.23,65.8,0.57
sidra_9541_PercMoradDPPOColetTot_munic_22_pol.fid-703dc0a5_191866d88cb_-185f,1721000,Palmas - TO,249521,297651,48130,301512,82.76,98.72,15.96
sidra_9541_PercMoradDPPOColetTot_munic_22_pol.fid-703dc0a5_191866d88cb_-185e,1721109,Tocantínia - TO,3104,3251,147,7439,41.73,43.7,1.98
sidra_9541_PercMoradDPPOColetTot_munic_22_pol.fid-703dc0a5_191866d88cb_-185d,1721208,Tocantinópolis - TO,18294,21335,3041,22474,81.4,94.93,13.53
sidra_9541_PercMoradDPPOColetTot_munic_22_pol.fid-703dc0a5_191866d88cb_-185c,1721257,Tupirama - TO,1307,1363,56,1909,68.47,71.4,2.93
sidra_9541_PercMoradDPPOColetTot_munic_22_pol.fid-703dc0a5_191866d88cb_-185b,1721307,Tupiratins - TO,1098,1103,5,1865,58.87,59.14,0.27
sidra_9541_PercMoradDPPOColetTot_munic_22_pol.fid-703dc0a5_191866d88cb_-185a,1722081,Wanderlândia - TO,7818,8936,1118,10506,74.41,85.06,10.64
sidra_9541_PercMoradDPPOColetTot_munic_22_pol.fid-703dc0a5_191866d88cb_-1859,1722107,Xambioá - TO,8226,8738,512,10503,78.32,83.2,4.87
sidra_9541_PercMoradDPPOColetTot_munic_22_pol.fid-703dc0a5_191866d88cb_-1858,2100055,Açailândia - MA,95127,96255,1128,106200,89.57,90.64,1.06
sidra_9541_PercMoradDPPOColetTot_munic_22_pol.fid-703dc0a5_191866d88cb_-1854,2100105,Afonso Cunha - MA,2418,2449,31,6132,39.43,39.94,0.51
sidra_9541_PercMoradDPPOColetTot_munic_22_pol.fid-703dc0a5_191866d88cb_-1853,2100154,Água Doce do Maranhão - MA,3821,5270,1449,12137,31.48,43.42,11.94
sidra_9541_PercMoradDPPOColetTot_munic_22_pol.fid-703dc0a5_191866d88cb_-1852,2100204,Alcântara - MA,3778,5557,1779,18460,20.47,30.1,9.64
sidra_9541_PercMoradDPPOColetTot_munic_22_pol.fid-703dc0a5_191866d88cb_-1851,2100303,Aldeias Altas - MA,12241,13729,1488,23283,52.57,58.97,6.39
sidra_9541_PercMoradDPPOColetTot_munic_22_pol.fid-703dc0a5_191866d88cb_-1850,2100402,Altamira do Maranhão - MA,3514,4723,1209,6446,54.51,73.27,18.76
sidra_9541_PercMoradDPPOColetTot_munic_22_pol.fid-703dc0a5_191866d88cb_-184f,2100436,Alto Alegre do Maranhão - MA,15162,17419,2257,24019,63.13,72.52,9.4
sidra_9541_PercMoradDPPOColetTot_munic_22_pol.fid-703dc0a5_191866d88cb_-184e,2100477,Alto Alegre do Pindaré - MA,17297,17713,416,25611,67.54,69.16,1.62
sidra_9541_PercMoradDPPOColetTot_munic_22_pol.fid-703dc0a5_191866d88cb_-184d,2100501,Alto Parnaíba - MA,7134,7902,768,11045,64.59,71.54,6.95
sidra_9541_PercMoradDPPOColetTot_munic_22_pol.fid-703dc0a5_191866d88cb_-184c,2100550,Amapá do Maranhão - MA,4828,4897,69,7170,67.34,68.3,0.96
sidra_9541_PercMoradDPPOColetTot_munic_22_pol.fid-703dc0a5_191866d88cb_-184b,2100600,Amarante do Maranhão - MA,17412,17469,57,37039,47.01,47.16,0.15
sidra_9541_PercMoradDPPOColetTot_munic_22_pol.fid-703dc0a5_191866d88cb_-184a,2100709,Anajatuba - MA,6731,9522,2791,25312,26.59,37.62,11.03
sidra_9541_PercMoradDPPOColetTot_munic_22_pol.fid-703dc0a5_191866d88cb_-1849,2100808,Anapurus - MA,5016,5318,302,13759,36.46,38.65,2.19
sidra_9541_PercMoradDPPOColetTot_munic_22_pol.fid-703dc0a5_191866d88cb_-1848,2100832,Apicum-Açu - MA,7983,8594,611,17487,45.65,49.15,3.49
sidra_9541_PercMoradDPPOColetTot_munic_22_pol.fid-703dc0a5_191866d88cb_-1847,2100873,Araguanã - MA,4039,5515,1476,11176,36.14,49.35,13.21
sidra_9541_PercMoradDPPOColetTot_munic_22_pol.fid-703dc0a5_191866d88cb_-1846,2100907,Araioses - MA,12638,13442,804,39024,32.39,34.45,2.06
sidra_9541_PercMoradDPPOColetTot_munic_22_pol.fid-703dc0a5_191866d88cb_-1845,2100956,Arame - MA,8668,10585,1917,25478,34.02,41.55,7.52
sidra_9541_PercMoradDPPOColetTot_munic_22_pol.fid-703dc0a5_191866d88cb_-1844,2101004,Arari - MA,15983,17151,1168,29444,54.28,58.25,3.97
sidra_9541_PercMoradDPPOColetTot_munic_22_pol.fid-703dc0a5_191866d88cb_-1843,2101103,Axixá - MA,3523,3653,130,11779,29.91,31.01,1.1
sidra_9541_PercMoradDPPOColetTot_munic_22_pol.fid-703dc0a5_191866d88cb_-1842,2101202,Bacabal - MA,76472,81255,4783,103505,73.88,78.5,4.62
sidra_9541_PercMoradDPPOColetTot_munic_22_pol.fid-703dc0a5_191866d88cb_-1841,2101251,Bacabeira - MA,13591,13835,244,16956,80.15,81.59,1.44
sidra_9541_PercMoradDPPOColetTot_munic_22_pol.fid-703dc0a5_191866d88cb_-1840,2101301,Bacuri - MA,4024,4546,522,16254,24.76,27.97,3.21
sidra_9541_PercMoradDPPOColetTot_munic_22_pol.fid-703dc0a5_191866d88cb_-183f,2101350,Bacurituba - MA,365,661,296,5250,6.95,12.59,5.64
sidra_9541_PercMoradDPPOColetTot_munic_22_pol.fid-703dc0a5_191866d88cb_-183e,2101400,Balsas - MA,87944,89081,1137,101337,86.78,87.91,1.12
sidra_9541_PercMoradDPPOColetTot_munic_22_pol.fid-703dc0a5_191866d88cb_-183d,2101509,Barão de Grajaú - MA,11944,12216,272,18957,63.01,64.44,1.43
sidra_9541_PercMoradDPPOColetTot_munic_22_pol.fid-703dc0a5_191866d88cb_-183c,2101608,Barra do Corda - MA,51804,56253,4449,84418,61.37,66.64,5.27
sidra_9541_PercMoradDPPOColetTot_munic_22_pol.fid-703dc0a5_191866d88cb_-183b,2101707,Barreirinhas - MA,25142,31922,6780,65461,38.41,48.76,10.36
sidra_9541_PercMoradDPPOColetTot_munic_22_pol.fid-703dc0a5_191866d88cb_-183a,2101731,Belágua - MA,1900,2427,527,8460,22.46,28.69,6.23
sidra_9541_PercMoradDPPOColetTot_munic_22_pol.fid-703dc0a5_191866d88cb_-1839,2101772,Bela Vista do Maranhão - MA,7409,7456,47,11736,63.13,63.53,0.4
sidra_9541_PercMoradDPPOColetTot_munic_22_pol.fid-703dc0a5_191866d88cb_-1838,2101806,Benedito Leite - MA,4089,4097,8,5449,75.04,75.19,0.15
sidra_9541_PercMoradDPPOColetTot_munic_22_pol.fid-703dc0a5_191866d88cb_-1837,2101905,Bequimão - MA,4182,4247,65,19516,21.43,21.76,0.33
sidra_9541_PercMoradDPPOColetTot_munic_22_pol.fid-703dc0a5_191866d88cb_-1836,2101939,Bernardo do Mearim - MA,1861,3593,1732,5840,31.87,61.52,29.66
sidra_9541_PercMoradDPPOColetTot_munic_22_pol.fid-703dc0a5_191866d88cb_-1835,2101970,Boa Vista do Gurupi - MA,4055,5873,1818,7550,53.71,77.79,24.08
sidra_9541_PercMoradDPPOColetTot_munic_22_pol.fid-703dc0a5_191866d88cb_-1834,2102002,Bom Jardim - MA,18046,19395,1349,33053,54.6,58.68,4.08
sidra_9541_PercMoradDPPOColetTot_munic_22_pol.fid-703dc0a5_191866d88cb_-1833,2102036,Bom Jesus das Selvas - MA,16670,19880,3210,28534,58.42,69.67,11.25
sidra_9541_PercMoradDPPOColetTot_munic_22_pol.fid-703dc0a5_191866d88cb_-1832,2102077,Bom Lugar - MA,4343,4827,484,12203,35.59,39.56,3.97
sidra_9541_PercMoradDPPOColetTot_munic_22_pol.fid-703dc0a5_191866d88cb_-1831,2102101,Brejo - MA,6802,7675,873,34096,19.95,22.51,2.56
sidra_9541_PercMoradDPPOColetTot_munic_22_pol.fid-703dc0a5_191866d88cb_-1830,2102150,Brejo de Areia - MA,43,3357,3314,9200,0.47,36.49,36.02
sidra_9541_PercMoradDPPOColetTot_munic_22_pol.fid-703dc0a5_191866d88cb_-182e,2102200,Buriti - MA,6807,7758,951,29628,22.97,26.18,3.21
sidra_9541_PercMoradDPPOColetTot_munic_22_pol.fid-703dc0a5_191866d88cb_-182d,2102309,Buriti Bravo - MA,13556,14647,1091,22434,60.43,65.29,4.86
sidra_9541_PercMoradDPPOColetTot_munic_22_pol.fid-703dc0a5_191866d88cb_-182c,2102325,Buriticupu - MA,35027,41320,6293,55406,63.22,74.58,11.36
sidra_9541_PercMoradDPPOColetTot_munic_22_pol.fid-703dc0a5_191866d88cb_-182b,2102358,Buritirana - MA,9236,9266,30,12900,71.6,71.83,0.23
sidra_9541_PercMoradDPPOColetTot_munic_22_pol.fid-703dc0a5_191866d88cb_-182a,2102374,Cachoeira Grande - MA,3073,3106,33,9720,31.62,31.95,0.34
sidra_9541_PercMoradDPPOColetTot_munic_22_pol.fid-703dc0a5_191866d88cb_-1829,2102408,Cajapió - MA,1573,1830,257,10121,15.54,18.08,2.54
sidra_9541_PercMoradDPPOColetTot_munic_22_pol.fid-703dc0a5_191866d88cb_-1828,2102507,Cajari - MA,3584,3632,48,16394,21.86,22.15,0.29
sidra_9541_PercMoradDPPOColetTot_munic_22_pol.fid-703dc0a5_191866d88cb_-1827,2102556,Campestre do Maranhão - MA,11094,11280,186,12257,90.51,92.03,1.52
sidra_9541_PercMoradDPPOColetTot_munic_22_pol.fid-703dc0a5_191866d88cb_-1826,2102606,Cândido Mendes - MA,9177,9420,243,19921,46.07,47.29,1.22
sidra_9541_PercMoradDPPOColetTot_munic_22_pol.fid-703dc0a5_191866d88cb_-1825,2102705,Cantanhede - MA,12509,14172,1663,24280,51.52,58.37,6.85
sidra_9541_PercMoradDPPOColetTot_munic_22_pol.fid-703dc0a5_191866d88cb_-1824,2102754,Capinzal do Norte - MA,7557,8570,1013,11370,66.46,75.37,8.91
sidra_9541_PercMoradDPPOColetTot_munic_22_pol.fid-703dc0a5_191866d88cb_-1823,2102804,Carolina - MA,17408,17574,166,23896,72.85,73.54,0.69
sidra_9541_PercMoradDPPOColetTot_munic_22_pol.fid-703dc0a5_191866d88cb_-1822,2102903,Carutapera - MA,16808,18507,1699,24229,69.37,76.38,7.01
sidra_9541_PercMoradDPPOColetTot_munic_22_pol.fid-703dc0a5_191866d88cb_-1821,2103000,Caxias - MA,108258,112571,4313,156765,69.06,71.81,2.75
sidra_9541_PercMoradDPPOColetTot_munic_22_pol.fid-703dc0a5_191866d88cb_-1820,2103109,Cedral - MA,4212,4225,13,10195,41.31,41.44,0.13
sidra_9541_PercMoradDPPOColetTot_munic_22_pol.fid-703dc0a5_191866d88cb_-181f,2103125,Central do Maranhão - MA,3103,3498,395,7082,43.82,49.39,5.58
sidra_9541_PercMoradDPPOColetTot_munic_22_pol.fid-703dc0a5_191866d88cb_-181e,2103158,Centro do Guilherme - MA,7104,7110,6,12341,57.56,57.61,0.05
sidra_9541_PercMoradDPPOColetTot_munic_22_pol.fid-703dc0a5_191866d88cb_-181d,2103174,Centro Novo do Maranhão - MA,8555,9863,1308,16241,52.68,60.73,8.05
sidra_9541_PercMoradDPPOColetTot_munic_22_pol.fid-703dc0a5_191866d88cb_-181b,2103208,Chapadinha - MA,49955,54353,4398,81248,61.48,66.9,5.41
sidra_9541_PercMoradDPPOColetTot_munic_22_pol.fid-703dc0a5_191866d88cb_-181a,2103257,Cidelândia - MA,8783,8996,213,12859,68.3,69.96,1.66
sidra_9541_PercMoradDPPOColetTot_munic_22_pol.fid-703dc0a5_191866d88cb_-1819,2103307,Codó - MA,73374,82893,9519,113993,64.37,72.72,8.35
sidra_9541_PercMoradDPPOColetTot_munic_22_pol.fid-703dc0a5_191866d88cb_-1818,2103406,Coelho Neto - MA,29444,30297,853,41635,70.72,72.77,2.05
sidra_9541_PercMoradDPPOColetTot_munic_22_pol.fid-703dc0a5_191866d88cb_-1817,2103505,Colinas - MA,24167,24495,328,40201,60.12,60.93,0.82
sidra_9541_PercMoradDPPOColetTot_munic_22_pol.fid-703dc0a5_191866d88cb_-1816,2103554,Conceição do Lago-Açu - MA,4771,6251,1480,14898,32.02,41.96,9.93
sidra_9541_PercMoradDPPOColetTot_munic_22_pol.fid-703dc0a5_191866d88cb_-1815,2103604,Coroatá - MA,33688,35398,1710,59338,56.77,59.65,2.88
sidra_9541_PercMoradDPPOColetTot_munic_22_pol.fid-703dc0a5_191866d88cb_-1813,2103703,Cururupu - MA,20671,20917,246,31439,65.75,66.53,0.78
sidra_9541_PercMoradDPPOColetTot_munic_22_pol.fid-703dc0a5_191866d88cb_-1812,2103752,Davinópolis - MA,11454,12203,749,14274,80.24,85.49,5.25
sidra_9541_PercMoradDPPOColetTot_munic_22_pol.fid-703dc0a5_191866d88cb_-1811,2103802,Dom Pedro - MA,14894,17144,2250,23016,64.71,74.49,9.78
sidra_9541_PercMoradDPPOColetTot_munic_22_pol.fid-703dc0a5_191866d88cb_-1810,2103901,Duque Bacelar - MA,3991,4295,304,10218,39.06,42.03,2.98
sidra_9541_PercMoradDPPOColetTot_munic_22_pol.fid-703dc0a5_191866d88cb_-180f,2104008,Esperantinópolis - MA,9246,11945,2699,18299,50.53,65.28,14.75
sidra_9541_PercMoradDPPOColetTot_munic_22_pol.fid-703dc0a5_191866d88cb_-180e,2104057,Estreito - MA,24258,25497,1239,33268,72.92,76.64,3.72
sidra_9541_PercMoradDPPOColetTot_munic_22_pol.fid-703dc0a5_191866d88cb_-180d,2104073,Feira Nova do Maranhão - MA,3439,3450,11,8048,42.73,42.87,0.14
sidra_9541_PercMoradDPPOColetTot_munic_22_pol.fid-703dc0a5_191866d88cb_-180c,2104081,Fernando Falcão - MA,2790,2906,116,10861,25.69,26.76,1.07
sidra_9541_PercMoradDPPOColetTot_munic_22_pol.fid-703dc0a5_191866d88cb_-180b,2104099,Formosa da Serra Negra - MA,5696,5799,103,17675,32.23,32.81,0.58
sidra_9541_PercMoradDPPOColetTot_munic_22_pol.fid-703dc0a5_191866d88cb_-180a,2104107,Fortaleza dos Nogueiras - MA,7895,8071,176,12618,62.57,63.96,1.39
sidra_9541_PercMoradDPPOColetTot_munic_22_pol.fid-703dc0a5_191866d88cb_-1809,2104206,Fortuna - MA,9065,9431,366,16971,53.41,55.57,2.16
sidra_9541_PercMoradDPPOColetTot_munic_22_pol.fid-703dc0a5_191866d88cb_-1808,2104305,Godofredo Viana - MA,7985,7999,14,10147,78.69,78.83,0.14
sidra_9541_PercMoradDPPOColetTot_munic_22_pol.fid-703dc0a5_191866d88cb_-1807,2104404,Gonçalves Dias - MA,6518,7669,1151,17195,37.91,44.6,6.69
sidra_9541_PercMoradDPPOColetTot_munic_22_pol.fid-703dc0a5_191866d88cb_-1806,2104503,Governador Archer - MA,7260,7260,,10227,70.99,70.99,
sidra_9541_PercMoradDPPOColetTot_munic_22_pol.fid-703dc0a5_191866d88cb_-1805,2104552,Governador Edison Lobão - MA,13746,15050,1304,18279,75.2,82.33,7.13
sidra_9541_PercMoradDPPOColetTot_munic_22_pol.fid-703dc0a5_191866d88cb_-1804,2104602,Governador Eugênio Barros - MA,6455,6482,27,13925,46.36,46.55,0.19
sidra_9541_PercMoradDPPOColetTot_munic_22_pol.fid-703dc0a5_191866d88cb_-1803,2104628,Governador Luiz Rocha - MA,4210,4481,271,7061,59.62,63.46,3.84
sidra_9541_PercMoradDPPOColetTot_munic_22_pol.fid-703dc0a5_191866d88cb_-1802,2104651,Governador Newton Bello - MA,6240,6313,73,10704,58.3,58.98,0.68
sidra_9541_PercMoradDPPOColetTot_munic_22_pol.fid-703dc0a5_191866d88cb_-1801,2104677,Governador Nunes Freire - MA,11238,16108,4870,22917,49.04,70.29,21.25
sidra_9541_PercMoradDPPOColetTot_munic_22_pol.fid-703dc0a5_191866d88cb_-1800,2104701,Graça Aranha - MA,2724,2734,10,6021,45.24,45.41,0.17
sidra_9541_PercMoradDPPOColetTot_munic_22_pol.fid-703dc0a5_191866d88cb_-17ff,2104800,Grajaú - MA,49066,49976,910,73736,66.54,67.78,1.23
sidra_9541_PercMoradDPPOColetTot_munic_22_pol.fid-703dc0a5_191866d88cb_-17fe,2104909,Guimarães - MA,4604,5169,565,10277,44.8,50.3,5.5
sidra_9541_PercMoradDPPOColetTot_munic_22_pol.fid-703dc0a5_191866d88cb_-17fd,2105005,Humberto de Campos - MA,8820,10574,1754,25647,34.39,41.23,6.84
sidra_9541_PercMoradDPPOColetTot_munic_22_pol.fid-703dc0a5_191866d88cb_-17fc,2105104,Icatu - MA,6092,7024,932,24785,24.58,28.34,3.76
sidra_9541_PercMoradDPPOColetTot_munic_22_pol.fid-703dc0a5_191866d88cb_-17fb,2105153,Igarapé do Meio - MA,7707,8313,606,13961,55.2,59.54,4.34
sidra_9541_PercMoradDPPOColetTot_munic_22_pol.fid-703dc0a5_191866d88cb_-17fa,2105203,Igarapé Grande - MA,7354,8483,1129,10231,71.88,82.91,11.04
sidra_9541_PercMoradDPPOColetTot_munic_22_pol.fid-703dc0a5_191866d88cb_-17f9,2105302,Imperatriz - MA,258493,262805,4312,272348,94.91,96.5,1.58
sidra_9541_PercMoradDPPOColetTot_munic_22_pol.fid-703dc0a5_191866d88cb_-17f8,2105351,Itaipava do Grajaú - MA,6685,7196,511,13824,48.36,52.05,3.7
sidra_9541_PercMoradDPPOColetTot_munic_22_pol.fid-703dc0a5_191866d88cb_-17f7,2105401,Itapecuru Mirim - MA,31981,36604,4623,60290,53.05,60.71,7.67
sidra_9541_PercMoradDPPOColetTot_munic_22_pol.fid-703dc0a5_191866d88cb_-17f6,2105427,Itinga do Maranhão - MA,18019,18616,597,22392,80.47,83.14,2.67
sidra_9541_PercMoradDPPOColetTot_munic_22_pol.fid-703dc0a5_191866d88cb_-17f5,2105450,Jatobá - MA,1540,1570,30,7458,20.65,21.05,0.4
sidra_9541_PercMoradDPPOColetTot_munic_22_pol.fid-703dc0a5_191866d88cb_-17f4,2105476,Jenipapo dos Vieiras - MA,2167,2761,594,17073,12.69,16.17,3.48
sidra_9541_PercMoradDPPOColetTot_munic_22_pol.fid-703dc0a5_191866d88cb_-17f2,2105500,João Lisboa - MA,17561,17972,411,24561,71.5,73.17,1.67
sidra_9541_PercMoradDPPOColetTot_munic_22_pol.fid-703dc0a5_191866d88cb_-17f1,2105609,Joselândia - MA,8882,9042,160,14908,59.58,60.65,1.07
sidra_9541_PercMoradDPPOColetTot_munic_22_pol.fid-703dc0a5_191866d88cb_-17ef,2105658,Junco do Maranhão - MA,3553,3638,85,5138,69.15,70.81,1.65
sidra_9541_PercMoradDPPOColetTot_munic_22_pol.fid-703dc0a5_191866d88cb_-17ee,2105708,Lago da Pedra - MA,32826,34899,2073,44375,73.97,78.65,4.67
sidra_9541_PercMoradDPPOColetTot_munic_22_pol.fid-703dc0a5_191866d88cb_-17ed,2105807,Lago do Junco - MA,1943,4513,2570,9501,20.45,47.5,27.05
sidra_9541_PercMoradDPPOColetTot_munic_22_pol.fid-703dc0a5_191866d88cb_-17ec,2105906,Lago Verde - MA,5315,5621,306,14765,36,38.07,2.07
sidra_9541_PercMoradDPPOColetTot_munic_22_pol.fid-703dc0a5_191866d88cb_-17eb,2105922,Lagoa do Mato - MA,4853,4865,12,10570,45.91,46.03,0.11
sidra_9541_PercMoradDPPOColetTot_munic_22_pol.fid-703dc0a5_191866d88cb_-17ea,2105948,Lago dos Rodrigues - MA,5589,5994,405,8745,63.91,68.54,4.63
sidra_9541_PercMoradDPPOColetTot_munic_22_pol.fid-703dc0a5_191866d88cb_-17e9,2105963,Lagoa Grande do Maranhão - MA,7093,7101,8,11405,62.19,62.26,0.07
sidra_9541_PercMoradDPPOColetTot_munic_22_pol.fid-703dc0a5_191866d88cb_-17e8,2105989,Lajeado Novo - MA,3911,4372,461,7057,55.42,61.95,6.53
sidra_9541_PercMoradDPPOColetTot_munic_22_pol.fid-703dc0a5_191866d88cb_-17e7,2106003,Lima Campos - MA,7359,7416,57,11295,65.15,65.66,0.5
sidra_9541_PercMoradDPPOColetTot_munic_22_pol.fid-703dc0a5_191866d88cb_-17e6,2106102,Loreto - MA,8622,8870,248,11596,74.35,76.49,2.14
sidra_9541_PercMoradDPPOColetTot_munic_22_pol.fid-703dc0a5_191866d88cb_-17e5,2106201,Luís Domingues - MA,5648,5655,7,7156,78.93,79.02,0.1
sidra_9541_PercMoradDPPOColetTot_munic_22_pol.fid-703dc0a5_191866d88cb_-17e4,2106300,Magalhães de Almeida - MA,6882,8508,1626,13799,49.87,61.66,11.78
sidra_9541_PercMoradDPPOColetTot_munic_22_pol.fid-703dc0a5_191866d88cb_-17e3,2106326,Maracaçumé - MA,18226,18332,106,21131,86.25,86.75,0.5
sidra_9541_PercMoradDPPOColetTot_munic_22_pol.fid-703dc0a5_191866d88cb_-17e2,2106359,Marajá do Sena - MA,1330,1545,215,7025,18.93,21.99,3.06
sidra_9541_PercMoradDPPOColetTot_munic_22_pol.fid-703dc0a5_191866d88cb_-17e1,2106375,Maranhãozinho - MA,8411,8423,12,13740,61.22,61.3,0.09
sidra_9541_PercMoradDPPOColetTot_munic_22_pol.fid-703dc0a5_191866d88cb_-17e0,2106409,Mata Roma - MA,4879,5388,509,17069,28.58,31.57,2.98
sidra_9541_PercMoradDPPOColetTot_munic_22_pol.fid-703dc0a5_191866d88cb_-17df,2106508,Matinha - MA,8091,8454,363,22020,36.74,38.39,1.65
sidra_9541_PercMoradDPPOColetTot_munic_22_pol.fid-703dc0a5_191866d88cb_-17de,2106607,Matões - MA,13532,14087,555,32167,42.07,43.79,1.73
sidra_9541_PercMoradDPPOColetTot_munic_22_pol.fid-703dc0a5_191866d88cb_-17dd,2106631,Matões do Norte - MA,8157,8244,87,17413,46.84,47.34,0.5
sidra_9541_PercMoradDPPOColetTot_munic_22_pol.fid-703dc0a5_191866d88cb_-17dc,2106672,Milagres do Maranhão - MA,845,1332,487,8809,9.59,15.12,5.53
sidra_9541_PercMoradDPPOColetTot_munic_22_pol.fid-703dc0a5_191866d88cb_-17db,2106706,Mirador - MA,9480,10493,1013,21011,45.12,49.94,4.82
sidra_9541_PercMoradDPPOColetTot_munic_22_pol.fid-703dc0a5_191866d88cb_-17da,2106755,Miranda do Norte - MA,20169,20271,102,23794,84.77,85.19,0.43
sidra_9541_PercMoradDPPOColetTot_munic_22_pol.fid-703dc0a5_191866d88cb_-17d9,2106805,Mirinzal - MA,6626,8457,1831,13965,47.45,60.56,13.11
sidra_9541_PercMoradDPPOColetTot_munic_22_pol.fid-703dc0a5_191866d88cb_-17d8,2106904,Monção - MA,7686,10212,2526,27746,27.7,36.81,9.1
sidra_9541_PercMoradDPPOColetTot_munic_22_pol.fid-703dc0a5_191866d88cb_-17d7,2107001,Montes Altos - MA,4848,4860,12,9099,53.28,53.41,0.13
sidra_9541_PercMoradDPPOColetTot_munic_22_pol.fid-703dc0a5_191866d88cb_-17d6,2107100,Morros - MA,6679,6980,301,18539,36.03,37.65,1.62
sidra_9541_PercMoradDPPOColetTot_munic_22_pol.fid-703dc0a5_191866d88cb_-17d5,2107209,Nina Rodrigues - MA,6324,6472,148,14163,44.65,45.7,1.04
sidra_9541_PercMoradDPPOColetTot_munic_22_pol.fid-703dc0a5_191866d88cb_-17d4,2107258,Nova Colinas - MA,2455,2459,4,5015,48.95,49.03,0.08
sidra_9541_PercMoradDPPOColetTot_munic_22_pol.fid-703dc0a5_191866d88cb_-17d3,2107308,Nova Iorque - MA,2800,2800,,4317,64.86,64.86,
sidra_9541_PercMoradDPPOColetTot_munic_22_pol.fid-703dc0a5_191866d88cb_-17d2,2107357,Nova Olinda do Maranhão - MA,8705,10054,1349,14307,60.84,70.27,9.43
sidra_9541_PercMoradDPPOColetTot_munic_22_pol.fid-703dc0a5_191866d88cb_-17d1,2107407,Olho d'Água das Cunhãs - MA,12262,12868,606,17906,68.48,71.86,3.38
sidra_9541_PercMoradDPPOColetTot_munic_22_pol.fid-703dc0a5_191866d88cb_-17d0,2107456,Olinda Nova do Maranhão - MA,4805,6852,2047,13576,35.39,50.47,15.08
sidra_9541_PercMoradDPPOColetTot_munic_22_pol.fid-703dc0a5_191866d88cb_-17cf,2107506,Paço do Lumiar - MA,114467,122752,8285,145277,78.79,84.5,5.7
sidra_9541_PercMoradDPPOColetTot_munic_22_pol.fid-703dc0a5_191866d88cb_-17ce,2107605,Palmeirândia - MA,4651,5430,779,21043,22.1,25.8,3.7
sidra_9541_PercMoradDPPOColetTot_munic_22_pol.fid-703dc0a5_191866d88cb_-17cd,2107704,Paraibano - MA,14089,14108,19,18261,77.15,77.26,0.1
sidra_9541_PercMoradDPPOColetTot_munic_22_pol.fid-703dc0a5_191866d88cb_-17cc,2107803,Parnarama - MA,12194,12360,166,31247,39.02,39.56,0.53
sidra_9541_PercMoradDPPOColetTot_munic_22_pol.fid-703dc0a5_191866d88cb_-17cb,2107902,Passagem Franca - MA,10621,10681,60,17213,61.7,62.05,0.35
sidra_9541_PercMoradDPPOColetTot_munic_22_pol.fid-703dc0a5_191866d88cb_-17ca,2108009,Pastos Bons - MA,11609,12970,1361,18800,61.75,68.99,7.24
sidra_9541_PercMoradDPPOColetTot_munic_22_pol.fid-703dc0a5_191866d88cb_-17c9,2108058,Paulino Neves - MA,6865,6921,56,16994,40.4,40.73,0.33
sidra_9541_PercMoradDPPOColetTot_munic_22_pol.fid-703dc0a5_191866d88cb_-17c7,2108108,Paulo Ramos - MA,10343,13105,2762,20338,50.86,64.44,13.58
sidra_9541_PercMoradDPPOColetTot_munic_22_pol.fid-703dc0a5_191866d88cb_-17c6,2108207,Pedreiras - MA,30090,33904,3814,36822,81.72,92.08,10.36
sidra_9541_PercMoradDPPOColetTot_munic_22_pol.fid-703dc0a5_191866d88cb_-17c5,2108256,Pedro do Rosário - MA,7399,7624,225,24297,30.45,31.38,0.93
sidra_9541_PercMoradDPPOColetTot_munic_22_pol.fid-703dc0a5_191866d88cb_-17c4,2108306,Penalva - MA,11106,15119,4013,32498,34.17,46.52,12.35
sidra_9541_PercMoradDPPOColetTot_munic_22_pol.fid-703dc0a5_191866d88cb_-17c3,2108405,Peri Mirim - MA,2901,3262,361,11107,26.12,29.37,3.25
sidra_9541_PercMoradDPPOColetTot_munic_22_pol.fid-703dc0a5_191866d88cb_-17c2,2108454,Peritoró - MA,10191,12663,2472,20472,49.78,61.86,12.08
sidra_9541_PercMoradDPPOColetTot_munic_22_pol.fid-703dc0a5_191866d88cb_-17c1,2108504,Pindaré-Mirim - MA,15879,20238,4359,31403,50.57,64.45,13.88
sidra_9541_PercMoradDPPOColetTot_munic_22_pol.fid-703dc0a5_191866d88cb_-17c0,2108603,Pinheiro - MA,47582,52844,5262,84269,56.46,62.71,6.24
sidra_9541_PercMoradDPPOColetTot_munic_22_pol.fid-703dc0a5_191866d88cb_-17bf,2108702,Pio XII - MA,9755,12157,2402,21862,44.62,55.61,10.99
sidra_9541_PercMoradDPPOColetTot_munic_22_pol.fid-703dc0a5_191866d88cb_-17be,2108801,Pirapemas - MA,7910,9925,2015,17711,44.66,56.04,11.38
sidra_9541_PercMoradDPPOColetTot_munic_22_pol.fid-703dc0a5_191866d88cb_-17bd,2108900,Poção de Pedras - MA,9524,9542,18,17157,55.51,55.62,0.1
sidra_9541_PercMoradDPPOColetTot_munic_22_pol.fid-703dc0a5_191866d88cb_-17bc,2109007,Porto Franco - MA,19224,19441,217,23788,80.81,81.73,0.91
sidra_9541_PercMoradDPPOColetTot_munic_22_pol.fid-703dc0a5_191866d88cb_-17bb,2109056,Porto Rico do Maranhão - MA,2265,2347,82,5951,38.06,39.44,1.38
sidra_9541_PercMoradDPPOColetTot_munic_22_pol.fid-703dc0a5_191866d88cb_-17ba,2109106,Presidente Dutra - MA,33348,38223,4875,45038,74.04,84.87,10.82
sidra_9541_PercMoradDPPOColetTot_munic_22_pol.fid-703dc0a5_191866d88cb_-17b9,2109205,Presidente Juscelino - MA,3677,3722,45,11340,32.43,32.82,0.4
sidra_9541_PercMoradDPPOColetTot_munic_22_pol.fid-703dc0a5_191866d88cb_-17b8,2109239,Presidente Médici - MA,597,3623,3026,4687,12.74,77.3,64.56
sidra_9541_PercMoradDPPOColetTot_munic_22_pol.fid-703dc0a5_191866d88cb_-17b7,2109270,Presidente Sarney - MA,7978,8124,146,17503,45.58,46.41,0.83
sidra_9541_PercMoradDPPOColetTot_munic_22_pol.fid-703dc0a5_191866d88cb_-17b6,2109304,Presidente Vargas - MA,4236,4592,356,10543,40.18,43.55,3.38
sidra_9541_PercMoradDPPOColetTot_munic_22_pol.fid-703dc0a5_191866d88cb_-17b5,2109403,Primeira Cruz - MA,3060,3090,30,13603,22.5,22.72,0.22
sidra_9541_PercMoradDPPOColetTot_munic_22_pol.fid-703dc0a5_191866d88cb_-17b4,2109452,Raposa - MA,23442,25877,2435,30803,76.1,84.01,7.91
sidra_9541_PercMoradDPPOColetTot_munic_22_pol.fid-703dc0a5_191866d88cb_-17b3,2109502,Riachão - MA,12999,13340,341,22044,58.97,60.52,1.55
sidra_9541_PercMoradDPPOColetTot_munic_22_pol.fid-703dc0a5_191866d88cb_-17b2,2109551,Ribamar Fiquene - MA,3711,4883,1172,7417,50.03,65.84,15.8
sidra_9541_PercMoradDPPOColetTot_munic_22_pol.fid-703dc0a5_191866d88cb_-17b1,2109601,Rosário - MA,24505,26139,1634,38319,63.95,68.21,4.26
sidra_9541_PercMoradDPPOColetTot_munic_22_pol.fid-703dc0a5_191866d88cb_-17b0,2109700,Sambaíba - MA,1818,3431,1613,5568,32.65,61.62,28.97
sidra_9541_PercMoradDPPOColetTot_munic_22_pol.fid-703dc0a5_191866d88cb_-17af,2109759,Santa Filomena do Maranhão - MA,2799,2819,20,6695,41.81,42.11,0.3
sidra_9541_PercMoradDPPOColetTot_munic_22_pol.fid-703dc0a5_191866d88cb_-17ae,2109809,Santa Helena - MA,21950,22837,887,41541,52.84,54.97,2.14
sidra_9541_PercMoradDPPOColetTot_munic_22_pol.fid-703dc0a5_191866d88cb_-17ad,2109908,Santa Inês - MA,73285,76635,3350,84785,86.44,90.39,3.95
sidra_9541_PercMoradDPPOColetTot_munic_22_pol.fid-703dc0a5_191866d88cb_-17ac,2110005,Santa Luzia - MA,34074,38452,4378,57523,59.24,66.85,7.61
sidra_9541_PercMoradDPPOColetTot_munic_22_pol.fid-703dc0a5_191866d88cb_-17ab,2110039,Santa Luzia do Paruá - MA,19971,20509,538,24286,82.23,84.45,2.22
sidra_9541_PercMoradDPPOColetTot_munic_22_pol.fid-703dc0a5_191866d88cb_-17aa,2110104,Santa Quitéria do Maranhão - MA,7584,10390,2806,23949,31.67,43.38,11.72
sidra_9541_PercMoradDPPOColetTot_munic_22_pol.fid-703dc0a5_191866d88cb_-17a9,2110203,Santa Rita - MA,17495,21029,3534,36976,47.31,56.87,9.56
sidra_9541_PercMoradDPPOColetTot_munic_22_pol.fid-703dc0a5_191866d88cb_-17a8,2110237,Santana do Maranhão - MA,2353,2436,83,10547,22.31,23.1,0.79
sidra_9541_PercMoradDPPOColetTot_munic_22_pol.fid-703dc0a5_191866d88cb_-17a7,2110278,Santo Amaro do Maranhão - MA,4462,4585,123,13923,32.05,32.93,0.88
sidra_9541_PercMoradDPPOColetTot_munic_22_pol.fid-703dc0a5_191866d88cb_-17a6,2110302,Santo Antônio dos Lopes - MA,9193,9452,259,14285,64.35,66.17,1.81
sidra_9541_PercMoradDPPOColetTot_munic_22_pol.fid-703dc0a5_191866d88cb_-17a5,2110401,São Benedito do Rio Preto - MA,6251,8477,2226,18342,34.08,46.22,12.14
sidra_9541_PercMoradDPPOColetTot_munic_22_pol.fid-703dc0a5_191866d88cb_-17a4,2110500,São Bento - MA,24814,26975,2161,46369,53.51,58.17,4.66
sidra_9541_PercMoradDPPOColetTot_munic_22_pol.fid-703dc0a5_191866d88cb_-17a3,2110609,São Bernardo - MA,10708,12060,1352,26917,39.78,44.8,5.02
sidra_9541_PercMoradDPPOColetTot_munic_22_pol.fid-703dc0a5_191866d88cb_-17a2,2110658,São Domingos do Azeitão - MA,6702,6801,99,7990,83.88,85.12,1.24
sidra_9541_PercMoradDPPOColetTot_munic_22_pol.fid-703dc0a5_191866d88cb_-17a1,2110708,São Domingos do Maranhão - MA,17786,19573,1787,34004,52.31,57.56,5.26
sidra_9541_PercMoradDPPOColetTot_munic_22_pol.fid-703dc0a5_191866d88cb_-17a0,2110807,São Félix de Balsas - MA,820,1994,1174,4398,18.64,45.34,26.69
sidra_9541_PercMoradDPPOColetTot_munic_22_pol.fid-703dc0a5_191866d88cb_-179f,2110856,São Francisco do Brejão - MA,6719,6822,103,9045,74.28,75.42,1.14
sidra_9541_PercMoradDPPOColetTot_munic_22_pol.fid-703dc0a5_191866d88cb_-179e,2110906,São Francisco do Maranhão - MA,2796,3727,931,12063,23.18,30.9,7.72
sidra_9541_PercMoradDPPOColetTot_munic_22_pol.fid-703dc0a5_191866d88cb_-179d,2111003,São João Batista - MA,3911,4075,164,18536,21.1,21.98,0.88
sidra_9541_PercMoradDPPOColetTot_munic_22_pol.fid-703dc0a5_191866d88cb_-179c,2111029,São João do Carú - MA,5842,7691,1849,12251,47.69,62.78,15.09
sidra_9541_PercMoradDPPOColetTot_munic_22_pol.fid-703dc0a5_191866d88cb_-179b,2111052,São João do Paraíso - MA,4959,5846,887,9904,50.07,59.03,8.96
sidra_9541_PercMoradDPPOColetTot_munic_22_pol.fid-703dc0a5_191866d88cb_-179a,2111078,São João do Soter - MA,5087,5907,820,16883,30.13,34.99,4.86
sidra_9541_PercMoradDPPOColetTot_munic_22_pol.fid-703dc0a5_191866d88cb_-1799,2111102,São João dos Patos - MA,19184,19662,478,24948,76.9,78.81,1.92
sidra_9541_PercMoradDPPOColetTot_munic_22_pol.fid-703dc0a5_191866d88cb_-1798,2111201,São José de Ribamar - MA,208394,227881,19487,244426,85.26,93.23,7.97
sidra_9541_PercMoradDPPOColetTot_munic_22_pol.fid-703dc0a5_191866d88cb_-1797,2111250,São José dos Basílios - MA,3768,3794,26,6942,54.28,54.65,0.37
sidra_9541_PercMoradDPPOColetTot_munic_22_pol.fid-703dc0a5_191866d88cb_-1796,2111300,São Luís - MA,951023,992227,41204,1032305,92.13,96.12,3.99
sidra_9541_PercMoradDPPOColetTot_munic_22_pol.fid-703dc0a5_191866d88cb_-1795,2111409,São Luís Gonzaga do Maranhão - MA,5222,8453,3231,17813,29.32,47.45,18.14
sidra_9541_PercMoradDPPOColetTot_munic_22_pol.fid-703dc0a5_191866d88cb_-1794,2111508,São Mateus do Maranhão - MA,24903,28546,3643,38811,64.16,73.55,9.39
sidra_9541_PercMoradDPPOColetTot_munic_22_pol.fid-703dc0a5_191866d88cb_-1793,2111532,São Pedro da Água Branca - MA,11950,12602,652,14298,83.58,88.14,4.56
sidra_9541_PercMoradDPPOColetTot_munic_22_pol.fid-703dc0a5_191866d88cb_-1792,2111573,São Pedro dos Crentes - MA,2613,3111,498,5777,45.23,53.85,8.62
sidra_9541_PercMoradDPPOColetTot_munic_22_pol.fid-703dc0a5_191866d88cb_-1791,2111607,São Raimundo das Mangabeiras - MA,14221,14978,757,18662,76.2,80.26,4.06
sidra_9541_PercMoradDPPOColetTot_munic_22_pol.fid-703dc0a5_191866d88cb_-178f,2111631,São Raimundo do Doca Bezerra - MA,3759,3801,42,5650,66.53,67.27,0.74
sidra_9541_PercMoradDPPOColetTot_munic_22_pol.fid-703dc0a5_191866d88cb_-178e,2111672,São Roberto - MA,3038,3062,24,4531,67.05,67.58,0.53
sidra_9541_PercMoradDPPOColetTot_munic_22_pol.fid-703dc0a5_191866d88cb_-178d,2111706,São Vicente Ferrer - MA,3684,4853,1169,19474,18.92,24.92,6
sidra_9541_PercMoradDPPOColetTot_munic_22_pol.fid-703dc0a5_191866d88cb_-178c,2111722,Satubinha - MA,3271,3320,49,8755,37.36,37.92,0.56
sidra_9541_PercMoradDPPOColetTot_munic_22_pol.fid-703dc0a5_191866d88cb_-178b,2111748,Senador Alexandre Costa - MA,4630,4717,87,10206,45.37,46.22,0.85
sidra_9541_PercMoradDPPOColetTot_munic_22_pol.fid-703dc0a5_191866d88cb_-178a,2111763,Senador La Rocque - MA,11522,11707,185,14666,78.56,79.82,1.26
sidra_9541_PercMoradDPPOColetTot_munic_22_pol.fid-703dc0a5_191866d88cb_-1789,2111789,Serrano do Maranhão - MA,141,178,37,10201,1.38,1.74,0.36
sidra_9541_PercMoradDPPOColetTot_munic_22_pol.fid-703dc0a5_191866d88cb_-1788,2111805,Sítio Novo - MA,4941,6500,1559,17062,28.96,38.1,9.14
sidra_9541_PercMoradDPPOColetTot_munic_22_pol.fid-703dc0a5_191866d88cb_-1787,2111904,Sucupira do Norte - MA,5430,5989,559,10235,53.05,58.51,5.46
sidra_9541_PercMoradDPPOColetTot_munic_22_pol.fid-703dc0a5_191866d88cb_-1786,2111953,Sucupira do Riachão - MA,2243,2243,,4985,44.99,44.99,
sidra_9541_PercMoradDPPOColetTot_munic_22_pol.fid-703dc0a5_191866d88cb_-1784,2112001,Tasso Fragoso - MA,6525,6875,350,8832,73.88,77.84,3.96
sidra_9541_PercMoradDPPOColetTot_munic_22_pol.fid-703dc0a5_191866d88cb_-1783,2112100,Timbiras - MA,12687,15465,2778,26480,47.91,58.4,10.49
sidra_9541_PercMoradDPPOColetTot_munic_22_pol.fid-703dc0a5_191866d88cb_-1782,2112209,Timon - MA,142562,144727,2165,173743,82.05,83.3,1.25
sidra_9541_PercMoradDPPOColetTot_munic_22_pol.fid-703dc0a5_191866d88cb_-1781,2112233,Trizidela do Vale - MA,19752,19912,160,22463,87.93,88.64,0.71
sidra_9541_PercMoradDPPOColetTot_munic_22_pol.fid-703dc0a5_191866d88cb_-1780,2112274,Tufilândia - MA,1550,2162,612,5506,28.15,39.27,11.12
sidra_9541_PercMoradDPPOColetTot_munic_22_pol.fid-703dc0a5_191866d88cb_-177f,2112308,Tuntum - MA,20070,23541,3471,36173,55.48,65.08,9.6
sidra_9541_PercMoradDPPOColetTot_munic_22_pol.fid-703dc0a5_191866d88cb_-177d,2112407,Turiaçu - MA,13519,14204,685,37459,36.09,37.92,1.83
sidra_9541_PercMoradDPPOColetTot_munic_22_pol.fid-703dc0a5_191866d88cb_-177c,2112456,Turilândia - MA,18213,18327,114,31614,57.61,57.97,0.36
sidra_9541_PercMoradDPPOColetTot_munic_22_pol.fid-703dc0a5_191866d88cb_-177b,2112506,Tutóia - MA,25792,29334,3542,53157,48.52,55.18,6.66
sidra_9541_PercMoradDPPOColetTot_munic_22_pol.fid-703dc0a5_191866d88cb_-177a,2112605,Urbano Santos - MA,14529,15184,655,32790,44.31,46.31,2
sidra_9541_PercMoradDPPOColetTot_munic_22_pol.fid-703dc0a5_191866d88cb_-1779,2112704,Vargem Grande - MA,19665,23462,3797,43250,45.47,54.25,8.78
sidra_9541_PercMoradDPPOColetTot_munic_22_pol.fid-703dc0a5_191866d88cb_-1778,2112803,Viana - MA,22662,28271,5609,51314,44.16,55.09,10.93
sidra_9541_PercMoradDPPOColetTot_munic_22_pol.fid-703dc0a5_191866d88cb_-1777,2112852,Vila Nova dos Martírios - MA,6948,8433,1485,10350,67.13,81.48,14.35
sidra_9541_PercMoradDPPOColetTot_munic_22_pol.fid-703dc0a5_191866d88cb_-1776,2112902,Vitória do Mearim - MA,17592,18953,1361,30775,57.16,61.59,4.42
sidra_9541_PercMoradDPPOColetTot_munic_22_pol.fid-703dc0a5_191866d88cb_-1775,2113009,Vitorino Freire - MA,16671,20454,3783,30813,54.1,66.38,12.28
sidra_9541_PercMoradDPPOColetTot_munic_22_pol.fid-703dc0a5_191866d88cb_-1774,2114007,Zé Doca - MA,27468,30037,2569,40683,67.52,73.83,6.31
sidra_9541_PercMoradDPPOColetTot_munic_22_pol.fid-703dc0a5_191866d88cb_-1773,2200053,Acauã - PI,1877,2286,409,6419,29.24,35.61,6.37
sidra_9541_PercMoradDPPOColetTot_munic_22_pol.fid-703dc0a5_191866d88cb_-1772,2200103,Agricolândia - PI,4025,4045,20,4939,81.49,81.9,0.4
sidra_9541_PercMoradDPPOColetTot_munic_22_pol.fid-703dc0a5_191866d88cb_-1771,2200202,Água Branca - PI,16019,17109,1090,17565,91.2,97.4,6.21
sidra_9541_PercMoradDPPOColetTot_munic_22_pol.fid-703dc0a5_191866d88cb_-1770,2200251,Alagoinha do Piauí - PI,3938,4032,94,6819,57.75,59.13,1.38
sidra_9541_PercMoradDPPOColetTot_munic_22_pol.fid-703dc0a5_191866d88cb_-176f,2200277,Alegrete do Piauí - PI,1191,3225,2034,4629,25.73,69.67,43.94
sidra_9541_PercMoradDPPOColetTot_munic_22_pol.fid-703dc0a5_191866d88cb_-176e,2200301,Alto Longá - PI,6468,6479,11,13479,47.99,48.07,0.08
sidra_9541_PercMoradDPPOColetTot_munic_22_pol.fid-703dc0a5_191866d88cb_-176d,2200400,Altos - PI,32469,33205,736,46578,69.71,71.29,1.58
sidra_9541_PercMoradDPPOColetTot_munic_22_pol.fid-703dc0a5_191866d88cb_-176c,2200459,Alvorada do Gurguéia - PI,2172,2195,23,5322,40.81,41.24,0.43
sidra_9541_PercMoradDPPOColetTot_munic_22_pol.fid-703dc0a5_191866d88cb_-176b,2200509,Amarante - PI,8129,8400,271,17194,47.28,48.85,1.58
sidra_9541_PercMoradDPPOColetTot_munic_22_pol.fid-703dc0a5_191866d88cb_-176a,2200608,Angical do Piauí - PI,5681,5852,171,6815,83.36,85.87,2.51
sidra_9541_PercMoradDPPOColetTot_munic_22_pol.fid-703dc0a5_191866d88cb_-1769,2200707,Anísio de Abreu - PI,5395,5912,517,9389,57.46,62.97,5.51
sidra_9541_PercMoradDPPOColetTot_munic_22_pol.fid-703dc0a5_191866d88cb_-1768,2200806,Antônio Almeida - PI,2507,2610,103,3145,79.71,82.99,3.28
sidra_9541_PercMoradDPPOColetTot_munic_22_pol.fid-703dc0a5_191866d88cb_-1767,2200905,Aroazes - PI,3584,3660,76,5369,66.75,68.17,1.42
sidra_9541_PercMoradDPPOColetTot_munic_22_pol.fid-703dc0a5_191866d88cb_-1766,2200954,Aroeiras do Itaim - PI,936,1653,717,2690,34.8,61.45,26.65
sidra_9541_PercMoradDPPOColetTot_munic_22_pol.fid-703dc0a5_191866d88cb_-1765,2201002,Arraial - PI,1937,2600,663,4519,42.86,57.53,14.67
sidra_9541_PercMoradDPPOColetTot_munic_22_pol.fid-703dc0a5_191866d88cb_-1764,2201051,Assunção do Piauí - PI,2068,2919,851,7452,27.75,39.17,11.42
sidra_9541_PercMoradDPPOColetTot_munic_22_pol.fid-703dc0a5_191866d88cb_-1763,2201101,Avelino Lopes - PI,6693,6919,226,10861,61.62,63.71,2.08
sidra_9541_PercMoradDPPOColetTot_munic_22_pol.fid-703dc0a5_191866d88cb_-1762,2201150,Baixa Grande do Ribeiro - PI,6887,8216,1329,13235,52.04,62.08,10.04
sidra_9541_PercMoradDPPOColetTot_munic_22_pol.fid-703dc0a5_191866d88cb_-1761,2201176,Barra D'Alcântara - PI,2553,2563,10,3995,63.9,64.16,0.25
sidra_9541_PercMoradDPPOColetTot_munic_22_pol.fid-703dc0a5_191866d88cb_-1760,2201200,Barras - PI,22573,22793,220,47920,47.11,47.56,0.46
sidra_9541_PercMoradDPPOColetTot_munic_22_pol.fid-703dc0a5_191866d88cb_-175f,2201309,Barreiras do Piauí - PI,1854,1900,46,3261,56.85,58.26,1.41
sidra_9541_PercMoradDPPOColetTot_munic_22_pol.fid-703dc0a5_191866d88cb_-175e,2201408,Barro Duro - PI,4909,5039,130,6631,74.03,75.99,1.96
sidra_9541_PercMoradDPPOColetTot_munic_22_pol.fid-703dc0a5_191866d88cb_-175d,2201507,Batalha - PI,10799,11808,1009,26251,41.14,44.98,3.84
sidra_9541_PercMoradDPPOColetTot_munic_22_pol.fid-703dc0a5_191866d88cb_-175c,2201556,Bela Vista do Piauí - PI,2509,2526,17,4086,61.4,61.82,0.42
sidra_9541_PercMoradDPPOColetTot_munic_22_pol.fid-703dc0a5_191866d88cb_-175b,2201572,Belém do Piauí - PI,1937,2166,229,3423,56.59,63.28,6.69
sidra_9541_PercMoradDPPOColetTot_munic_22_pol.fid-703dc0a5_191866d88cb_-175a,2201606,Beneditinos - PI,5993,6026,33,9926,60.38,60.71,0.33
sidra_9541_PercMoradDPPOColetTot_munic_22_pol.fid-703dc0a5_191866d88cb_-1759,2201705,Bertolínia - PI,3866,3868,2,5542,69.76,69.79,0.04
sidra_9541_PercMoradDPPOColetTot_munic_22_pol.fid-703dc0a5_191866d88cb_-1758,2201739,Betânia do Piauí - PI,2173,2194,21,6219,34.94,35.28,0.34
sidra_9541_PercMoradDPPOColetTot_munic_22_pol.fid-703dc0a5_191866d88cb_-1757,2201770,Boa Hora - PI,2435,2633,198,6883,35.38,38.25,2.88
sidra_9541_PercMoradDPPOColetTot_munic_22_pol.fid-703dc0a5_191866d88cb_-1756,2201804,Bocaina - PI,3051,3066,15,4077,74.83,75.2,0.37
sidra_9541_PercMoradDPPOColetTot_munic_22_pol.fid-703dc0a5_191866d88cb_-1755,2201903,Bom Jesus - PI,22622,23768,1146,28734,78.73,82.72,3.99
sidra_9541_PercMoradDPPOColetTot_munic_22_pol.fid-703dc0a5_191866d88cb_-1754,2201919,Bom Princípio do Piauí - PI,1032,2985,1953,5634,18.32,52.98,34.66
sidra_9541_PercMoradDPPOColetTot_munic_22_pol.fid-703dc0a5_191866d88cb_-1753,2201929,Bonfim do Piauí - PI,1482,1759,277,5913,25.06,29.75,4.68
sidra_9541_PercMoradDPPOColetTot_munic_22_pol.fid-703dc0a5_191866d88cb_-1752,2201945,Boqueirão do Piauí - PI,4453,4475,22,6545,68.04,68.37,0.34
sidra_9541_PercMoradDPPOColetTot_munic_22_pol.fid-703dc0a5_191866d88cb_-1751,2201960,Brasileira - PI,7038,7042,4,8436,83.43,83.48,0.05
sidra_9541_PercMoradDPPOColetTot_munic_22_pol.fid-703dc0a5_191866d88cb_-1750,2201988,Brejo do Piauí - PI,1475,1499,24,3887,37.95,38.56,0.62
sidra_9541_PercMoradDPPOColetTot_munic_22_pol.fid-703dc0a5_191866d88cb_-174f,2202000,Buriti dos Lopes - PI,14396,14421,25,19646,73.28,73.4,0.13
sidra_9541_PercMoradDPPOColetTot_munic_22_pol.fid-703dc0a5_191866d88cb_-174e,2202026,Buriti dos Montes - PI,4712,5389,677,7431,63.41,72.52,9.11
sidra_9541_PercMoradDPPOColetTot_munic_22_pol.fid-703dc0a5_191866d88cb_-174d,2202059,Cabeceiras do Piauí - PI,2238,2283,45,10212,21.92,22.36,0.44
sidra_9541_PercMoradDPPOColetTot_munic_22_pol.fid-703dc0a5_191866d88cb_-174c,2202075,Cajazeiras do Piauí - PI,1169,1170,1,3107,37.62,37.66,0.03
sidra_9541_PercMoradDPPOColetTot_munic_22_pol.fid-703dc0a5_191866d88cb_-174b,2202083,Cajueiro da Praia - PI,5593,5619,26,7946,70.39,70.71,0.33
sidra_9541_PercMoradDPPOColetTot_munic_22_pol.fid-703dc0a5_191866d88cb_-174a,2202091,Caldeirão Grande do Piauí - PI,1357,2254,897,5503,24.66,40.96,16.3
sidra_9541_PercMoradDPPOColetTot_munic_22_pol.fid-703dc0a5_191866d88cb_-1749,2202109,Campinas do Piauí - PI,1563,2091,528,4932,31.69,42.4,10.71
sidra_9541_PercMoradDPPOColetTot_munic_22_pol.fid-703dc0a5_191866d88cb_-1748,2202117,Campo Alegre do Fidalgo - PI,1321,1362,41,4614,28.63,29.52,0.89
sidra_9541_PercMoradDPPOColetTot_munic_22_pol.fid-703dc0a5_191866d88cb_-1747,2202133,Campo Grande do Piauí - PI,2722,4242,1520,6014,45.26,70.54,25.27
sidra_9541_PercMoradDPPOColetTot_munic_22_pol.fid-703dc0a5_191866d88cb_-1746,2202174,Campo Largo do Piauí - PI,1784,1829,45,7419,24.05,24.65,0.61
sidra_9541_PercMoradDPPOColetTot_munic_22_pol.fid-703dc0a5_191866d88cb_-1745,2202208,Campo Maior - PI,36670,36897,227,45641,80.34,80.84,0.5
sidra_9541_PercMoradDPPOColetTot_munic_22_pol.fid-703dc0a5_191866d88cb_-1744,2202251,Canavieira - PI,1686,1686,,3414,49.38,49.38,
sidra_9541_PercMoradDPPOColetTot_munic_22_pol.fid-703dc0a5_191866d88cb_-1743,2202307,Canto do Buriti - PI,11298,12338,1040,19345,58.4,63.78,5.38
sidra_9541_PercMoradDPPOColetTot_munic_22_pol.fid-703dc0a5_191866d88cb_-1742,2202406,Capitão de Campos - PI,7786,7862,76,11084,70.25,70.93,0.69
sidra_9541_PercMoradDPPOColetTot_munic_22_pol.fid-703dc0a5_191866d88cb_-1741,2202455,Capitão Gervásio Oliveira - PI,1531,1569,38,3971,38.55,39.51,0.96
sidra_9541_PercMoradDPPOColetTot_munic_22_pol.fid-703dc0a5_191866d88cb_-1740,2202505,Caracol - PI,4810,5129,319,10307,46.67,49.76,3.09
sidra_9541_PercMoradDPPOColetTot_munic_22_pol.fid-703dc0a5_191866d88cb_-173f,2202539,Caraúbas do Piauí - PI,2086,2165,79,5628,37.06,38.47,1.4
sidra_9541_PercMoradDPPOColetTot_munic_22_pol.fid-703dc0a5_191866d88cb_-173e,2202554,Caridade do Piauí - PI,2717,2784,67,5032,53.99,55.33,1.33
sidra_9541_PercMoradDPPOColetTot_munic_22_pol.fid-703dc0a5_191866d88cb_-173d,2202604,Castelo do Piauí - PI,11850,13250,1400,19271,61.49,68.76,7.26
sidra_9541_PercMoradDPPOColetTot_munic_22_pol.fid-703dc0a5_191866d88cb_-173c,2202653,Caxingó - PI,2855,2855,,5482,52.08,52.08,
sidra_9541_PercMoradDPPOColetTot_munic_22_pol.fid-703dc0a5_191866d88cb_-173b,2202703,Cocal - PI,11241,12864,1623,28200,39.86,45.62,5.76
sidra_9541_PercMoradDPPOColetTot_munic_22_pol.fid-703dc0a5_191866d88cb_-173a,2202711,Cocal de Telha - PI,2916,2946,30,4909,59.4,60.01,0.61
sidra_9541_PercMoradDPPOColetTot_munic_22_pol.fid-703dc0a5_191866d88cb_-1739,2202729,Cocal dos Alves - PI,1886,1951,65,6385,29.54,30.56,1.02
sidra_9541_PercMoradDPPOColetTot_munic_22_pol.fid-703dc0a5_191866d88cb_-1738,2202737,Coivaras - PI,1690,2039,349,4113,41.09,49.57,8.49
sidra_9541_PercMoradDPPOColetTot_munic_22_pol.fid-703dc0a5_191866d88cb_-1737,2202752,Colônia do Gurguéia - PI,3605,5178,1573,6143,58.68,84.29,25.61
sidra_9541_PercMoradDPPOColetTot_munic_22_pol.fid-703dc0a5_191866d88cb_-1736,2202778,Colônia do Piauí - PI,3501,3686,185,6993,50.06,52.71,2.65
sidra_9541_PercMoradDPPOColetTot_munic_22_pol.fid-703dc0a5_191866d88cb_-1735,2202802,Conceição do Canindé - PI,2767,2880,113,4928,56.15,58.44,2.29
sidra_9541_PercMoradDPPOColetTot_munic_22_pol.fid-703dc0a5_191866d88cb_-1734,2202851,Coronel José Dias - PI,1951,1951,,4240,46.01,46.01,
sidra_9541_PercMoradDPPOColetTot_munic_22_pol.fid-703dc0a5_191866d88cb_-1732,2202901,Corrente - PI,16972,17173,201,27173,62.46,63.2,0.74
sidra_9541_PercMoradDPPOColetTot_munic_22_pol.fid-703dc0a5_191866d88cb_-1731,2203008,Cristalândia do Piauí - PI,3441,3463,22,7340,46.88,47.18,0.3
sidra_9541_PercMoradDPPOColetTot_munic_22_pol.fid-703dc0a5_191866d88cb_-1730,2203107,Cristino Castro - PI,7390,7422,32,10487,70.47,70.77,0.31
sidra_9541_PercMoradDPPOColetTot_munic_22_pol.fid-703dc0a5_191866d88cb_-172f,2203206,Curimatá - PI,6972,7578,606,11248,61.98,67.37,5.39
sidra_9541_PercMoradDPPOColetTot_munic_22_pol.fid-703dc0a5_191866d88cb_-172e,2203230,Currais - PI,1821,1833,12,4839,37.63,37.88,0.25
sidra_9541_PercMoradDPPOColetTot_munic_22_pol.fid-703dc0a5_191866d88cb_-172d,2203255,Curralinhos - PI,2727,2727,,4407,61.88,61.88,
sidra_9541_PercMoradDPPOColetTot_munic_22_pol.fid-703dc0a5_191866d88cb_-172c,2203271,Curral Novo do Piauí - PI,2168,2274,106,5060,42.85,44.94,2.09
sidra_9541_PercMoradDPPOColetTot_munic_22_pol.fid-703dc0a5_191866d88cb_-172b,2203305,Demerval Lobão - PI,13467,13517,50,16347,82.38,82.69,0.31
sidra_9541_PercMoradDPPOColetTot_munic_22_pol.fid-703dc0a5_191866d88cb_-172a,2203354,Dirceu Arcoverde - PI,2775,2806,31,7048,39.37,39.81,0.44
sidra_9541_PercMoradDPPOColetTot_munic_22_pol.fid-703dc0a5_191866d88cb_-1729,2203404,Dom Expedito Lopes - PI,5715,6046,331,6320,90.43,95.66,5.24
sidra_9541_PercMoradDPPOColetTot_munic_22_pol.fid-703dc0a5_191866d88cb_-1728,2203420,Domingos Mourão - PI,1772,1773,1,4074,43.5,43.52,0.02
sidra_9541_PercMoradDPPOColetTot_munic_22_pol.fid-703dc0a5_191866d88cb_-1727,2203453,Dom Inocêncio - PI,2908,2945,37,9153,31.77,32.18,0.4
sidra_9541_PercMoradDPPOColetTot_munic_22_pol.fid-703dc0a5_191866d88cb_-1726,2203503,Elesbão Veloso - PI,9605,9774,169,13604,70.6,71.85,1.24
sidra_9541_PercMoradDPPOColetTot_munic_22_pol.fid-703dc0a5_191866d88cb_-1725,2203602,Eliseu Martins - PI,3400,3402,2,4376,77.7,77.74,0.05
sidra_9541_PercMoradDPPOColetTot_munic_22_pol.fid-703dc0a5_191866d88cb_-1724,2203701,Esperantina - PI,25153,25494,341,40863,61.55,62.39,0.83
sidra_9541_PercMoradDPPOColetTot_munic_22_pol.fid-703dc0a5_191866d88cb_-1723,2203750,Fartura do Piauí - PI,1311,1317,6,5280,24.83,24.94,0.11
sidra_9541_PercMoradDPPOColetTot_munic_22_pol.fid-703dc0a5_191866d88cb_-1722,2203800,Flores do Piauí - PI,2923,2925,2,4413,66.24,66.28,0.05
sidra_9541_PercMoradDPPOColetTot_munic_22_pol.fid-703dc0a5_191866d88cb_-1721,2203859,Floresta do Piauí - PI,1069,1069,,2329,45.9,45.9,
sidra_9541_PercMoradDPPOColetTot_munic_22_pol.fid-703dc0a5_191866d88cb_-1720,2203909,Floriano - PI,54579,55133,554,61742,88.4,89.3,0.9
sidra_9541_PercMoradDPPOColetTot_munic_22_pol.fid-703dc0a5_191866d88cb_-171f,2204006,Francinópolis - PI,3339,3401,62,4503,74.15,75.53,1.38
sidra_9541_PercMoradDPPOColetTot_munic_22_pol.fid-703dc0a5_191866d88cb_-171e,2204105,Francisco Ayres - PI,2132,2134,2,4412,48.32,48.37,0.05
sidra_9541_PercMoradDPPOColetTot_munic_22_pol.fid-703dc0a5_191866d88cb_-171d,2204154,Francisco Macedo - PI,1452,1454,2,2929,49.57,49.64,0.07
sidra_9541_PercMoradDPPOColetTot_munic_22_pol.fid-703dc0a5_191866d88cb_-171c,2204204,Francisco Santos - PI,4318,4968,650,8225,52.5,60.4,7.9
sidra_9541_PercMoradDPPOColetTot_munic_22_pol.fid-703dc0a5_191866d88cb_-171b,2204303,Fronteiras - PI,4794,7217,2423,10257,46.74,70.36,23.62
sidra_9541_PercMoradDPPOColetTot_munic_22_pol.fid-703dc0a5_191866d88cb_-171a,2204352,Geminiano - PI,4586,4606,20,5434,84.39,84.76,0.37
sidra_9541_PercMoradDPPOColetTot_munic_22_pol.fid-703dc0a5_191866d88cb_-1719,2204402,Gilbués - PI,6945,6966,21,10869,63.9,64.09,0.19
sidra_9541_PercMoradDPPOColetTot_munic_22_pol.fid-703dc0a5_191866d88cb_-1718,2204501,Guadalupe - PI,9264,9329,65,10232,90.54,91.17,0.64
sidra_9541_PercMoradDPPOColetTot_munic_22_pol.fid-703dc0a5_191866d88cb_-1717,2204550,Guaribas - PI,1220,1304,84,4272,28.56,30.52,1.97
sidra_9541_PercMoradDPPOColetTot_munic_22_pol.fid-703dc0a5_191866d88cb_-1716,2204600,Hugo Napoleão - PI,3271,3303,32,3503,93.38,94.29,0.91
sidra_9541_PercMoradDPPOColetTot_munic_22_pol.fid-703dc0a5_191866d88cb_-1715,2204659,Ilha Grande - PI,7845,8265,420,9266,84.66,89.2,4.53
sidra_9541_PercMoradDPPOColetTot_munic_22_pol.fid-703dc0a5_191866d88cb_-1714,2204709,Inhuma - PI,11972,12032,60,14951,80.07,80.48,0.4
sidra_9541_PercMoradDPPOColetTot_munic_22_pol.fid-703dc0a5_191866d88cb_-1713,2204808,Ipiranga do Piauí - PI,6193,6221,28,9411,65.81,66.1,0.3
sidra_9541_PercMoradDPPOColetTot_munic_22_pol.fid-703dc0a5_191866d88cb_-1712,2204907,Isaías Coelho - PI,2655,2719,64,7767,34.18,35.01,0.82
sidra_9541_PercMoradDPPOColetTot_munic_22_pol.fid-703dc0a5_191866d88cb_-1711,2205003,Itainópolis - PI,4234,4502,268,10761,39.35,41.84,2.49
sidra_9541_PercMoradDPPOColetTot_munic_22_pol.fid-703dc0a5_191866d88cb_-1710,2205102,Itaueira - PI,6212,6247,35,10307,60.27,60.61,0.34
sidra_9541_PercMoradDPPOColetTot_munic_22_pol.fid-703dc0a5_191866d88cb_-170f,2205151,Jacobina do Piauí - PI,2513,2558,45,5611,44.79,45.59,0.8
sidra_9541_PercMoradDPPOColetTot_munic_22_pol.fid-703dc0a5_191866d88cb_-170e,2205201,Jaicós - PI,9287,9758,471,17515,53.02,55.71,2.69
sidra_9541_PercMoradDPPOColetTot_munic_22_pol.fid-703dc0a5_191866d88cb_-170d,2205250,Jardim do Mulato - PI,1985,1985,,4180,47.49,47.49,
sidra_9541_PercMoradDPPOColetTot_munic_22_pol.fid-703dc0a5_191866d88cb_-170c,2205276,Jatobá do Piauí - PI,1368,1550,182,4494,30.44,34.49,4.05
sidra_9541_PercMoradDPPOColetTot_munic_22_pol.fid-703dc0a5_191866d88cb_-170b,2205300,Jerumenha - PI,1800,2872,1072,4491,40.08,63.95,23.87
sidra_9541_PercMoradDPPOColetTot_munic_22_pol.fid-703dc0a5_191866d88cb_-170a,2205359,João Costa - PI,945,964,19,2969,31.83,32.47,0.64
sidra_9541_PercMoradDPPOColetTot_munic_22_pol.fid-703dc0a5_191866d88cb_-1709,2205409,Joaquim Pires - PI,5139,5141,2,13877,37.03,37.05,0.01
sidra_9541_PercMoradDPPOColetTot_munic_22_pol.fid-703dc0a5_191866d88cb_-1708,2205458,Joca Marques - PI,679,1946,1267,5394,12.59,36.08,23.49
sidra_9541_PercMoradDPPOColetTot_munic_22_pol.fid-703dc0a5_191866d88cb_-1707,2205508,José de Freitas - PI,26055,27138,1083,42549,61.24,63.78,2.55
sidra_9541_PercMoradDPPOColetTot_munic_22_pol.fid-703dc0a5_191866d88cb_-1706,2205516,Juazeiro do Piauí - PI,2311,2329,18,5193,44.5,44.85,0.35
sidra_9541_PercMoradDPPOColetTot_munic_22_pol.fid-703dc0a5_191866d88cb_-1705,2205524,Júlio Borges - PI,2288,2574,286,5376,42.56,47.88,5.32
sidra_9541_PercMoradDPPOColetTot_munic_22_pol.fid-703dc0a5_191866d88cb_-1704,2205532,Jurema - PI,1447,1787,340,4425,32.7,40.38,7.68
sidra_9541_PercMoradDPPOColetTot_munic_22_pol.fid-703dc0a5_191866d88cb_-1703,2205540,Lagoinha do Piauí - PI,2510,2583,73,2939,85.4,87.89,2.48
sidra_9541_PercMoradDPPOColetTot_munic_22_pol.fid-703dc0a5_191866d88cb_-1702,2205557,Lagoa Alegre - PI,2955,2962,7,8248,35.83,35.91,0.08
sidra_9541_PercMoradDPPOColetTot_munic_22_pol.fid-703dc0a5_191866d88cb_-1701,2205565,Lagoa do Barro do Piauí - PI,1623,1684,61,4995,32.49,33.71,1.22
sidra_9541_PercMoradDPPOColetTot_munic_22_pol.fid-703dc0a5_191866d88cb_-1700,2205573,Lagoa de São Francisco - PI,1973,2026,53,6309,31.27,32.11,0.84
sidra_9541_PercMoradDPPOColetTot_munic_22_pol.fid-703dc0a5_191866d88cb_-16ff,2205581,Lagoa do Piauí - PI,2840,3110,270,4810,59.04,64.66,5.61
sidra_9541_PercMoradDPPOColetTot_munic_22_pol.fid-703dc0a5_191866d88cb_-16fe,2205599,Lagoa do Sítio - PI,2228,2357,129,4519,49.3,52.16,2.85
sidra_9541_PercMoradDPPOColetTot_munic_22_pol.fid-703dc0a5_191866d88cb_-16fd,2205607,Landri Sales - PI,4307,4387,80,5212,82.64,84.17,1.53
sidra_9541_PercMoradDPPOColetTot_munic_22_pol.fid-703dc0a5_191866d88cb_-16fc,2205706,Luís Correia - PI,15955,16536,581,30604,52.13,54.03,1.9
sidra_9541_PercMoradDPPOColetTot_munic_22_pol.fid-703dc0a5_191866d88cb_-16fb,2205805,Luzilândia - PI,14521,16112,1591,25368,57.24,63.51,6.27
sidra_9541_PercMoradDPPOColetTot_munic_22_pol.fid-703dc0a5_191866d88cb_-16fa,2205854,Madeiro - PI,2909,3817,908,8031,36.22,47.53,11.31
sidra_9541_PercMoradDPPOColetTot_munic_22_pol.fid-703dc0a5_191866d88cb_-16f9,2205904,Manoel Emídio - PI,3575,3594,19,5209,68.63,69,0.36
sidra_9541_PercMoradDPPOColetTot_munic_22_pol.fid-703dc0a5_191866d88cb_-16f8,2205953,Marcolândia - PI,7456,7490,34,8526,87.45,87.85,0.4
sidra_9541_PercMoradDPPOColetTot_munic_22_pol.fid-703dc0a5_191866d88cb_-16f7,2206001,Marcos Parente - PI,3963,4173,210,4722,83.93,88.37,4.45
sidra_9541_PercMoradDPPOColetTot_munic_22_pol.fid-703dc0a5_191866d88cb_-16f6,2206050,Massapê do Piauí - PI,1290,1358,68,5218,24.72,26.03,1.3
sidra_9541_PercMoradDPPOColetTot_munic_22_pol.fid-703dc0a5_191866d88cb_-16f5,2206100,Matias Olímpio - PI,4173,4272,99,10641,39.22,40.15,0.93
sidra_9541_PercMoradDPPOColetTot_munic_22_pol.fid-703dc0a5_191866d88cb_-16f4,2206209,Miguel Alves - PI,8959,10217,1258,32136,27.88,31.79,3.91
sidra_9541_PercMoradDPPOColetTot_munic_22_pol.fid-703dc0a5_191866d88cb_-16f3,2206308,Miguel Leão - PI,897,897,,1313,68.32,68.32,
sidra_9541_PercMoradDPPOColetTot_munic_22_pol.fid-703dc0a5_191866d88cb_-16f2,2206357,Milton Brandão - PI,2100,2399,299,6538,32.12,36.69,4.57
sidra_9541_PercMoradDPPOColetTot_munic_22_pol.fid-703dc0a5_191866d88cb_-16f1,2206407,Monsenhor Gil - PI,5824,6382,558,10252,56.81,62.25,5.44
sidra_9541_PercMoradDPPOColetTot_munic_22_pol.fid-703dc0a5_191866d88cb_-16f0,2206506,Monsenhor Hipólito - PI,2606,5044,2438,7570,34.43,66.63,32.21
sidra_9541_PercMoradDPPOColetTot_munic_22_pol.fid-703dc0a5_191866d88cb_-16ef,2206605,Monte Alegre do Piauí - PI,4105,4434,329,10653,38.53,41.62,3.09
sidra_9541_PercMoradDPPOColetTot_munic_22_pol.fid-703dc0a5_191866d88cb_-16ee,2206654,Morro Cabeça no Tempo - PI,880,1748,868,4361,20.18,40.08,19.9
sidra_9541_PercMoradDPPOColetTot_munic_22_pol.fid-703dc0a5_191866d88cb_-16ed,2206670,Morro do Chapéu do Piauí - PI,1875,2787,912,6416,29.22,43.44,14.21
sidra_9541_PercMoradDPPOColetTot_munic_22_pol.fid-703dc0a5_191866d88cb_-16ec,2206696,Murici dos Portelas - PI,2465,4184,1719,9784,25.19,42.76,17.57
sidra_9541_PercMoradDPPOColetTot_munic_22_pol.fid-703dc0a5_191866d88cb_-16eb,2206704,Nazaré do Piauí - PI,3490,3547,57,6665,52.36,53.22,0.86
sidra_9541_PercMoradDPPOColetTot_munic_22_pol.fid-703dc0a5_191866d88cb_-16ea,2206720,Nazária - PI,4641,4648,7,10235,45.34,45.41,0.07
sidra_9541_PercMoradDPPOColetTot_munic_22_pol.fid-703dc0a5_191866d88cb_-16e9,2206753,Nossa Senhora de Nazaré - PI,2074,2405,331,5228,39.67,46,6.33
sidra_9541_PercMoradDPPOColetTot_munic_22_pol.fid-703dc0a5_191866d88cb_-16e8,2206803,Nossa Senhora dos Remédios - PI,2842,2848,6,8520,33.36,33.43,0.07
sidra_9541_PercMoradDPPOColetTot_munic_22_pol.fid-703dc0a5_191866d88cb_-16e6,2206902,Novo Oriente do Piauí - PI,3184,3516,332,6082,52.35,57.81,5.46
sidra_9541_PercMoradDPPOColetTot_munic_22_pol.fid-703dc0a5_191866d88cb_-16e5,2206951,Novo Santo Antônio - PI,1073,1124,51,2825,37.98,39.79,1.81
sidra_9541_PercMoradDPPOColetTot_munic_22_pol.fid-703dc0a5_191866d88cb_-16e4,2207009,Oeiras - PI,26246,28074,1828,38077,68.93,73.73,4.8
sidra_9541_PercMoradDPPOColetTot_munic_22_pol.fid-703dc0a5_191866d88cb_-16e3,2207108,Olho D'Água do Piauí - PI,1601,1604,3,2637,60.71,60.83,0.11
sidra_9541_PercMoradDPPOColetTot_munic_22_pol.fid-703dc0a5_191866d88cb_-16e2,2207207,Padre Marcos - PI,3280,3427,147,6366,51.52,53.83,2.31
sidra_9541_PercMoradDPPOColetTot_munic_22_pol.fid-703dc0a5_191866d88cb_-16e1,2207306,Paes Landim - PI,2230,2613,383,4088,54.55,63.92,9.37
sidra_9541_PercMoradDPPOColetTot_munic_22_pol.fid-703dc0a5_191866d88cb_-16e0,2207355,Pajeú do Piauí - PI,1744,1744,,3000,58.13,58.13,
sidra_9541_PercMoradDPPOColetTot_munic_22_pol.fid-703dc0a5_191866d88cb_-16df,2207405,Palmeira do Piauí - PI,1842,1868,26,4942,37.27,37.8,0.53
sidra_9541_PercMoradDPPOColetTot_munic_22_pol.fid-703dc0a5_191866d88cb_-16de,2207504,Palmeirais - PI,6447,6533,86,13260,48.62,49.27,0.65
sidra_9541_PercMoradDPPOColetTot_munic_22_pol.fid-703dc0a5_191866d88cb_-16dd,2207553,Paquetá - PI,2176,2705,529,3813,57.07,70.94,13.87
sidra_9541_PercMoradDPPOColetTot_munic_22_pol.fid-703dc0a5_191866d88cb_-16dc,2207603,Parnaguá - PI,3566,4682,1116,10095,35.32,46.38,11.05
sidra_9541_PercMoradDPPOColetTot_munic_22_pol.fid-703dc0a5_191866d88cb_-16db,2207702,Parnaíba - PI,145854,151936,6082,161489,90.32,94.08,3.77
sidra_9541_PercMoradDPPOColetTot_munic_22_pol.fid-703dc0a5_191866d88cb_-16da,2207751,Passagem Franca do Piauí - PI,2642,2645,3,4135,63.89,63.97,0.07
sidra_9541_PercMoradDPPOColetTot_munic_22_pol.fid-703dc0a5_191866d88cb_-16d9,2207777,Patos do Piauí - PI,2133,2425,292,5425,39.32,44.7,5.38
sidra_9541_PercMoradDPPOColetTot_munic_22_pol.fid-703dc0a5_191866d88cb_-16d8,2207793,Pau D'Arco do Piauí - PI,417,887,470,3877,10.76,22.88,12.12
sidra_9541_PercMoradDPPOColetTot_munic_22_pol.fid-703dc0a5_191866d88cb_-16d7,2207801,Paulistana - PI,12251,13155,904,21051,58.2,62.49,4.29
sidra_9541_PercMoradDPPOColetTot_munic_22_pol.fid-703dc0a5_191866d88cb_-16d6,2207850,Pavussu - PI,1863,1869,6,3625,51.39,51.56,0.17
sidra_9541_PercMoradDPPOColetTot_munic_22_pol.fid-703dc0a5_191866d88cb_-16d5,2207900,Pedro II - PI,25453,26835,1382,37876,67.2,70.85,3.65
sidra_9541_PercMoradDPPOColetTot_munic_22_pol.fid-703dc0a5_191866d88cb_-16d4,2207934,Pedro Laurentino - PI,1082,1082,,2453,44.11,44.11,
sidra_9541_PercMoradDPPOColetTot_munic_22_pol.fid-703dc0a5_191866d88cb_-16d3,2207959,Nova Santa Rita - PI,1227,1245,18,4076,30.1,30.54,0.44
sidra_9541_PercMoradDPPOColetTot_munic_22_pol.fid-703dc0a5_191866d88cb_-16d2,2208007,Picos - PI,75927,79491,3564,82568,91.96,96.27,4.32
sidra_9541_PercMoradDPPOColetTot_munic_22_pol.fid-703dc0a5_191866d88cb_-16d1,2208106,Pimenteiras - PI,5390,5482,92,11311,47.65,48.47,0.81
sidra_9541_PercMoradDPPOColetTot_munic_22_pol.fid-703dc0a5_191866d88cb_-16d0,2208205,Pio IX - PI,9940,10006,66,17594,56.5,56.87,0.38
sidra_9541_PercMoradDPPOColetTot_munic_22_pol.fid-703dc0a5_191866d88cb_-16cf,2208304,Piracuruca - PI,21456,22140,684,28828,74.43,76.8,2.37
sidra_9541_PercMoradDPPOColetTot_munic_22_pol.fid-703dc0a5_191866d88cb_-16ce,2208403,Piripiri - PI,54909,55798,889,65507,83.82,85.18,1.36
sidra_9541_PercMoradDPPOColetTot_munic_22_pol.fid-703dc0a5_191866d88cb_-16cd,2208502,Porto - PI,6921,7091,170,12034,57.51,58.92,1.41
sidra_9541_PercMoradDPPOColetTot_munic_22_pol.fid-703dc0a5_191866d88cb_-16cc,2208551,Porto Alegre do Piauí - PI,1671,1671,,2364,70.69,70.69,
sidra_9541_PercMoradDPPOColetTot_munic_22_pol.fid-703dc0a5_191866d88cb_-16cb,2208601,Prata do Piauí - PI,2529,2529,,3042,83.14,83.14,
sidra_9541_PercMoradDPPOColetTot_munic_22_pol.fid-703dc0a5_191866d88cb_-16ca,2208650,Queimada Nova - PI,2697,2707,10,8738,30.87,30.98,0.11
sidra_9541_PercMoradDPPOColetTot_munic_22_pol.fid-703dc0a5_191866d88cb_-16c9,2208700,Redenção do Gurguéia - PI,4625,4679,54,8369,55.26,55.91,0.65
sidra_9541_PercMoradDPPOColetTot_munic_22_pol.fid-703dc0a5_191866d88cb_-16c8,2208809,Regeneração - PI,12750,12996,246,17119,74.48,75.92,1.44
sidra_9541_PercMoradDPPOColetTot_munic_22_pol.fid-703dc0a5_191866d88cb_-16c7,2208858,Riacho Frio - PI,2209,2401,192,4165,53.04,57.65,4.61
sidra_9541_PercMoradDPPOColetTot_munic_22_pol.fid-703dc0a5_191866d88cb_-16c6,2208874,Ribeira do Piauí - PI,1910,2546,636,4054,47.11,62.8,15.69
sidra_9541_PercMoradDPPOColetTot_munic_22_pol.fid-703dc0a5_191866d88cb_-16c5,2208908,Ribeiro Gonçalves - PI,3044,4283,1239,6151,49.49,69.63,20.14
sidra_9541_PercMoradDPPOColetTot_munic_22_pol.fid-703dc0a5_191866d88cb_-16c4,2209005,Rio Grande do Piauí - PI,3655,3675,20,5796,63.06,63.41,0.35
sidra_9541_PercMoradDPPOColetTot_munic_22_pol.fid-703dc0a5_191866d88cb_-16c3,2209104,Santa Cruz do Piauí - PI,4331,4333,2,5827,74.33,74.36,0.03
sidra_9541_PercMoradDPPOColetTot_munic_22_pol.fid-703dc0a5_191866d88cb_-16c2,2209153,Santa Cruz dos Milagres - PI,2686,2773,87,3435,78.2,80.73,2.53
sidra_9541_PercMoradDPPOColetTot_munic_22_pol.fid-703dc0a5_191866d88cb_-16c1,2209203,Santa Filomena - PI,3223,3900,677,6063,53.16,64.32,11.17
sidra_9541_PercMoradDPPOColetTot_munic_22_pol.fid-703dc0a5_191866d88cb_-16c0,2209302,Santa Luz - PI,3966,4066,100,5332,74.38,76.26,1.88
sidra_9541_PercMoradDPPOColetTot_munic_22_pol.fid-703dc0a5_191866d88cb_-16bf,2209351,Santana do Piauí - PI,3733,3736,3,4121,90.58,90.66,0.07
sidra_9541_PercMoradDPPOColetTot_munic_22_pol.fid-703dc0a5_191866d88cb_-16be,2209377,Santa Rosa do Piauí - PI,3558,3564,6,4650,76.52,76.65,0.13
sidra_9541_PercMoradDPPOColetTot_munic_22_pol.fid-703dc0a5_191866d88cb_-16bd,2209401,Santo Antônio de Lisboa - PI,4577,4689,112,5817,78.68,80.61,1.93
sidra_9541_PercMoradDPPOColetTot_munic_22_pol.fid-703dc0a5_191866d88cb_-16bc,2209450,Santo Antônio dos Milagres - PI,1300,1331,31,2137,60.83,62.28,1.45
sidra_9541_PercMoradDPPOColetTot_munic_22_pol.fid-703dc0a5_191866d88cb_-16bb,2209500,Santo Inácio do Piauí - PI,2384,2384,,3636,65.57,65.57,
sidra_9541_PercMoradDPPOColetTot_munic_22_pol.fid-703dc0a5_191866d88cb_-16ba,2209559,São Braz do Piauí - PI,2318,2362,44,4358,53.19,54.2,1.01
sidra_9541_PercMoradDPPOColetTot_munic_22_pol.fid-703dc0a5_191866d88cb_-16b9,2209609,São Félix do Piauí - PI,2342,2345,3,2840,82.46,82.57,0.11
sidra_9541_PercMoradDPPOColetTot_munic_22_pol.fid-703dc0a5_191866d88cb_-16b8,2209658,São Francisco de Assis do Piauí - PI,1746,1883,137,5571,31.34,33.8,2.46
sidra_9541_PercMoradDPPOColetTot_munic_22_pol.fid-703dc0a5_191866d88cb_-16b7,2209708,São Francisco do Piauí - PI,2069,2795,726,5392,38.37,51.84,13.46
sidra_9541_PercMoradDPPOColetTot_munic_22_pol.fid-703dc0a5_191866d88cb_-16b6,2209757,São Gonçalo do Gurguéia - PI,1415,1418,3,2947,48.01,48.12,0.1
sidra_9541_PercMoradDPPOColetTot_munic_22_pol.fid-703dc0a5_191866d88cb_-16b5,2209807,São Gonçalo do Piauí - PI,4309,4309,,4823,89.34,89.34,
sidra_9541_PercMoradDPPOColetTot_munic_22_pol.fid-703dc0a5_191866d88cb_-16b4,2209856,São João da Canabrava - PI,2403,2456,53,4240,56.67,57.92,1.25
sidra_9541_PercMoradDPPOColetTot_munic_22_pol.fid-703dc0a5_191866d88cb_-16b3,2209872,São João da Fronteira - PI,3283,3291,8,5485,59.85,60,0.15
sidra_9541_PercMoradDPPOColetTot_munic_22_pol.fid-703dc0a5_191866d88cb_-16b2,2209906,São João da Serra - PI,3927,4124,197,6088,64.5,67.74,3.24
sidra_9541_PercMoradDPPOColetTot_munic_22_pol.fid-703dc0a5_191866d88cb_-16b1,2209955,São João da Varjota - PI,1551,1559,8,4380,35.41,35.59,0.18
sidra_9541_PercMoradDPPOColetTot_munic_22_pol.fid-703dc0a5_191866d88cb_-16b0,2209971,São João do Arraial - PI,4012,4031,19,8180,49.05,49.28,0.23
sidra_9541_PercMoradDPPOColetTot_munic_22_pol.fid-703dc0a5_191866d88cb_-16af,2210003,São João do Piauí - PI,16178,16505,327,21408,75.57,77.1,1.53
sidra_9541_PercMoradDPPOColetTot_munic_22_pol.fid-703dc0a5_191866d88cb_-16ae,2210052,São José do Divino - PI,3020,4215,1195,4838,62.42,87.12,24.7
sidra_9541_PercMoradDPPOColetTot_munic_22_pol.fid-703dc0a5_191866d88cb_-16ad,2210102,São José do Peixe - PI,2265,2332,67,3292,68.8,70.84,2.04
sidra_9541_PercMoradDPPOColetTot_munic_22_pol.fid-703dc0a5_191866d88cb_-16ac,2210201,São José do Piauí - PI,5458,5463,5,6597,82.73,82.81,0.08
sidra_9541_PercMoradDPPOColetTot_munic_22_pol.fid-703dc0a5_191866d88cb_-16ab,2210300,São Julião - PI,3670,4486,816,6025,60.91,74.46,13.54
sidra_9541_PercMoradDPPOColetTot_munic_22_pol.fid-703dc0a5_191866d88cb_-16aa,2210359,São Lourenço do Piauí - PI,1404,1477,73,4408,31.85,33.51,1.66
sidra_9541_PercMoradDPPOColetTot_munic_22_pol.fid-703dc0a5_191866d88cb_-16a9,2210375,São Luis do Piauí - PI,1163,1368,205,2309,50.37,59.25,8.88
sidra_9541_PercMoradDPPOColetTot_munic_22_pol.fid-703dc0a5_191866d88cb_-16a8,2210383,São Miguel da Baixa Grande - PI,1399,1418,19,2269,61.66,62.49,0.84
sidra_9541_PercMoradDPPOColetTot_munic_22_pol.fid-703dc0a5_191866d88cb_-16a7,2210391,São Miguel do Fidalgo - PI,1592,1634,42,2828,56.29,57.78,1.49
sidra_9541_PercMoradDPPOColetTot_munic_22_pol.fid-703dc0a5_191866d88cb_-16a6,2210409,São Miguel do Tapuio - PI,9580,9680,100,17551,54.58,55.15,0.57
sidra_9541_PercMoradDPPOColetTot_munic_22_pol.fid-703dc0a5_191866d88cb_-16a5,2210508,São Pedro do Piauí - PI,11052,11102,50,13748,80.39,80.75,0.36
sidra_9541_PercMoradDPPOColetTot_munic_22_pol.fid-703dc0a5_191866d88cb_-16a4,2210607,São Raimundo Nonato - PI,26629,27044,415,38843,68.56,69.62,1.07
sidra_9541_PercMoradDPPOColetTot_munic_22_pol.fid-703dc0a5_191866d88cb_-16a3,2210623,Sebastião Barros - PI,1320,1320,,3196,41.3,41.3,
sidra_9541_PercMoradDPPOColetTot_munic_22_pol.fid-703dc0a5_191866d88cb_-16a2,2210631,Sebastião Leal - PI,1026,2289,1263,4446,23.08,51.48,28.41
sidra_9541_PercMoradDPPOColetTot_munic_22_pol.fid-703dc0a5_191866d88cb_-16a1,2210656,Sigefredo Pacheco - PI,5417,5460,43,9455,57.29,57.75,0.45
sidra_9541_PercMoradDPPOColetTot_munic_22_pol.fid-703dc0a5_191866d88cb_-16a0,2210706,Simões - PI,7590,7650,60,14335,52.95,53.37,0.42
sidra_9541_PercMoradDPPOColetTot_munic_22_pol.fid-703dc0a5_191866d88cb_-169f,2210805,Simplício Mendes - PI,7742,9940,2198,13806,56.08,72,15.92
sidra_9541_PercMoradDPPOColetTot_munic_22_pol.fid-703dc0a5_191866d88cb_-169e,2210904,Socorro do Piauí - PI,1942,2253,311,4139,46.92,54.43,7.51
sidra_9541_PercMoradDPPOColetTot_munic_22_pol.fid-703dc0a5_191866d88cb_-169d,2210938,Sussuapara - PI,5591,5691,100,6220,89.89,91.5,1.61
sidra_9541_PercMoradDPPOColetTot_munic_22_pol.fid-703dc0a5_191866d88cb_-169c,2210953,Tamboril do Piauí - PI,1405,1410,5,2945,47.71,47.88,0.17
sidra_9541_PercMoradDPPOColetTot_munic_22_pol.fid-703dc0a5_191866d88cb_-169b,2210979,Tanque do Piauí - PI,1711,1714,3,2312,74.01,74.13,0.13
sidra_9541_PercMoradDPPOColetTot_munic_22_pol.fid-703dc0a5_191866d88cb_-169a,2211001,Teresina - PI,803946,827651,23705,862981,93.16,95.91,2.75
sidra_9541_PercMoradDPPOColetTot_munic_22_pol.fid-703dc0a5_191866d88cb_-1699,2211100,União - PI,22208,23190,982,46097,48.18,50.31,2.13
sidra_9541_PercMoradDPPOColetTot_munic_22_pol.fid-703dc0a5_191866d88cb_-1698,2211209,Uruçuí - PI,19415,19733,318,25182,77.1,78.36,1.26
sidra_9541_PercMoradDPPOColetTot_munic_22_pol.fid-703dc0a5_191866d88cb_-1697,2211308,Valença do Piauí - PI,18352,18514,162,22269,82.41,83.14,0.73
sidra_9541_PercMoradDPPOColetTot_munic_22_pol.fid-703dc0a5_191866d88cb_-1696,2211357,Várzea Branca - PI,1137,1375,238,5045,22.54,27.25,4.72
sidra_9541_PercMoradDPPOColetTot_munic_22_pol.fid-703dc0a5_191866d88cb_-1695,2211407,Várzea Grande - PI,3219,3228,9,4417,72.88,73.08,0.2
sidra_9541_PercMoradDPPOColetTot_munic_22_pol.fid-703dc0a5_191866d88cb_-1694,2211506,Vera Mendes - PI,1238,1489,251,3185,38.87,46.75,7.88
sidra_9541_PercMoradDPPOColetTot_munic_22_pol.fid-703dc0a5_191866d88cb_-1693,2211605,Vila Nova do Piauí - PI,1694,1699,5,2934,57.74,57.91,0.17
sidra_9541_PercMoradDPPOColetTot_munic_22_pol.fid-703dc0a5_191866d88cb_-1692,2211704,Wall Ferraz - PI,1783,1869,86,4059,43.93,46.05,2.12
sidra_9541_PercMoradDPPOColetTot_munic_22_pol.fid-703dc0a5_191866d88cb_-1691,2300101,Abaiara - CE,4514,5042,528,10021,45.05,50.31,5.27
sidra_9541_PercMoradDPPOColetTot_munic_22_pol.fid-703dc0a5_191866d88cb_-1690,2300150,Acarape - CE,11833,12726,893,14022,84.39,90.76,6.37
sidra_9541_PercMoradDPPOColetTot_munic_22_pol.fid-703dc0a5_191866d88cb_-168f,2300200,Acaraú - CE,36939,45848,8909,65154,56.69,70.37,13.67
sidra_9541_PercMoradDPPOColetTot_munic_22_pol.fid-703dc0a5_191866d88cb_-168e,2300309,Acopiara - CE,23494,27956,4462,44911,52.31,62.25,9.94
sidra_9541_PercMoradDPPOColetTot_munic_22_pol.fid-703dc0a5_191866d88cb_-168d,2300408,Aiuaba - CE,7488,8183,695,14059,53.26,58.2,4.94
sidra_9541_PercMoradDPPOColetTot_munic_22_pol.fid-703dc0a5_191866d88cb_-168c,2300507,Alcântaras - CE,1929,9191,7262,11367,16.97,80.86,63.89
sidra_9541_PercMoradDPPOColetTot_munic_22_pol.fid-703dc0a5_191866d88cb_-168b,2300606,Altaneira - CE,6143,6170,27,6771,90.73,91.12,0.4
sidra_9541_PercMoradDPPOColetTot_munic_22_pol.fid-703dc0a5_191866d88cb_-168a,2300705,Alto Santo - CE,9192,9807,615,14154,64.94,69.29,4.35
sidra_9541_PercMoradDPPOColetTot_munic_22_pol.fid-703dc0a5_191866d88cb_-1689,2300754,Amontada - CE,6922,20149,13227,42147,16.42,47.81,31.38
sidra_9541_PercMoradDPPOColetTot_munic_22_pol.fid-703dc0a5_191866d88cb_-1688,2300804,Antonina do Norte - CE,1426,5985,4559,7241,19.69,82.65,62.96
sidra_9541_PercMoradDPPOColetTot_munic_22_pol.fid-703dc0a5_191866d88cb_-1687,2300903,Apuiarés - CE,5329,9344,4015,12915,41.26,72.35,31.09
sidra_9541_PercMoradDPPOColetTot_munic_22_pol.fid-703dc0a5_191866d88cb_-1686,2301000,Aquiraz - CE,63161,71678,8517,79730,79.22,89.9,10.68
sidra_9541_PercMoradDPPOColetTot_munic_22_pol.fid-703dc0a5_191866d88cb_-1685,2301109,Aracati - CE,63986,66358,2372,75026,85.29,88.45,3.16
sidra_9541_PercMoradDPPOColetTot_munic_22_pol.fid-703dc0a5_191866d88cb_-1684,2301208,Aracoiaba - CE,14801,22286,7485,25547,57.94,87.24,29.3
sidra_9541_PercMoradDPPOColetTot_munic_22_pol.fid-703dc0a5_191866d88cb_-1683,2301257,Ararendá - CE,4822,6421,1599,11069,43.56,58.01,14.45
sidra_9541_PercMoradDPPOColetTot_munic_22_pol.fid-703dc0a5_191866d88cb_-1682,2301307,Araripe - CE,12022,12288,266,19767,60.82,62.16,1.35
sidra_9541_PercMoradDPPOColetTot_munic_22_pol.fid-703dc0a5_191866d88cb_-1681,2301406,Aratuba - CE,3795,7214,3419,11217,33.83,64.31,30.48
sidra_9541_PercMoradDPPOColetTot_munic_22_pol.fid-703dc0a5_191866d88cb_-1680,2301505,Arneiroz - CE,2537,4685,2148,7408,34.25,63.24,29
sidra_9541_PercMoradDPPOColetTot_munic_22_pol.fid-703dc0a5_191866d88cb_-167f,2301604,Assaré - CE,11242,14860,3618,21651,51.92,68.63,16.71
sidra_9541_PercMoradDPPOColetTot_munic_22_pol.fid-703dc0a5_191866d88cb_-167e,2301703,Aurora - CE,5297,13812,8515,23699,22.35,58.28,35.93
sidra_9541_PercMoradDPPOColetTot_munic_22_pol.fid-703dc0a5_191866d88cb_-167d,2301802,Baixio - CE,2386,3873,1487,5702,41.84,67.92,26.08
sidra_9541_PercMoradDPPOColetTot_munic_22_pol.fid-703dc0a5_191866d88cb_-167c,2301851,Banabuiú - CE,9701,9839,138,17166,56.51,57.32,0.8
sidra_9541_PercMoradDPPOColetTot_munic_22_pol.fid-703dc0a5_191866d88cb_-167b,2301901,Barbalha - CE,63880,66444,2564,74962,85.22,88.64,3.42
sidra_9541_PercMoradDPPOColetTot_munic_22_pol.fid-703dc0a5_191866d88cb_-167a,2301950,Barreira - CE,15380,17966,2586,22385,68.71,80.26,11.55
sidra_9541_PercMoradDPPOColetTot_munic_22_pol.fid-703dc0a5_191866d88cb_-1679,2302008,Barro - CE,12992,13520,528,19377,67.05,69.77,2.72
sidra_9541_PercMoradDPPOColetTot_munic_22_pol.fid-703dc0a5_191866d88cb_-1678,2302057,Barroquinha - CE,8513,10230,1717,14558,58.48,70.27,11.79
sidra_9541_PercMoradDPPOColetTot_munic_22_pol.fid-703dc0a5_191866d88cb_-1677,2302107,Baturité - CE,22616,29551,6935,35187,64.27,83.98,19.71
sidra_9541_PercMoradDPPOColetTot_munic_22_pol.fid-703dc0a5_191866d88cb_-1676,2302206,Beberibe - CE,33354,40194,6840,53025,62.9,75.8,12.9
sidra_9541_PercMoradDPPOColetTot_munic_22_pol.fid-703dc0a5_191866d88cb_-1675,2302305,Bela Cruz - CE,12268,17022,4754,32731,37.48,52.01,14.52
sidra_9541_PercMoradDPPOColetTot_munic_22_pol.fid-703dc0a5_191866d88cb_-1674,2302404,Boa Viagem - CE,16090,31254,15164,50355,31.95,62.07,30.11
sidra_9541_PercMoradDPPOColetTot_munic_22_pol.fid-703dc0a5_191866d88cb_-1673,2302503,Brejo Santo - CE,36764,40544,3780,51050,72.02,79.42,7.4
sidra_9541_PercMoradDPPOColetTot_munic_22_pol.fid-703dc0a5_191866d88cb_-1672,2302602,Camocim - CE,45080,47582,2502,62273,72.39,76.41,4.02
sidra_9541_PercMoradDPPOColetTot_munic_22_pol.fid-703dc0a5_191866d88cb_-1671,2302701,Campos Sales - CE,6830,19240,12410,25083,27.23,76.71,49.48
sidra_9541_PercMoradDPPOColetTot_munic_22_pol.fid-703dc0a5_191866d88cb_-166f,2302800,Canindé - CE,35310,50050,14740,74036,47.69,67.6,19.91
sidra_9541_PercMoradDPPOColetTot_munic_22_pol.fid-703dc0a5_191866d88cb_-166e,2302909,Capistrano - CE,5725,11261,5536,17250,33.19,65.28,32.09
sidra_9541_PercMoradDPPOColetTot_munic_22_pol.fid-703dc0a5_191866d88cb_-166d,2303006,Caridade - CE,8822,12224,3402,16369,53.89,74.68,20.78
sidra_9541_PercMoradDPPOColetTot_munic_22_pol.fid-703dc0a5_191866d88cb_-166c,2303105,Cariré - CE,8710,13749,5039,17620,49.43,78.03,28.6
sidra_9541_PercMoradDPPOColetTot_munic_22_pol.fid-703dc0a5_191866d88cb_-166b,2303204,Caririaçu - CE,15627,16189,562,26303,59.41,61.55,2.14
sidra_9541_PercMoradDPPOColetTot_munic_22_pol.fid-703dc0a5_191866d88cb_-166a,2303303,Cariús - CE,10898,12361,1463,17015,64.05,72.65,8.6
sidra_9541_PercMoradDPPOColetTot_munic_22_pol.fid-703dc0a5_191866d88cb_-1669,2303402,Carnaubal - CE,2040,15376,13336,17207,11.86,89.36,77.5
sidra_9541_PercMoradDPPOColetTot_munic_22_pol.fid-703dc0a5_191866d88cb_-1668,2303501,Cascavel - CE,57062,61185,4123,72689,78.5,84.17,5.67
sidra_9541_PercMoradDPPOColetTot_munic_22_pol.fid-703dc0a5_191866d88cb_-1667,2303600,Catarina - CE,2311,6833,4522,10231,22.59,66.79,44.2
sidra_9541_PercMoradDPPOColetTot_munic_22_pol.fid-703dc0a5_191866d88cb_-1666,2303659,Catunda - CE,6179,6591,412,10441,59.18,63.13,3.95
sidra_9541_PercMoradDPPOColetTot_munic_22_pol.fid-703dc0a5_191866d88cb_-1665,2303709,Caucaia - CE,309795,331078,21283,354944,87.28,93.28,6
sidra_9541_PercMoradDPPOColetTot_munic_22_pol.fid-703dc0a5_191866d88cb_-1664,2303808,Cedro - CE,14516,14953,437,22336,64.99,66.95,1.96
sidra_9541_PercMoradDPPOColetTot_munic_22_pol.fid-703dc0a5_191866d88cb_-1663,2303907,Chaval - CE,9691,9694,3,12410,78.09,78.11,0.02
sidra_9541_PercMoradDPPOColetTot_munic_22_pol.fid-703dc0a5_191866d88cb_-1662,2303931,Choró - CE,1795,3403,1608,12110,14.82,28.1,13.28
sidra_9541_PercMoradDPPOColetTot_munic_22_pol.fid-703dc0a5_191866d88cb_-1661,2303956,Chorozinho - CE,11550,16188,4638,20127,57.39,80.43,23.04
sidra_9541_PercMoradDPPOColetTot_munic_22_pol.fid-703dc0a5_191866d88cb_-1660,2304004,Coreaú - CE,12375,14117,1742,20944,59.09,67.4,8.32
sidra_9541_PercMoradDPPOColetTot_munic_22_pol.fid-703dc0a5_191866d88cb_-165f,2304103,Crateús - CE,60249,61356,1107,76232,79.03,80.49,1.45
sidra_9541_PercMoradDPPOColetTot_munic_22_pol.fid-703dc0a5_191866d88cb_-165e,2304202,Crato - CE,116896,119515,2619,130823,89.35,91.36,2
sidra_9541_PercMoradDPPOColetTot_munic_22_pol.fid-703dc0a5_191866d88cb_-165d,2304236,Croatá - CE,15218,15726,508,17476,87.08,89.99,2.91
sidra_9541_PercMoradDPPOColetTot_munic_22_pol.fid-703dc0a5_191866d88cb_-165c,2304251,Cruz - CE,20210,22234,2024,29711,68.02,74.83,6.81
sidra_9541_PercMoradDPPOColetTot_munic_22_pol.fid-703dc0a5_191866d88cb_-165b,2304269,Deputado Irapuan Pinheiro - CE,5179,5424,245,8916,58.09,60.83,2.75
sidra_9541_PercMoradDPPOColetTot_munic_22_pol.fid-703dc0a5_191866d88cb_-165a,2304277,Ereré - CE,4241,4252,11,6473,65.52,65.69,0.17
sidra_9541_PercMoradDPPOColetTot_munic_22_pol.fid-703dc0a5_191866d88cb_-1659,2304285,Eusébio - CE,71887,73692,1805,74084,97.03,99.47,2.44
sidra_9541_PercMoradDPPOColetTot_munic_22_pol.fid-703dc0a5_191866d88cb_-1658,2304301,Farias Brito - CE,13863,14541,678,18202,76.16,79.89,3.72
sidra_9541_PercMoradDPPOColetTot_munic_22_pol.fid-703dc0a5_191866d88cb_-1657,2304350,Forquilha - CE,18176,20802,2626,24162,75.23,86.09,10.87
sidra_9541_PercMoradDPPOColetTot_munic_22_pol.fid-703dc0a5_191866d88cb_-1656,2304400,Fortaleza - CE,2310277,2415650,105373,2424880,95.27,99.62,4.35
sidra_9541_PercMoradDPPOColetTot_munic_22_pol.fid-703dc0a5_191866d88cb_-1655,2304459,Fortim - CE,10624,15410,4786,17253,61.58,89.32,27.74
sidra_9541_PercMoradDPPOColetTot_munic_22_pol.fid-703dc0a5_191866d88cb_-1654,2304509,Frecheirinha - CE,5070,12401,7331,15651,32.39,79.23,46.84
sidra_9541_PercMoradDPPOColetTot_munic_22_pol.fid-703dc0a5_191866d88cb_-1653,2304608,General Sampaio - CE,4589,4646,57,6701,68.48,69.33,0.85
sidra_9541_PercMoradDPPOColetTot_munic_22_pol.fid-703dc0a5_191866d88cb_-1652,2304657,Graça - CE,7636,8352,716,13801,55.33,60.52,5.19
sidra_9541_PercMoradDPPOColetTot_munic_22_pol.fid-703dc0a5_191866d88cb_-1651,2304707,Granja - CE,15331,26049,10718,53314,28.76,48.86,20.1
sidra_9541_PercMoradDPPOColetTot_munic_22_pol.fid-703dc0a5_191866d88cb_-1650,2304806,Granjeiro - CE,2942,3381,439,4840,60.79,69.86,9.07
sidra_9541_PercMoradDPPOColetTot_munic_22_pol.fid-703dc0a5_191866d88cb_-164f,2304905,Groaíras - CE,3163,8817,5654,10901,29.02,80.88,51.87
sidra_9541_PercMoradDPPOColetTot_munic_22_pol.fid-703dc0a5_191866d88cb_-164e,2304954,Guaiúba - CE,17846,22279,4433,24310,73.41,91.65,18.24
sidra_9541_PercMoradDPPOColetTot_munic_22_pol.fid-703dc0a5_191866d88cb_-164d,2305001,Guaraciaba do Norte - CE,27460,36281,8821,41972,65.42,86.44,21.02
sidra_9541_PercMoradDPPOColetTot_munic_22_pol.fid-703dc0a5_191866d88cb_-164c,2305100,Guaramiranga - CE,4220,5162,942,5639,74.84,91.54,16.71
sidra_9541_PercMoradDPPOColetTot_munic_22_pol.fid-703dc0a5_191866d88cb_-164b,2305209,Hidrolândia - CE,11812,12287,475,17853,66.16,68.82,2.66
sidra_9541_PercMoradDPPOColetTot_munic_22_pol.fid-703dc0a5_191866d88cb_-164a,2305233,Horizonte - CE,71645,72776,1131,74670,95.95,97.46,1.51
sidra_9541_PercMoradDPPOColetTot_munic_22_pol.fid-703dc0a5_191866d88cb_-1649,2305266,Ibaretama - CE,4510,5858,1348,11946,37.75,49.04,11.28
sidra_9541_PercMoradDPPOColetTot_munic_22_pol.fid-703dc0a5_191866d88cb_-1648,2305308,Ibiapina - CE,15984,21334,5350,23963,66.7,89.03,22.33
sidra_9541_PercMoradDPPOColetTot_munic_22_pol.fid-703dc0a5_191866d88cb_-1647,2305332,Ibicuitinga - CE,7495,8561,1066,11579,64.73,73.94,9.21
sidra_9541_PercMoradDPPOColetTot_munic_22_pol.fid-703dc0a5_191866d88cb_-1646,2305357,Icapuí - CE,20169,20290,121,21361,94.42,94.99,0.57
sidra_9541_PercMoradDPPOColetTot_munic_22_pol.fid-703dc0a5_191866d88cb_-1645,2305407,Icó - CE,32569,39200,6631,62610,52.02,62.61,10.59
sidra_9541_PercMoradDPPOColetTot_munic_22_pol.fid-703dc0a5_191866d88cb_-1644,2305506,Iguatu - CE,84093,86075,1982,97966,85.84,87.86,2.02
sidra_9541_PercMoradDPPOColetTot_munic_22_pol.fid-703dc0a5_191866d88cb_-1643,2305605,Independência - CE,10992,11199,207,24024,45.75,46.62,0.86
sidra_9541_PercMoradDPPOColetTot_munic_22_pol.fid-703dc0a5_191866d88cb_-1642,2305654,Ipaporanga - CE,6320,8733,2413,11566,54.64,75.51,20.86
sidra_9541_PercMoradDPPOColetTot_munic_22_pol.fid-703dc0a5_191866d88cb_-1641,2305704,Ipaumirim - CE,1077,8576,7499,12057,8.93,71.13,62.2
sidra_9541_PercMoradDPPOColetTot_munic_22_pol.fid-703dc0a5_191866d88cb_-1640,2305803,Ipu - CE,32801,34118,1317,41062,79.88,83.09,3.21
sidra_9541_PercMoradDPPOColetTot_munic_22_pol.fid-703dc0a5_191866d88cb_-163f,2305902,Ipueiras - CE,21308,21754,446,36790,57.92,59.13,1.21
sidra_9541_PercMoradDPPOColetTot_munic_22_pol.fid-703dc0a5_191866d88cb_-163e,2306009,Iracema - CE,10829,11499,670,13999,77.36,82.14,4.79
sidra_9541_PercMoradDPPOColetTot_munic_22_pol.fid-703dc0a5_191866d88cb_-163d,2306108,Irauçuba - CE,17089,18348,1259,23909,71.48,76.74,5.27
sidra_9541_PercMoradDPPOColetTot_munic_22_pol.fid-703dc0a5_191866d88cb_-163c,2306207,Itaiçaba - CE,7180,7272,92,7517,95.52,96.74,1.22
sidra_9541_PercMoradDPPOColetTot_munic_22_pol.fid-703dc0a5_191866d88cb_-163b,2306256,Itaitinga - CE,47410,54929,7519,55948,84.74,98.18,13.44
sidra_9541_PercMoradDPPOColetTot_munic_22_pol.fid-703dc0a5_191866d88cb_-163a,2306306,Itapajé - CE,36996,40268,3272,46412,79.71,86.76,7.05
sidra_9541_PercMoradDPPOColetTot_munic_22_pol.fid-703dc0a5_191866d88cb_-1639,2306405,Itapipoca - CE,81489,93143,11654,131041,62.19,71.08,8.89
sidra_9541_PercMoradDPPOColetTot_munic_22_pol.fid-703dc0a5_191866d88cb_-1638,2306504,Itapiúna - CE,6321,10875,4554,17836,35.44,60.97,25.53
sidra_9541_PercMoradDPPOColetTot_munic_22_pol.fid-703dc0a5_191866d88cb_-1637,2306553,Itarema - CE,20293,26162,5869,42901,47.3,60.98,13.68
sidra_9541_PercMoradDPPOColetTot_munic_22_pol.fid-703dc0a5_191866d88cb_-1636,2306603,Itatira - CE,7476,10820,3344,20422,36.61,52.98,16.37
sidra_9541_PercMoradDPPOColetTot_munic_22_pol.fid-703dc0a5_191866d88cb_-1635,2306702,Jaguaretama - CE,8694,9096,402,17222,50.48,52.82,2.33
sidra_9541_PercMoradDPPOColetTot_munic_22_pol.fid-703dc0a5_191866d88cb_-1634,2306801,Jaguaribara - CE,7174,8692,1518,10333,69.43,84.12,14.69
sidra_9541_PercMoradDPPOColetTot_munic_22_pol.fid-703dc0a5_191866d88cb_-1633,2306900,Jaguaribe - CE,23542,24192,650,33708,69.84,71.77,1.93
sidra_9541_PercMoradDPPOColetTot_munic_22_pol.fid-703dc0a5_191866d88cb_-1632,2307007,Jaguaruana - CE,29001,29267,266,31670,91.57,92.41,0.84
sidra_9541_PercMoradDPPOColetTot_munic_22_pol.fid-703dc0a5_191866d88cb_-1631,2307106,Jardim - CE,13673,15069,1396,27407,49.89,54.98,5.09
sidra_9541_PercMoradDPPOColetTot_munic_22_pol.fid-703dc0a5_191866d88cb_-1630,2307205,Jati - CE,5224,6452,1228,7846,66.58,82.23,15.65
sidra_9541_PercMoradDPPOColetTot_munic_22_pol.fid-703dc0a5_191866d88cb_-162f,2307254,Jijoca de Jericoacoara - CE,20243,21202,959,25472,79.47,83.24,3.76
sidra_9541_PercMoradDPPOColetTot_munic_22_pol.fid-703dc0a5_191866d88cb_-162e,2307304,Juazeiro do Norte - CE,271615,276502,4887,284413,95.5,97.22,1.72
sidra_9541_PercMoradDPPOColetTot_munic_22_pol.fid-703dc0a5_191866d88cb_-162d,2307403,Jucás - CE,14380,18036,3656,23871,60.24,75.56,15.32
sidra_9541_PercMoradDPPOColetTot_munic_22_pol.fid-703dc0a5_191866d88cb_-162c,2307502,Lavras da Mangabeira - CE,13407,19618,6211,30785,43.55,63.73,20.18
sidra_9541_PercMoradDPPOColetTot_munic_22_pol.fid-703dc0a5_191866d88cb_-162b,2307601,Limoeiro do Norte - CE,55238,56156,918,59494,92.85,94.39,1.54
sidra_9541_PercMoradDPPOColetTot_munic_22_pol.fid-703dc0a5_191866d88cb_-162a,2307635,Madalena - CE,11065,11491,426,16874,65.57,68.1,2.52
sidra_9541_PercMoradDPPOColetTot_munic_22_pol.fid-703dc0a5_191866d88cb_-1629,2307650,Maracanaú - CE,229597,231317,1720,234327,97.98,98.72,0.73
sidra_9541_PercMoradDPPOColetTot_munic_22_pol.fid-703dc0a5_191866d88cb_-1628,2307700,Maranguape - CE,91058,99313,8255,104983,86.74,94.6,7.86
sidra_9541_PercMoradDPPOColetTot_munic_22_pol.fid-703dc0a5_191866d88cb_-1627,2307809,Marco - CE,19056,20815,1759,25730,74.06,80.9,6.84
sidra_9541_PercMoradDPPOColetTot_munic_22_pol.fid-703dc0a5_191866d88cb_-1626,2307908,Martinópole - CE,142,7333,7191,10844,1.31,67.62,66.31
sidra_9541_PercMoradDPPOColetTot_munic_22_pol.fid-703dc0a5_191866d88cb_-1625,2308005,Massapê - CE,25846,30701,4855,37679,68.6,81.48,12.89
sidra_9541_PercMoradDPPOColetTot_munic_22_pol.fid-703dc0a5_191866d88cb_-1624,2308104,Mauriti - CE,28489,30677,2188,45515,62.59,67.4,4.81
sidra_9541_PercMoradDPPOColetTot_munic_22_pol.fid-703dc0a5_191866d88cb_-161a,2308203,Meruoca - CE,7043,12587,5544,15142,46.51,83.13,36.61
sidra_9541_PercMoradDPPOColetTot_munic_22_pol.fid-703dc0a5_191866d88cb_-1619,2309300,Nova Russas - CE,25600,26095,495,30617,83.61,85.23,1.62
sidra_9541_PercMoradDPPOColetTot_munic_22_pol.fid-703dc0a5_191866d88cb_-1618,2309409,Novo Oriente - CE,19370,19958,588,27530,70.36,72.5,2.14
sidra_9541_PercMoradDPPOColetTot_munic_22_pol.fid-703dc0a5_191866d88cb_-1617,2309458,Ocara - CE,16288,19771,3483,24476,66.55,80.78,14.23
sidra_9541_PercMoradDPPOColetTot_munic_22_pol.fid-703dc0a5_191866d88cb_-1616,2309508,Orós - CE,15606,16628,1022,19661,79.38,84.57,5.2
sidra_9541_PercMoradDPPOColetTot_munic_22_pol.fid-703dc0a5_191866d88cb_-1615,2404903,Itaú - RN,5003,5003,,5319,94.06,94.06,
sidra_9541_PercMoradDPPOColetTot_munic_22_pol.fid-703dc0a5_191866d88cb_-1614,4217253,São Pedro de Alcântara - SC,3587,4426,839,4599,78,96.24,18.24
sidra_9541_PercMoradDPPOColetTot_munic_22_pol.fid-703dc0a5_191866d88cb_-1613,4217303,Saudades - SC,8217,9667,1450,10256,80.12,94.26,14.14
sidra_9541_PercMoradDPPOColetTot_munic_22_pol.fid-703dc0a5_191866d88cb_-1612,4217402,Schroeder - SC,19882,20006,124,20053,99.15,99.77,0.62
sidra_9541_PercMoradDPPOColetTot_munic_22_pol.fid-703dc0a5_191866d88cb_-1611,2308302,Milagres - CE,13837,15498,1661,25874,53.48,59.9,6.42
sidra_9541_PercMoradDPPOColetTot_munic_22_pol.fid-703dc0a5_191866d88cb_-1610,2308351,Milhã - CE,6859,8262,1403,14094,48.67,58.62,9.95
sidra_9541_PercMoradDPPOColetTot_munic_22_pol.fid-703dc0a5_191866d88cb_-160f,2308377,Miraíma - CE,8163,10044,1881,14190,57.53,70.78,13.26
sidra_9541_PercMoradDPPOColetTot_munic_22_pol.fid-703dc0a5_191866d88cb_-160e,2308401,Missão Velha - CE,19835,22743,2908,36800,53.9,61.8,7.9
sidra_9541_PercMoradDPPOColetTot_munic_22_pol.fid-703dc0a5_191866d88cb_-160d,2308500,Mombaça - CE,20119,22199,2080,37704,53.36,58.88,5.52
sidra_9541_PercMoradDPPOColetTot_munic_22_pol.fid-703dc0a5_191866d88cb_-160c,2308609,Monsenhor Tabosa - CE,10160,10712,552,17148,59.25,62.47,3.22
sidra_9541_PercMoradDPPOColetTot_munic_22_pol.fid-703dc0a5_191866d88cb_-160b,2308708,Morada Nova - CE,44410,45848,1438,61383,72.35,74.69,2.34
sidra_9541_PercMoradDPPOColetTot_munic_22_pol.fid-703dc0a5_191866d88cb_-160a,2308807,Moraújo - CE,2641,5520,2879,8254,32,66.88,34.88
sidra_9541_PercMoradDPPOColetTot_munic_22_pol.fid-703dc0a5_191866d88cb_-1609,2308906,Morrinhos - CE,15336,15734,398,22732,67.46,69.22,1.75
sidra_9541_PercMoradDPPOColetTot_munic_22_pol.fid-703dc0a5_191866d88cb_-1608,2309003,Mucambo - CE,10625,11352,727,13663,77.76,83.09,5.32
sidra_9541_PercMoradDPPOColetTot_munic_22_pol.fid-703dc0a5_191866d88cb_-1607,2310258,Paraipaba - CE,21945,25596,3651,32149,68.26,79.62,11.36
sidra_9541_PercMoradDPPOColetTot_munic_22_pol.fid-703dc0a5_191866d88cb_-1606,2310308,Parambu - CE,13369,16812,3443,31394,42.58,53.55,10.97
sidra_9541_PercMoradDPPOColetTot_munic_22_pol.fid-703dc0a5_191866d88cb_-1605,2310407,Paramoti - CE,5318,6278,960,10365,51.31,60.57,9.26
sidra_9541_PercMoradDPPOColetTot_munic_22_pol.fid-703dc0a5_191866d88cb_-1604,2310506,Pedra Branca - CE,21295,25840,4545,40164,53.02,64.34,11.32
sidra_9541_PercMoradDPPOColetTot_munic_22_pol.fid-703dc0a5_191866d88cb_-1603,4217501,Seara - SC,14502,17736,3234,18611,77.92,95.3,17.38
sidra_9541_PercMoradDPPOColetTot_munic_22_pol.fid-703dc0a5_191866d88cb_-1602,4217550,Serra Alta - SC,1749,2593,844,3303,52.95,78.5,25.55
sidra_9541_PercMoradDPPOColetTot_munic_22_pol.fid-703dc0a5_191866d88cb_-1601,4217600,Siderópolis - SC,12955,13568,613,13683,94.68,99.16,4.48
sidra_9541_PercMoradDPPOColetTot_munic_22_pol.fid-703dc0a5_191866d88cb_-1600,4217709,Sombrio - SC,25416,29577,4161,29956,84.84,98.73,13.89
sidra_9541_PercMoradDPPOColetTot_munic_22_pol.fid-703dc0a5_191866d88cb_-15ff,2309102,Mulungu - CE,6525,9248,2723,10568,61.74,87.51,25.77
sidra_9541_PercMoradDPPOColetTot_munic_22_pol.fid-703dc0a5_191866d88cb_-15fe,2309201,Nova Olinda - CE,13235,13350,115,15390,86,86.74,0.75
sidra_9541_PercMoradDPPOColetTot_munic_22_pol.fid-703dc0a5_191866d88cb_-15fd,2309607,Pacajus - CE,63174,66459,3285,70965,89.02,93.65,4.63
sidra_9541_PercMoradDPPOColetTot_munic_22_pol.fid-703dc0a5_191866d88cb_-15fc,2309706,Pacatuba - CE,68457,77558,9101,80770,84.76,96.02,11.27
sidra_9541_PercMoradDPPOColetTot_munic_22_pol.fid-703dc0a5_191866d88cb_-15fb,2309805,Pacoti - CE,7976,10245,2269,11155,71.5,91.84,20.34
sidra_9541_PercMoradDPPOColetTot_munic_22_pol.fid-703dc0a5_191866d88cb_-15fa,2313104,Tabuleiro do Norte - CE,21529,24059,2530,30629,70.29,78.55,8.26
sidra_9541_PercMoradDPPOColetTot_munic_22_pol.fid-703dc0a5_191866d88cb_-15f9,2313203,Tamboril - CE,8748,15345,6597,24798,35.28,61.88,26.6
sidra_9541_PercMoradDPPOColetTot_munic_22_pol.fid-703dc0a5_191866d88cb_-15f8,2313252,Tarrafas - CE,5465,5472,7,7514,72.73,72.82,0.09
sidra_9541_PercMoradDPPOColetTot_munic_22_pol.fid-703dc0a5_191866d88cb_-15f7,2313302,Tauá - CE,42855,44697,1842,61174,70.05,73.07,3.01
sidra_9541_PercMoradDPPOColetTot_munic_22_pol.fid-703dc0a5_191866d88cb_-15f6,2313351,Tejuçuoca - CE,9892,11521,1629,17104,57.83,67.36,9.52
sidra_9541_PercMoradDPPOColetTot_munic_22_pol.fid-703dc0a5_191866d88cb_-15f5,2313401,Tianguá - CE,62388,70169,7781,81434,76.61,86.17,9.55
sidra_9541_PercMoradDPPOColetTot_munic_22_pol.fid-703dc0a5_191866d88cb_-15f4,2313500,Trairi - CE,39002,42049,3047,58373,66.82,72.04,5.22
sidra_9541_PercMoradDPPOColetTot_munic_22_pol.fid-703dc0a5_191866d88cb_-15f3,2313559,Tururu - CE,5186,10881,5695,15411,33.65,70.61,36.95
sidra_9541_PercMoradDPPOColetTot_munic_22_pol.fid-703dc0a5_191866d88cb_-15f2,2313609,Ubajara - CE,17126,28746,11620,32745,52.3,87.79,35.49
sidra_9541_PercMoradDPPOColetTot_munic_22_pol.fid-703dc0a5_191866d88cb_-15f1,2403400,Equador - RN,4181,4554,373,5360,78,84.96,6.96
sidra_9541_PercMoradDPPOColetTot_munic_22_pol.fid-703dc0a5_191866d88cb_-15f0,2309904,Pacujá - CE,5157,5179,22,6169,83.6,83.95,0.36
sidra_9541_PercMoradDPPOColetTot_munic_22_pol.fid-703dc0a5_191866d88cb_-15ef,2310001,Palhano - CE,5880,5930,50,9343,62.93,63.47,0.54
sidra_9541_PercMoradDPPOColetTot_munic_22_pol.fid-703dc0a5_191866d88cb_-15ee,2310100,Palmácia - CE,6067,7275,1208,10234,59.28,71.09,11.8
sidra_9541_PercMoradDPPOColetTot_munic_22_pol.fid-703dc0a5_191866d88cb_-15ed,2310209,Paracuru - CE,33679,35273,1594,38949,86.47,90.56,4.09
sidra_9541_PercMoradDPPOColetTot_munic_22_pol.fid-703dc0a5_191866d88cb_-15ec,2310605,Penaforte - CE,6320,7687,1367,8955,70.58,85.84,15.27
sidra_9541_PercMoradDPPOColetTot_munic_22_pol.fid-703dc0a5_191866d88cb_-15eb,2310704,Pentecoste - CE,19841,25974,6133,37763,52.54,68.78,16.24
sidra_9541_PercMoradDPPOColetTot_munic_22_pol.fid-703dc0a5_191866d88cb_-15ea,2310803,Pereiro - CE,7957,8452,495,15273,52.1,55.34,3.24
sidra_9541_PercMoradDPPOColetTot_munic_22_pol.fid-703dc0a5_191866d88cb_-15e9,2310852,Pindoretama - CE,19513,21299,1786,23371,83.49,91.13,7.64
sidra_9541_PercMoradDPPOColetTot_munic_22_pol.fid-703dc0a5_191866d88cb_-15e8,2310902,Piquet Carneiro - CE,10351,10532,181,16609,62.32,63.41,1.09
sidra_9541_PercMoradDPPOColetTot_munic_22_pol.fid-703dc0a5_191866d88cb_-15e7,2310951,Pires Ferreira - CE,2808,8149,5341,10591,26.51,76.94,50.43
sidra_9541_PercMoradDPPOColetTot_munic_22_pol.fid-703dc0a5_191866d88cb_-15e6,2311009,Poranga - CE,7613,7855,242,12065,63.1,65.11,2.01
sidra_9541_PercMoradDPPOColetTot_munic_22_pol.fid-703dc0a5_191866d88cb_-15e5,2311108,Porteiras - CE,8888,9472,584,17049,52.13,55.56,3.43
sidra_9541_PercMoradDPPOColetTot_munic_22_pol.fid-703dc0a5_191866d88cb_-15e4,4217758,Sul Brasil - SC,1874,2264,390,2832,66.17,79.94,13.77
sidra_9541_PercMoradDPPOColetTot_munic_22_pol.fid-703dc0a5_191866d88cb_-15e3,4217808,Taió - SC,12685,16078,3393,18282,69.39,87.94,18.56
sidra_9541_PercMoradDPPOColetTot_munic_22_pol.fid-703dc0a5_191866d88cb_-15e2,4217907,Tangará - SC,5687,6027,340,8138,69.88,74.06,4.18
sidra_9541_PercMoradDPPOColetTot_munic_22_pol.fid-703dc0a5_191866d88cb_-15e1,4217956,Tigrinhos - SC,1122,1127,5,2328,48.2,48.41,0.21
sidra_9541_PercMoradDPPOColetTot_munic_22_pol.fid-703dc0a5_191866d88cb_-15e0,4218004,Tijucas - SC,49514,51065,1551,51215,96.68,99.71,3.03
sidra_9541_PercMoradDPPOColetTot_munic_22_pol.fid-703dc0a5_191866d88cb_-15df,2311207,Potengi - CE,4168,6072,1904,8832,47.19,68.75,21.56
sidra_9541_PercMoradDPPOColetTot_munic_22_pol.fid-703dc0a5_191866d88cb_-15de,2311231,Potiretama - CE,3557,4766,1209,5965,59.63,79.9,20.27
sidra_9541_PercMoradDPPOColetTot_munic_22_pol.fid-703dc0a5_191866d88cb_-15dd,2311264,Quiterianópolis - CE,9887,10344,457,20209,48.92,51.19,2.26
sidra_9541_PercMoradDPPOColetTot_munic_22_pol.fid-703dc0a5_191866d88cb_-15dc,2311306,Quixadá - CE,63603,66114,2511,84026,75.69,78.68,2.99
sidra_9541_PercMoradDPPOColetTot_munic_22_pol.fid-703dc0a5_191866d88cb_-15db,2313807,Uruburetama - CE,12062,17662,5600,20187,59.75,87.49,27.74
sidra_9541_PercMoradDPPOColetTot_munic_22_pol.fid-703dc0a5_191866d88cb_-15da,2313906,Uruoca - CE,3124,8890,5766,13741,22.73,64.7,41.96
sidra_9541_PercMoradDPPOColetTot_munic_22_pol.fid-703dc0a5_191866d88cb_-15d9,4218103,Timbé do Sul - SC,4591,5101,510,5379,85.35,94.83,9.48
sidra_9541_PercMoradDPPOColetTot_munic_22_pol.fid-703dc0a5_191866d88cb_-15d8,4218202,Timbó - SC,45419,45941,522,46043,98.64,99.78,1.13
sidra_9541_PercMoradDPPOColetTot_munic_22_pol.fid-703dc0a5_191866d88cb_-15d7,4218251,Timbó Grande - SC,5163,5967,804,7334,70.4,81.36,10.96
sidra_9541_PercMoradDPPOColetTot_munic_22_pol.fid-703dc0a5_191866d88cb_-15d6,4218301,Três Barras - SC,18962,19479,517,19718,96.17,98.79,2.62
sidra_9541_PercMoradDPPOColetTot_munic_22_pol.fid-703dc0a5_191866d88cb_-15d5,4218350,Treviso - SC,3760,3761,1,3779,99.5,99.52,0.03
sidra_9541_PercMoradDPPOColetTot_munic_22_pol.fid-703dc0a5_191866d88cb_-15d4,4218400,Treze de Maio - SC,6847,7003,156,7356,93.08,95.2,2.12
sidra_9541_PercMoradDPPOColetTot_munic_22_pol.fid-703dc0a5_191866d88cb_-15d3,4218509,Treze Tílias - SC,6751,8366,1615,8787,76.83,95.21,18.38
sidra_9541_PercMoradDPPOColetTot_munic_22_pol.fid-703dc0a5_191866d88cb_-15d2,4218608,Trombudo Central - SC,6402,7133,731,7222,88.65,98.77,10.12
sidra_9541_PercMoradDPPOColetTot_munic_22_pol.fid-703dc0a5_191866d88cb_-15d1,4218707,Tubarão - SC,106358,108964,2606,109337,97.28,99.66,2.38
sidra_9541_PercMoradDPPOColetTot_munic_22_pol.fid-703dc0a5_191866d88cb_-15d0,4218756,Tunápolis - SC,3684,4113,429,4904,75.12,83.87,8.75
sidra_9541_PercMoradDPPOColetTot_munic_22_pol.fid-703dc0a5_191866d88cb_-15cf,2311355,Quixelô - CE,7395,7464,69,15904,46.5,46.93,0.43
sidra_9541_PercMoradDPPOColetTot_munic_22_pol.fid-703dc0a5_191866d88cb_-15ce,2311405,Quixeramobim - CE,48397,55119,6722,82027,59,67.2,8.19
sidra_9541_PercMoradDPPOColetTot_munic_22_pol.fid-703dc0a5_191866d88cb_-15cd,2311504,Quixeré - CE,17217,19439,2222,20860,82.54,93.19,10.65
sidra_9541_PercMoradDPPOColetTot_munic_22_pol.fid-703dc0a5_191866d88cb_-15cc,2311603,Redenção - CE,18799,23097,4298,27191,69.14,84.94,15.81
sidra_9541_PercMoradDPPOColetTot_munic_22_pol.fid-703dc0a5_191866d88cb_-15cb,2400307,Afonso Bezerra - RN,9123,9187,64,10822,84.3,84.89,0.59
sidra_9541_PercMoradDPPOColetTot_munic_22_pol.fid-703dc0a5_191866d88cb_-15ca,2400406,Água Nova - RN,2591,2602,11,2946,87.95,88.32,0.37
sidra_9541_PercMoradDPPOColetTot_munic_22_pol.fid-703dc0a5_191866d88cb_-15c9,4218806,Turvo - SC,10577,12401,1824,13004,81.34,95.36,14.03
sidra_9541_PercMoradDPPOColetTot_munic_22_pol.fid-703dc0a5_191866d88cb_-15c8,4218855,União do Oeste - SC,687,1462,775,2774,24.77,52.7,27.94
sidra_9541_PercMoradDPPOColetTot_munic_22_pol.fid-703dc0a5_191866d88cb_-15c7,4218905,Urubici - SC,9624,10338,714,10813,89,95.61,6.6
sidra_9541_PercMoradDPPOColetTot_munic_22_pol.fid-703dc0a5_191866d88cb_-15c6,2311702,Reriutaba - CE,7345,13496,6151,18602,39.49,72.55,33.07
sidra_9541_PercMoradDPPOColetTot_munic_22_pol.fid-703dc0a5_191866d88cb_-15c5,2311801,Russas - CE,61916,66599,4683,72844,85,91.43,6.43
sidra_9541_PercMoradDPPOColetTot_munic_22_pol.fid-703dc0a5_191866d88cb_-15c4,2311900,Saboeiro - CE,5182,8123,2941,13830,37.47,58.73,21.27
sidra_9541_PercMoradDPPOColetTot_munic_22_pol.fid-703dc0a5_191866d88cb_-15c3,2311959,Salitre - CE,3516,7081,3565,16609,21.17,42.63,21.46
sidra_9541_PercMoradDPPOColetTot_munic_22_pol.fid-703dc0a5_191866d88cb_-15c2,2312007,Santana do Acaraú - CE,11314,15336,4022,30599,36.98,50.12,13.14
sidra_9541_PercMoradDPPOColetTot_munic_22_pol.fid-703dc0a5_191866d88cb_-15c1,4218954,Urupema - SC,1825,2572,747,2647,68.95,97.17,28.22
sidra_9541_PercMoradDPPOColetTot_munic_22_pol.fid-703dc0a5_191866d88cb_-15c0,4219002,Urussanga - SC,18808,20142,1334,20888,90.04,96.43,6.39
sidra_9541_PercMoradDPPOColetTot_munic_22_pol.fid-703dc0a5_191866d88cb_-15bf,4219101,Vargeão - SC,3044,3293,249,3633,83.79,90.64,6.85
sidra_9541_PercMoradDPPOColetTot_munic_22_pol.fid-703dc0a5_191866d88cb_-15be,4219150,Vargem - SC,1402,1513,111,2627,53.37,57.59,4.23
sidra_9541_PercMoradDPPOColetTot_munic_22_pol.fid-703dc0a5_191866d88cb_-15bd,4219176,Vargem Bonita - SC,3491,4142,651,4570,76.39,90.63,14.25
sidra_9541_PercMoradDPPOColetTot_munic_22_pol.fid-703dc0a5_191866d88cb_-15bc,4219200,Vidal Ramos - SC,4433,5399,966,6142,72.18,87.9,15.73
sidra_9541_PercMoradDPPOColetTot_munic_22_pol.fid-703dc0a5_191866d88cb_-15bb,4219309,Videira - SC,51450,53616,2166,55305,93.03,96.95,3.92
sidra_9541_PercMoradDPPOColetTot_munic_22_pol.fid-703dc0a5_191866d88cb_-15ba,4219358,Vitor Meireles - SC,3679,3827,148,5368,68.54,71.29,2.76
sidra_9541_PercMoradDPPOColetTot_munic_22_pol.fid-703dc0a5_191866d88cb_-15b9,4219408,Witmarsum - SC,3824,4034,210,4242,90.15,95.1,4.95
sidra_9541_PercMoradDPPOColetTot_munic_22_pol.fid-703dc0a5_191866d88cb_-15b8,4219507,Xanxerê - SC,42121,48401,6280,51380,81.98,94.2,12.22
sidra_9541_PercMoradDPPOColetTot_munic_22_pol.fid-703dc0a5_191866d88cb_-15b7,4219606,Xavantina - SC,2007,2931,924,3651,54.97,80.28,25.31
sidra_9541_PercMoradDPPOColetTot_munic_22_pol.fid-703dc0a5_191866d88cb_-15b6,4219705,Xaxim - SC,27725,28789,1064,31907,86.89,90.23,3.33
sidra_9541_PercMoradDPPOColetTot_munic_22_pol.fid-703dc0a5_191866d88cb_-15b5,4219853,Zortéa - SC,3577,3834,257,3929,91.04,97.58,6.54
sidra_9541_PercMoradDPPOColetTot_munic_22_pol.fid-703dc0a5_191866d88cb_-15b4,4220000,Balneário Rincão - SC,15862,15931,69,15973,99.31,99.74,0.43
sidra_9541_PercMoradDPPOColetTot_munic_22_pol.fid-703dc0a5_191866d88cb_-15b3,2312106,Santana do Cariri - CE,10435,10993,558,16938,61.61,64.9,3.29
sidra_9541_PercMoradDPPOColetTot_munic_22_pol.fid-703dc0a5_191866d88cb_-15b2,2312205,Santa Quitéria - CE,22152,27081,4929,40160,55.16,67.43,12.27
sidra_9541_PercMoradDPPOColetTot_munic_22_pol.fid-703dc0a5_191866d88cb_-15b1,2312304,São Benedito - CE,27241,42378,15137,47604,57.22,89.02,31.8
sidra_9541_PercMoradDPPOColetTot_munic_22_pol.fid-703dc0a5_191866d88cb_-15b0,2312403,São Gonçalo do Amarante - CE,46930,49261,2331,54096,86.75,91.06,4.31
sidra_9541_PercMoradDPPOColetTot_munic_22_pol.fid-703dc0a5_191866d88cb_-15af,2403509,Espírito Santo - RN,9007,9777,770,10615,84.85,92.11,7.25
sidra_9541_PercMoradDPPOColetTot_munic_22_pol.fid-703dc0a5_191866d88cb_-15ae,4300034,Aceguá - RS,1624,3436,1812,4169,38.95,82.42,43.46
sidra_9541_PercMoradDPPOColetTot_munic_22_pol.fid-703dc0a5_191866d88cb_-15ad,2312502,São João do Jaguaribe - CE,3442,3630,188,5855,58.79,62,3.21
sidra_9541_PercMoradDPPOColetTot_munic_22_pol.fid-703dc0a5_191866d88cb_-15ac,2312601,São Luís do Curu - CE,6208,8592,2384,10788,57.55,79.64,22.1
sidra_9541_PercMoradDPPOColetTot_munic_22_pol.fid-703dc0a5_191866d88cb_-15ab,2312700,Senador Pompeu - CE,13242,16716,3474,24241,54.63,68.96,14.33
sidra_9541_PercMoradDPPOColetTot_munic_22_pol.fid-703dc0a5_191866d88cb_-15aa,2312809,Senador Sá - CE,5194,5585,391,7253,71.61,77,5.39
sidra_9541_PercMoradDPPOColetTot_munic_22_pol.fid-703dc0a5_191866d88cb_-15a9,2312908,Sobral - CE,182385,190616,8231,201456,90.53,94.62,4.09
sidra_9541_PercMoradDPPOColetTot_munic_22_pol.fid-703dc0a5_191866d88cb_-15a8,2313005,Solonópole - CE,7133,10132,2999,18172,39.25,55.76,16.5
sidra_9541_PercMoradDPPOColetTot_munic_22_pol.fid-703dc0a5_191866d88cb_-15a7,2313708,Umari - CE,4090,5038,948,6862,59.6,73.42,13.82
sidra_9541_PercMoradDPPOColetTot_munic_22_pol.fid-703dc0a5_191866d88cb_-15a6,2313757,Umirim - CE,10622,11833,1211,17446,60.89,67.83,6.94
sidra_9541_PercMoradDPPOColetTot_munic_22_pol.fid-703dc0a5_191866d88cb_-15a5,4300059,Água Santa - RS,1256,3597,2341,3912,32.11,91.95,59.84
sidra_9541_PercMoradDPPOColetTot_munic_22_pol.fid-703dc0a5_191866d88cb_-15a4,4300109,Agudo - RS,11413,13699,2286,15974,71.45,85.76,14.31
sidra_9541_PercMoradDPPOColetTot_munic_22_pol.fid-703dc0a5_191866d88cb_-15a3,4300208,Ajuricaba - RS,4381,5637,1256,6666,65.72,84.56,18.84
sidra_9541_PercMoradDPPOColetTot_munic_22_pol.fid-703dc0a5_191866d88cb_-15a2,4300307,Alecrim - RS,3802,5481,1679,6120,62.12,89.56,27.43
sidra_9541_PercMoradDPPOColetTot_munic_22_pol.fid-703dc0a5_191866d88cb_-15a1,4300406,Alegrete - RS,63563,66327,2764,71928,88.37,92.21,3.84
sidra_9541_PercMoradDPPOColetTot_munic_22_pol.fid-703dc0a5_191866d88cb_-15a0,4300455,Alegria - RS,2356,2480,124,3651,64.53,67.93,3.4
sidra_9541_PercMoradDPPOColetTot_munic_22_pol.fid-703dc0a5_191866d88cb_-159f,4300471,Almirante Tamandaré do Sul - RS,1466,1679,213,1968,74.49,85.32,10.82
sidra_9541_PercMoradDPPOColetTot_munic_22_pol.fid-703dc0a5_191866d88cb_-159e,4300505,Alpestre - RS,2636,3045,409,7108,37.08,42.84,5.75
sidra_9541_PercMoradDPPOColetTot_munic_22_pol.fid-703dc0a5_191866d88cb_-159d,4300554,Alto Alegre - RS,1022,1518,496,1800,56.78,84.33,27.56
sidra_9541_PercMoradDPPOColetTot_munic_22_pol.fid-703dc0a5_191866d88cb_-159c,5004403,Inocência - MS,5694,6119,425,8334,68.32,73.42,5.1
sidra_9541_PercMoradDPPOColetTot_munic_22_pol.fid-703dc0a5_191866d88cb_-159b,2313955,Varjota - CE,16091,16989,898,18089,88.95,93.92,4.96
sidra_9541_PercMoradDPPOColetTot_munic_22_pol.fid-703dc0a5_191866d88cb_-159a,2314003,Várzea Alegre - CE,27558,28251,693,38961,70.73,72.51,1.78
sidra_9541_PercMoradDPPOColetTot_munic_22_pol.fid-703dc0a5_191866d88cb_-1599,5004502,Itaporã - MS,15785,15952,167,24123,65.44,66.13,0.69
sidra_9541_PercMoradDPPOColetTot_munic_22_pol.fid-703dc0a5_191866d88cb_-1598,5004601,Itaquiraí - MS,10428,10456,28,19259,54.15,54.29,0.15
sidra_9541_PercMoradDPPOColetTot_munic_22_pol.fid-703dc0a5_191866d88cb_-1597,5004700,Ivinhema - MS,23874,24057,183,27714,86.14,86.8,0.66
sidra_9541_PercMoradDPPOColetTot_munic_22_pol.fid-703dc0a5_191866d88cb_-1596,5004809,Japorã - MS,1980,1987,7,8139,24.33,24.41,0.09
sidra_9541_PercMoradDPPOColetTot_munic_22_pol.fid-703dc0a5_191866d88cb_-1595,5004908,Jaraguari - MS,2965,3353,388,7114,41.68,47.13,5.45
sidra_9541_PercMoradDPPOColetTot_munic_22_pol.fid-703dc0a5_191866d88cb_-1594,5005004,Jardim - MS,22302,22383,81,23788,93.75,94.09,0.34
sidra_9541_PercMoradDPPOColetTot_munic_22_pol.fid-703dc0a5_191866d88cb_-1593,2314102,Viçosa do Ceará - CE,16474,27700,11226,59700,27.59,46.4,18.8
sidra_9541_PercMoradDPPOColetTot_munic_22_pol.fid-703dc0a5_191866d88cb_-1592,2400109,Acari - RN,7832,9684,1852,10556,74.19,91.74,17.54
sidra_9541_PercMoradDPPOColetTot_munic_22_pol.fid-703dc0a5_191866d88cb_-1591,2400208,Açu - RN,50475,50637,162,56426,89.45,89.74,0.29
sidra_9541_PercMoradDPPOColetTot_munic_22_pol.fid-703dc0a5_191866d88cb_-1590,5005103,Jateí - MS,2611,2639,28,3582,72.89,73.67,0.78
sidra_9541_PercMoradDPPOColetTot_munic_22_pol.fid-703dc0a5_191866d88cb_-158f,5005152,Juti - MS,4883,4892,9,6713,72.74,72.87,0.13
sidra_9541_PercMoradDPPOColetTot_munic_22_pol.fid-703dc0a5_191866d88cb_-158e,2400505,Alexandria - RN,9901,10376,475,13611,72.74,76.23,3.49
sidra_9541_PercMoradDPPOColetTot_munic_22_pol.fid-703dc0a5_191866d88cb_-158d,2400604,Almino Afonso - RN,1028,3569,2541,4687,21.93,76.15,54.21
sidra_9541_PercMoradDPPOColetTot_munic_22_pol.fid-703dc0a5_191866d88cb_-158c,2400703,Alto do Rodrigues - RN,12030,12191,161,12450,96.63,97.92,1.29
sidra_9541_PercMoradDPPOColetTot_munic_22_pol.fid-703dc0a5_191866d88cb_-158b,2400802,Angicos - RN,9093,10461,1368,11626,78.21,89.98,11.77
sidra_9541_PercMoradDPPOColetTot_munic_22_pol.fid-703dc0a5_191866d88cb_-158a,2401305,Campo Grande - RN,5607,6026,419,9730,57.63,61.93,4.31
sidra_9541_PercMoradDPPOColetTot_munic_22_pol.fid-703dc0a5_191866d88cb_-1589,2400901,Antônio Martins - RN,3095,4397,1302,6577,47.06,66.85,19.8
sidra_9541_PercMoradDPPOColetTot_munic_22_pol.fid-703dc0a5_191866d88cb_-1588,2401453,Baraúna - RN,21106,21202,96,26860,78.58,78.94,0.36
sidra_9541_PercMoradDPPOColetTot_munic_22_pol.fid-703dc0a5_191866d88cb_-1587,2406304,Lagoa de Pedras - RN,5031,5031,,7338,68.56,68.56,
sidra_9541_PercMoradDPPOColetTot_munic_22_pol.fid-703dc0a5_191866d88cb_-1586,2401008,Apodi - RN,22586,25816,3230,36035,62.68,71.64,8.96
sidra_9541_PercMoradDPPOColetTot_munic_22_pol.fid-703dc0a5_191866d88cb_-1585,2401107,Areia Branca - RN,23196,23271,75,24063,96.4,96.71,0.31
sidra_9541_PercMoradDPPOColetTot_munic_22_pol.fid-703dc0a5_191866d88cb_-1584,2401206,Arês - RN,11978,12093,115,13220,90.61,91.48,0.87
sidra_9541_PercMoradDPPOColetTot_munic_22_pol.fid-703dc0a5_191866d88cb_-1583,2401701,Bom Jesus - RN,8494,8541,47,9921,85.62,86.09,0.47
sidra_9541_PercMoradDPPOColetTot_munic_22_pol.fid-703dc0a5_191866d88cb_-1582,2401800,Brejinho - RN,10812,10906,94,12171,88.83,89.61,0.77
sidra_9541_PercMoradDPPOColetTot_munic_22_pol.fid-703dc0a5_191866d88cb_-1581,2406403,Lagoa de Velhos - RN,2144,2362,218,2548,84.14,92.7,8.56
sidra_9541_PercMoradDPPOColetTot_munic_22_pol.fid-703dc0a5_191866d88cb_-1580,2401404,Baía Formosa - RN,8157,8289,132,8819,92.49,93.99,1.5
sidra_9541_PercMoradDPPOColetTot_munic_22_pol.fid-703dc0a5_191866d88cb_-157f,2401503,Barcelona - RN,3151,3335,184,3983,79.11,83.73,4.62
sidra_9541_PercMoradDPPOColetTot_munic_22_pol.fid-703dc0a5_191866d88cb_-157e,2401602,Bento Fernandes - RN,3668,3672,4,4756,77.12,77.21,0.08
sidra_9541_PercMoradDPPOColetTot_munic_22_pol.fid-703dc0a5_191866d88cb_-157d,2401651,Bodó - RN,1414,1452,38,2306,61.32,62.97,1.65
sidra_9541_PercMoradDPPOColetTot_munic_22_pol.fid-703dc0a5_191866d88cb_-157c,2401859,Caiçara do Norte - RN,5760,5963,203,6291,91.56,94.79,3.23
sidra_9541_PercMoradDPPOColetTot_munic_22_pol.fid-703dc0a5_191866d88cb_-157b,2401909,Caiçara do Rio do Vento - RN,2638,2852,214,3268,80.72,87.27,6.55
sidra_9541_PercMoradDPPOColetTot_munic_22_pol.fid-703dc0a5_191866d88cb_-157a,2402402,Carnaúba dos Dantas - RN,7189,7562,373,7970,90.2,94.88,4.68
sidra_9541_PercMoradDPPOColetTot_munic_22_pol.fid-703dc0a5_191866d88cb_-1579,2402006,Caicó - RN,56208,56945,737,60614,92.73,93.95,1.22
sidra_9541_PercMoradDPPOColetTot_munic_22_pol.fid-703dc0a5_191866d88cb_-1578,2402105,Campo Redondo - RN,7822,7974,152,10207,76.63,78.12,1.49
sidra_9541_PercMoradDPPOColetTot_munic_22_pol.fid-703dc0a5_191866d88cb_-1577,2403756,Fernando Pedroza - RN,2487,2674,187,2937,84.68,91.05,6.37
sidra_9541_PercMoradDPPOColetTot_munic_22_pol.fid-703dc0a5_191866d88cb_-1576,2402204,Canguaretama - RN,26579,27941,1362,29626,89.72,94.31,4.6
sidra_9541_PercMoradDPPOColetTot_munic_22_pol.fid-703dc0a5_191866d88cb_-1575,2402303,Caraúbas - RN,14311,15820,1509,19631,72.9,80.59,7.69
sidra_9541_PercMoradDPPOColetTot_munic_22_pol.fid-703dc0a5_191866d88cb_-1574,2402501,Carnaubais - RN,8709,8744,35,9671,90.05,90.41,0.36
sidra_9541_PercMoradDPPOColetTot_munic_22_pol.fid-703dc0a5_191866d88cb_-1573,2402600,Ceará-Mirim - RN,61192,62554,1362,77849,78.6,80.35,1.75
sidra_9541_PercMoradDPPOColetTot_munic_22_pol.fid-703dc0a5_191866d88cb_-1572,2402709,Cerro Corá - RN,7014,7297,283,10983,63.86,66.44,2.58
sidra_9541_PercMoradDPPOColetTot_munic_22_pol.fid-703dc0a5_191866d88cb_-1571,2402808,Coronel Ezequiel - RN,3678,3733,55,5117,71.88,72.95,1.07
sidra_9541_PercMoradDPPOColetTot_munic_22_pol.fid-703dc0a5_191866d88cb_-1570,2402907,Coronel João Pessoa - RN,2178,3127,949,4232,51.47,73.89,22.42
sidra_9541_PercMoradDPPOColetTot_munic_22_pol.fid-703dc0a5_191866d88cb_-156f,2405009,Jaçanã - RN,6395,6425,30,7832,81.65,82.04,0.38
sidra_9541_PercMoradDPPOColetTot_munic_22_pol.fid-703dc0a5_191866d88cb_-156e,2403004,Cruzeta - RN,6299,6884,585,7955,79.18,86.54,7.35
sidra_9541_PercMoradDPPOColetTot_munic_22_pol.fid-703dc0a5_191866d88cb_-156d,2403202,Doutor Severiano - RN,3439,3491,52,7034,48.89,49.63,0.74
sidra_9541_PercMoradDPPOColetTot_munic_22_pol.fid-703dc0a5_191866d88cb_-156c,2405108,Jandaíra - RN,6242,6309,67,6562,95.12,96.14,1.02
sidra_9541_PercMoradDPPOColetTot_munic_22_pol.fid-703dc0a5_191866d88cb_-156b,2403103,Currais Novos - RN,38108,38204,96,41232,92.42,92.66,0.23
sidra_9541_PercMoradDPPOColetTot_munic_22_pol.fid-703dc0a5_191866d88cb_-156a,2403301,Encanto - RN,3423,4180,757,6003,57.02,69.63,12.61
sidra_9541_PercMoradDPPOColetTot_munic_22_pol.fid-703dc0a5_191866d88cb_-1569,2403251,Parnamirim - RN,235754,251433,15679,252375,93.41,99.63,6.21
sidra_9541_PercMoradDPPOColetTot_munic_22_pol.fid-703dc0a5_191866d88cb_-1568,2403608,Extremoz - RN,56195,58522,2327,61565,91.28,95.06,3.78
sidra_9541_PercMoradDPPOColetTot_munic_22_pol.fid-703dc0a5_191866d88cb_-1567,2403707,Felipe Guerra - RN,4347,4358,11,5930,73.31,73.49,0.19
sidra_9541_PercMoradDPPOColetTot_munic_22_pol.fid-703dc0a5_191866d88cb_-1566,2405504,Jardim de Angicos - RN,683,1146,463,2428,28.13,47.2,19.07
sidra_9541_PercMoradDPPOColetTot_munic_22_pol.fid-703dc0a5_191866d88cb_-1565,2403806,Florânia - RN,8124,8215,91,10191,79.72,80.61,0.89
sidra_9541_PercMoradDPPOColetTot_munic_22_pol.fid-703dc0a5_191866d88cb_-1564,2404309,Governador Dix-Sept Rosado - RN,4233,6757,2524,11937,35.46,56.61,21.14
sidra_9541_PercMoradDPPOColetTot_munic_22_pol.fid-703dc0a5_191866d88cb_-1563,2403905,Francisco Dantas - RN,1885,1979,94,2693,70,73.49,3.49
sidra_9541_PercMoradDPPOColetTot_munic_22_pol.fid-703dc0a5_191866d88cb_-1562,2404002,Frutuoso Gomes - RN,3079,3482,403,4112,74.88,84.68,9.8
sidra_9541_PercMoradDPPOColetTot_munic_22_pol.fid-703dc0a5_191866d88cb_-1561,2404606,Ielmo Marinho - RN,7971,8349,378,11601,68.71,71.97,3.26
sidra_9541_PercMoradDPPOColetTot_munic_22_pol.fid-703dc0a5_191866d88cb_-1560,2404101,Galinhos - RN,1376,2051,675,2102,65.46,97.57,32.11
sidra_9541_PercMoradDPPOColetTot_munic_22_pol.fid-703dc0a5_191866d88cb_-155f,2404200,Goianinha - RN,25398,25980,582,26736,95,97.17,2.18
sidra_9541_PercMoradDPPOColetTot_munic_22_pol.fid-703dc0a5_191866d88cb_-155e,2404408,Grossos - RN,9631,9751,120,9897,97.31,98.52,1.21
sidra_9541_PercMoradDPPOColetTot_munic_22_pol.fid-703dc0a5_191866d88cb_-155d,2404507,Guamaré - RN,14024,14879,855,15256,91.92,97.53,5.6
sidra_9541_PercMoradDPPOColetTot_munic_22_pol.fid-703dc0a5_191866d88cb_-155c,2408607,Paraná - RN,1409,3351,1942,3934,35.82,85.18,49.36
sidra_9541_PercMoradDPPOColetTot_munic_22_pol.fid-703dc0a5_191866d88cb_-155b,2404705,Ipanguaçu - RN,11310,12086,776,14089,80.28,85.78,5.51
sidra_9541_PercMoradDPPOColetTot_munic_22_pol.fid-703dc0a5_191866d88cb_-155a,2404804,Ipueira - RN,1824,1906,82,2035,89.63,93.66,4.03
sidra_9541_PercMoradDPPOColetTot_munic_22_pol.fid-703dc0a5_191866d88cb_-1559,2404853,Itajá - RN,6845,6859,14,7281,94.01,94.2,0.19
sidra_9541_PercMoradDPPOColetTot_munic_22_pol.fid-703dc0a5_191866d88cb_-1558,2405207,Janduís - RN,3830,3839,9,4733,80.92,81.11,0.19
sidra_9541_PercMoradDPPOColetTot_munic_22_pol.fid-703dc0a5_191866d88cb_-1557,2405306,Januário Cicco - RN,6223,6412,189,9043,68.82,70.91,2.09
sidra_9541_PercMoradDPPOColetTot_munic_22_pol.fid-703dc0a5_191866d88cb_-1556,2405405,Japi - RN,4215,4283,68,5117,82.37,83.7,1.33
sidra_9541_PercMoradDPPOColetTot_munic_22_pol.fid-703dc0a5_191866d88cb_-1555,2405603,Jardim de Piranhas - RN,11796,11985,189,13974,84.41,85.77,1.35
sidra_9541_PercMoradDPPOColetTot_munic_22_pol.fid-703dc0a5_191866d88cb_-1554,2405702,Jardim do Seridó - RN,10442,10510,68,11614,89.91,90.49,0.59
sidra_9541_PercMoradDPPOColetTot_munic_22_pol.fid-703dc0a5_191866d88cb_-1553,2406205,Lagoa d'Anta - RN,5021,5669,648,6644,75.57,85.33,9.75
sidra_9541_PercMoradDPPOColetTot_munic_22_pol.fid-703dc0a5_191866d88cb_-1552,2405801,João Câmara - RN,26358,26932,574,33204,79.38,81.11,1.73
sidra_9541_PercMoradDPPOColetTot_munic_22_pol.fid-703dc0a5_191866d88cb_-1551,2405900,João Dias - RN,1325,1330,5,2075,63.86,64.1,0.24
sidra_9541_PercMoradDPPOColetTot_munic_22_pol.fid-703dc0a5_191866d88cb_-1550,2406007,José da Penha - RN,4713,4754,41,5791,81.38,82.09,0.71
sidra_9541_PercMoradDPPOColetTot_munic_22_pol.fid-703dc0a5_191866d88cb_-154f,2408706,Paraú - RN,3053,3183,130,3578,85.33,88.96,3.63
sidra_9541_PercMoradDPPOColetTot_munic_22_pol.fid-703dc0a5_191866d88cb_-154e,2406106,Jucurutu - RN,13410,13714,304,17757,75.52,77.23,1.71
sidra_9541_PercMoradDPPOColetTot_munic_22_pol.fid-703dc0a5_191866d88cb_-154d,2406155,Jundiá - RN,2917,3338,421,3727,78.27,89.56,11.3
sidra_9541_PercMoradDPPOColetTot_munic_22_pol.fid-703dc0a5_191866d88cb_-154c,2406502,Lagoa Nova - RN,10128,10628,500,15562,65.08,68.29,3.21
sidra_9541_PercMoradDPPOColetTot_munic_22_pol.fid-703dc0a5_191866d88cb_-154b,2406601,Lagoa Salgada - RN,5687,5715,28,8305,68.48,68.81,0.34
sidra_9541_PercMoradDPPOColetTot_munic_22_pol.fid-703dc0a5_191866d88cb_-154a,2408805,Parazinho - RN,3309,3771,462,4795,69.01,78.64,9.64
sidra_9541_PercMoradDPPOColetTot_munic_22_pol.fid-703dc0a5_191866d88cb_-1549,2406700,Lajes - RN,9172,9270,98,9849,93.13,94.12,1
sidra_9541_PercMoradDPPOColetTot_munic_22_pol.fid-703dc0a5_191866d88cb_-1548,2406809,Lajes Pintadas - RN,2538,3700,1162,4786,53.03,77.31,24.28
sidra_9541_PercMoradDPPOColetTot_munic_22_pol.fid-703dc0a5_191866d88cb_-1547,2406908,Lucrécia - RN,3465,3465,,3489,99.31,99.31,
sidra_9541_PercMoradDPPOColetTot_munic_22_pol.fid-703dc0a5_191866d88cb_-1546,2407005,Luís Gomes - RN,5780,6394,614,9067,63.75,70.52,6.77
sidra_9541_PercMoradDPPOColetTot_munic_22_pol.fid-703dc0a5_191866d88cb_-1545,4300570,Alto Feliz - RS,2823,3014,191,3072,91.89,98.11,6.22
sidra_9541_PercMoradDPPOColetTot_munic_22_pol.fid-703dc0a5_191866d88cb_-1544,4300604,Alvorada - RS,180149,183985,3836,186616,96.53,98.59,2.06
sidra_9541_PercMoradDPPOColetTot_munic_22_pol.fid-703dc0a5_191866d88cb_-1543,2407104,Macaíba - RN,75984,76974,990,82126,92.52,93.73,1.21
sidra_9541_PercMoradDPPOColetTot_munic_22_pol.fid-703dc0a5_191866d88cb_-1542,2407203,Macau - RN,24913,26263,1350,27301,91.25,96.2,4.94
sidra_9541_PercMoradDPPOColetTot_munic_22_pol.fid-703dc0a5_191866d88cb_-1541,2407252,Major Sales - RN,3203,3672,469,3924,81.63,93.58,11.95
sidra_9541_PercMoradDPPOColetTot_munic_22_pol.fid-703dc0a5_191866d88cb_-1540,2407302,Marcelino Vieira - RN,4040,5238,1198,7896,51.17,66.34,15.17
sidra_9541_PercMoradDPPOColetTot_munic_22_pol.fid-703dc0a5_191866d88cb_-153f,2408409,Olho d'Água do Borges - RN,2666,3110,444,3901,68.34,79.72,11.38
sidra_9541_PercMoradDPPOColetTot_munic_22_pol.fid-703dc0a5_191866d88cb_-153e,4300638,Amaral Ferrador - RS,2622,2841,219,5289,49.57,53.72,4.14
sidra_9541_PercMoradDPPOColetTot_munic_22_pol.fid-703dc0a5_191866d88cb_-153d,4300646,Ametista do Sul - RS,5075,5618,543,7638,66.44,73.55,7.11
sidra_9541_PercMoradDPPOColetTot_munic_22_pol.fid-703dc0a5_191866d88cb_-153c,4300661,André da Rocha - RS,813,985,172,1135,71.63,86.78,15.15
sidra_9541_PercMoradDPPOColetTot_munic_22_pol.fid-703dc0a5_191866d88cb_-153b,4300703,Anta Gorda - RS,5287,5389,102,5954,88.8,90.51,1.71
sidra_9541_PercMoradDPPOColetTot_munic_22_pol.fid-703dc0a5_191866d88cb_-153a,4300802,Antônio Prado - RS,5983,12301,6318,13010,45.99,94.55,48.56
sidra_9541_PercMoradDPPOColetTot_munic_22_pol.fid-703dc0a5_191866d88cb_-1539,2407401,Martins - RN,6313,7414,1101,8179,77.19,90.65,13.46
sidra_9541_PercMoradDPPOColetTot_munic_22_pol.fid-703dc0a5_191866d88cb_-1538,2407500,Maxaranguape - RN,9097,9292,195,10218,89.03,90.94,1.91
sidra_9541_PercMoradDPPOColetTot_munic_22_pol.fid-703dc0a5_191866d88cb_-1537,2407609,Messias Targino - RN,1252,3932,2680,4271,29.31,92.06,62.75
sidra_9541_PercMoradDPPOColetTot_munic_22_pol.fid-703dc0a5_191866d88cb_-1536,2407708,Montanhas - RN,9798,9882,84,11442,85.63,86.37,0.73
sidra_9541_PercMoradDPPOColetTot_munic_22_pol.fid-703dc0a5_191866d88cb_-1535,4301107,Arroio dos Ratos - RS,13572,13638,66,14007,96.89,97.37,0.47
sidra_9541_PercMoradDPPOColetTot_munic_22_pol.fid-703dc0a5_191866d88cb_-1534,4301206,Arroio do Tigre - RS,7041,7756,715,12053,58.42,64.35,5.93
sidra_9541_PercMoradDPPOColetTot_munic_22_pol.fid-703dc0a5_191866d88cb_-1533,2407807,Monte Alegre - RN,20130,20379,249,23018,87.45,88.54,1.08
sidra_9541_PercMoradDPPOColetTot_munic_22_pol.fid-703dc0a5_191866d88cb_-1532,2407906,Monte das Gameleiras - RN,1018,1748,730,2276,44.73,76.8,32.07
sidra_9541_PercMoradDPPOColetTot_munic_22_pol.fid-703dc0a5_191866d88cb_-1531,2408508,Ouro Branco - RN,3578,3655,77,4908,72.9,74.47,1.57
sidra_9541_PercMoradDPPOColetTot_munic_22_pol.fid-703dc0a5_191866d88cb_-1530,4301305,Arroio Grande - RS,10369,16297,5928,17514,59.2,93.05,33.85
sidra_9541_PercMoradDPPOColetTot_munic_22_pol.fid-703dc0a5_191866d88cb_-152f,4301404,Arvorezinha - RS,7174,8486,1312,10305,69.62,82.35,12.73
sidra_9541_PercMoradDPPOColetTot_munic_22_pol.fid-703dc0a5_191866d88cb_-152e,4301503,Augusto Pestana - RS,4283,5061,778,7149,59.91,70.79,10.88
sidra_9541_PercMoradDPPOColetTot_munic_22_pol.fid-703dc0a5_191866d88cb_-152d,4301552,Áurea - RS,2757,2757,,3396,81.18,81.18,
sidra_9541_PercMoradDPPOColetTot_munic_22_pol.fid-703dc0a5_191866d88cb_-152c,4301602,Bagé - RS,74428,115466,41038,117168,63.52,98.55,35.02
sidra_9541_PercMoradDPPOColetTot_munic_22_pol.fid-703dc0a5_191866d88cb_-152b,2408003,Mossoró - RN,248562,252515,3953,263529,94.32,95.82,1.5
sidra_9541_PercMoradDPPOColetTot_munic_22_pol.fid-703dc0a5_191866d88cb_-152a,2408102,Natal - RN,723613,743630,20017,748745,96.64,99.32,2.67
sidra_9541_PercMoradDPPOColetTot_munic_22_pol.fid-703dc0a5_191866d88cb_-1529,2408201,Nísia Floresta - RN,25665,27371,1706,29449,87.15,92.94,5.79
sidra_9541_PercMoradDPPOColetTot_munic_22_pol.fid-703dc0a5_191866d88cb_-1528,2408300,Nova Cruz - RN,28985,29341,356,34098,85,86.05,1.04
sidra_9541_PercMoradDPPOColetTot_munic_22_pol.fid-703dc0a5_191866d88cb_-1527,2408904,Parelhas - RN,18280,19929,1649,21437,85.27,92.97,7.69
sidra_9541_PercMoradDPPOColetTot_munic_22_pol.fid-703dc0a5_191866d88cb_-1526,2409332,Santa Maria - RN,3828,3843,15,4838,79.12,79.43,0.31
sidra_9541_PercMoradDPPOColetTot_munic_22_pol.fid-703dc0a5_191866d88cb_-1525,2409407,Pau dos Ferros - RN,27709,28835,1126,30221,91.69,95.41,3.73
sidra_9541_PercMoradDPPOColetTot_munic_22_pol.fid-703dc0a5_191866d88cb_-1524,2408953,Rio do Fogo - RN,9098,9267,169,10297,88.36,90,1.64
sidra_9541_PercMoradDPPOColetTot_munic_22_pol.fid-703dc0a5_191866d88cb_-1523,2409100,Passa e Fica - RN,8121,9875,1754,10851,74.84,91.01,16.16
sidra_9541_PercMoradDPPOColetTot_munic_22_pol.fid-703dc0a5_191866d88cb_-1522,2409209,Passagem - RN,2695,2789,94,3115,86.52,89.53,3.02
sidra_9541_PercMoradDPPOColetTot_munic_22_pol.fid-703dc0a5_191866d88cb_-1521,2409308,Patu - RN,9478,9527,49,10987,86.27,86.71,0.45
sidra_9541_PercMoradDPPOColetTot_munic_22_pol.fid-703dc0a5_191866d88cb_-1520,2409506,Pedra Grande - RN,3260,3441,181,3598,90.61,95.64,5.03
sidra_9541_PercMoradDPPOColetTot_munic_22_pol.fid-703dc0a5_191866d88cb_-151f,2409605,Pedra Preta - RN,1121,1130,9,2433,46.07,46.44,0.37
sidra_9541_PercMoradDPPOColetTot_munic_22_pol.fid-703dc0a5_191866d88cb_-151e,2409704,Pedro Avelino - RN,4712,4798,86,6237,75.55,76.93,1.38
sidra_9541_PercMoradDPPOColetTot_munic_22_pol.fid-703dc0a5_191866d88cb_-151d,2409803,Pedro Velho - RN,11269,11559,290,13821,81.54,83.63,2.1
sidra_9541_PercMoradDPPOColetTot_munic_22_pol.fid-703dc0a5_191866d88cb_-151c,2409902,Pendências - RN,12103,12122,19,12268,98.66,98.81,0.15
sidra_9541_PercMoradDPPOColetTot_munic_22_pol.fid-703dc0a5_191866d88cb_-151b,2410009,Pilões - RN,2768,2771,3,2961,93.48,93.58,0.1
sidra_9541_PercMoradDPPOColetTot_munic_22_pol.fid-703dc0a5_191866d88cb_-151a,2410108,Poço Branco - RN,9011,9034,23,12354,72.94,73.13,0.19
sidra_9541_PercMoradDPPOColetTot_munic_22_pol.fid-703dc0a5_191866d88cb_-1519,2410603,Rafael Godeiro - RN,1988,2000,12,2933,67.78,68.19,0.41
sidra_9541_PercMoradDPPOColetTot_munic_22_pol.fid-703dc0a5_191866d88cb_-1518,2410207,Portalegre - RN,4490,4751,261,7600,59.08,62.51,3.43
sidra_9541_PercMoradDPPOColetTot_munic_22_pol.fid-703dc0a5_191866d88cb_-1517,2411056,Tibau - RN,5290,5290,,5332,99.21,99.21,
sidra_9541_PercMoradDPPOColetTot_munic_22_pol.fid-703dc0a5_191866d88cb_-1516,2410256,Porto do Mangue - RN,4345,4602,257,5214,83.33,88.26,4.93
sidra_9541_PercMoradDPPOColetTot_munic_22_pol.fid-703dc0a5_191866d88cb_-1515,2410306,Serra Caiada - RN,8402,8444,42,10108,83.12,83.54,0.42
sidra_9541_PercMoradDPPOColetTot_munic_22_pol.fid-703dc0a5_191866d88cb_-1514,2411106,Ruy Barbosa - RN,1137,1996,859,3191,35.63,62.55,26.92
sidra_9541_PercMoradDPPOColetTot_munic_22_pol.fid-703dc0a5_191866d88cb_-1513,2410405,Pureza - RN,5024,5617,593,9346,53.76,60.1,6.34
sidra_9541_PercMoradDPPOColetTot_munic_22_pol.fid-703dc0a5_191866d88cb_-1512,2410504,Rafael Fernandes - RN,4697,4798,101,5428,86.53,88.39,1.86
sidra_9541_PercMoradDPPOColetTot_munic_22_pol.fid-703dc0a5_191866d88cb_-1511,2413706,Sítio Novo - RN,1674,3251,1577,4649,36.01,69.93,33.92
sidra_9541_PercMoradDPPOColetTot_munic_22_pol.fid-703dc0a5_191866d88cb_-1510,2410702,Riacho da Cruz - RN,2464,2489,25,2701,91.23,92.15,0.93
sidra_9541_PercMoradDPPOColetTot_munic_22_pol.fid-703dc0a5_191866d88cb_-150f,2410801,Riacho de Santana - RN,2103,2109,6,4127,50.96,51.1,0.15
sidra_9541_PercMoradDPPOColetTot_munic_22_pol.fid-703dc0a5_191866d88cb_-150e,2410900,Riachuelo - RN,6851,6865,14,7375,92.89,93.08,0.19
sidra_9541_PercMoradDPPOColetTot_munic_22_pol.fid-703dc0a5_191866d88cb_-150d,2411007,Rodolfo Fernandes - RN,3956,3956,,4242,93.26,93.26,
sidra_9541_PercMoradDPPOColetTot_munic_22_pol.fid-703dc0a5_191866d88cb_-150c,2411205,Santa Cruz - RN,30410,31557,1147,37279,81.57,84.65,3.08
sidra_9541_PercMoradDPPOColetTot_munic_22_pol.fid-703dc0a5_191866d88cb_-150b,2411502,Santo Antônio - RN,19345,19603,258,22169,87.26,88.43,1.16
sidra_9541_PercMoradDPPOColetTot_munic_22_pol.fid-703dc0a5_191866d88cb_-150a,2414100,Tenente Ananias - RN,5285,8329,3044,10251,51.56,81.25,29.69
sidra_9541_PercMoradDPPOColetTot_munic_22_pol.fid-703dc0a5_191866d88cb_-1509,2411403,Santana do Matos - RN,7081,7496,415,12454,56.86,60.19,3.33
sidra_9541_PercMoradDPPOColetTot_munic_22_pol.fid-703dc0a5_191866d88cb_-1508,2411429,Santana do Seridó - RN,2420,2425,5,2692,89.9,90.08,0.19
sidra_9541_PercMoradDPPOColetTot_munic_22_pol.fid-703dc0a5_191866d88cb_-1507,2411601,São Bento do Norte - RN,2616,2642,26,3289,79.54,80.33,0.79
sidra_9541_PercMoradDPPOColetTot_munic_22_pol.fid-703dc0a5_191866d88cb_-1506,2411700,São Bento do Trairí - RN,2045,2598,553,3790,53.96,68.55,14.59
sidra_9541_PercMoradDPPOColetTot_munic_22_pol.fid-703dc0a5_191866d88cb_-1505,2411809,São Fernando - RN,2557,2711,154,3492,73.22,77.63,4.41
sidra_9541_PercMoradDPPOColetTot_munic_22_pol.fid-703dc0a5_191866d88cb_-1504,2411908,São Francisco do Oeste - RN,3218,3708,490,4159,77.37,89.16,11.78
sidra_9541_PercMoradDPPOColetTot_munic_22_pol.fid-703dc0a5_191866d88cb_-1503,2412104,São João do Sabugi - RN,4883,5284,401,5954,82.01,88.75,6.73
sidra_9541_PercMoradDPPOColetTot_munic_22_pol.fid-703dc0a5_191866d88cb_-1502,2412005,São Gonçalo do Amarante - RN,107954,113579,5625,115693,93.31,98.17,4.86
sidra_9541_PercMoradDPPOColetTot_munic_22_pol.fid-703dc0a5_191866d88cb_-1501,2413359,Serra do Mel - RN,7131,11156,4025,13060,54.6,85.42,30.82
sidra_9541_PercMoradDPPOColetTot_munic_22_pol.fid-703dc0a5_191866d88cb_-1500,2412203,São José de Mipibu - RN,41312,42203,891,47193,87.54,89.43,1.89
sidra_9541_PercMoradDPPOColetTot_munic_22_pol.fid-703dc0a5_191866d88cb_-14ff,2412302,São José do Campestre - RN,9690,9968,278,11119,87.15,89.65,2.5
sidra_9541_PercMoradDPPOColetTot_munic_22_pol.fid-703dc0a5_191866d88cb_-14fe,2412401,São José do Seridó - RN,1557,4059,2502,4539,34.3,89.42,55.12
sidra_9541_PercMoradDPPOColetTot_munic_22_pol.fid-703dc0a5_191866d88cb_-14fd,2412500,São Miguel - RN,17900,19650,1750,23517,76.12,83.56,7.44
sidra_9541_PercMoradDPPOColetTot_munic_22_pol.fid-703dc0a5_191866d88cb_-14fc,2413409,Serra Negra do Norte - RN,5414,5654,240,7591,71.32,74.48,3.16
sidra_9541_PercMoradDPPOColetTot_munic_22_pol.fid-703dc0a5_191866d88cb_-14fb,2412559,São Miguel do Gostoso - RN,5499,6081,582,10196,53.93,59.64,5.71
sidra_9541_PercMoradDPPOColetTot_munic_22_pol.fid-703dc0a5_191866d88cb_-14fa,2412609,São Paulo do Potengi - RN,14969,15480,511,16750,89.37,92.42,3.05
sidra_9541_PercMoradDPPOColetTot_munic_22_pol.fid-703dc0a5_191866d88cb_-14f9,2412708,São Pedro - RN,4170,4374,204,5760,72.4,75.94,3.54
sidra_9541_PercMoradDPPOColetTot_munic_22_pol.fid-703dc0a5_191866d88cb_-14f8,2412807,São Rafael - RN,5980,6211,231,7710,77.56,80.56,3
sidra_9541_PercMoradDPPOColetTot_munic_22_pol.fid-703dc0a5_191866d88cb_-14f7,2412906,São Tomé - RN,6036,6129,93,9932,60.77,61.71,0.94
sidra_9541_PercMoradDPPOColetTot_munic_22_pol.fid-703dc0a5_191866d88cb_-14f6,2413003,São Vicente - RN,4259,4438,179,6309,67.51,70.34,2.84
sidra_9541_PercMoradDPPOColetTot_munic_22_pol.fid-703dc0a5_191866d88cb_-14f5,2413102,Senador Elói de Souza - RN,3492,4358,866,5963,58.56,73.08,14.52
sidra_9541_PercMoradDPPOColetTot_munic_22_pol.fid-703dc0a5_191866d88cb_-14f4,2413201,Senador Georgino Avelino - RN,3922,3951,29,4058,96.65,97.36,0.71
sidra_9541_PercMoradDPPOColetTot_munic_22_pol.fid-703dc0a5_191866d88cb_-14f3,2413300,Serra de São Bento - RN,3128,4729,1601,5674,55.13,83.35,28.22
sidra_9541_PercMoradDPPOColetTot_munic_22_pol.fid-703dc0a5_191866d88cb_-14f2,2413508,Serrinha - RN,4295,4315,20,6417,66.93,67.24,0.31
sidra_9541_PercMoradDPPOColetTot_munic_22_pol.fid-703dc0a5_191866d88cb_-14f1,2413557,Serrinha dos Pintos - RN,3441,3491,50,4648,74.03,75.11,1.08
sidra_9541_PercMoradDPPOColetTot_munic_22_pol.fid-703dc0a5_191866d88cb_-14f0,2413607,Severiano Melo - RN,2341,4881,2540,5481,42.71,89.05,46.34
sidra_9541_PercMoradDPPOColetTot_munic_22_pol.fid-703dc0a5_191866d88cb_-14ef,2413805,Taboleiro Grande - RN,716,2073,1357,2338,30.62,88.67,58.04
sidra_9541_PercMoradDPPOColetTot_munic_22_pol.fid-703dc0a5_191866d88cb_-14ee,2413904,Taipu - RN,6435,7093,658,11400,56.45,62.22,5.77
sidra_9541_PercMoradDPPOColetTot_munic_22_pol.fid-703dc0a5_191866d88cb_-14ed,2414001,Tangará - RN,11163,11749,586,13252,84.24,88.66,4.42
sidra_9541_PercMoradDPPOColetTot_munic_22_pol.fid-703dc0a5_191866d88cb_-14ec,2414159,Tenente Laurentino Cruz - RN,4085,4232,147,5890,69.35,71.85,2.5
sidra_9541_PercMoradDPPOColetTot_munic_22_pol.fid-703dc0a5_191866d88cb_-14eb,2414209,Tibau do Sul - RN,14849,16536,1687,16911,87.81,97.78,9.98
sidra_9541_PercMoradDPPOColetTot_munic_22_pol.fid-703dc0a5_191866d88cb_-14ea,2414308,Timbaúba dos Batistas - RN,2045,2050,5,2344,87.24,87.46,0.21
sidra_9541_PercMoradDPPOColetTot_munic_22_pol.fid-703dc0a5_191866d88cb_-14e9,2414407,Touros - RN,22166,23127,961,33011,67.15,70.06,2.91
sidra_9541_PercMoradDPPOColetTot_munic_22_pol.fid-703dc0a5_191866d88cb_-14e8,2414456,Triunfo Potiguar - RN,1505,2279,774,3340,45.06,68.23,23.17
sidra_9541_PercMoradDPPOColetTot_munic_22_pol.fid-703dc0a5_191866d88cb_-14e7,2414506,Umarizal - RN,7981,8733,752,10073,79.23,86.7,7.47
sidra_9541_PercMoradDPPOColetTot_munic_22_pol.fid-703dc0a5_191866d88cb_-14e6,2414605,Upanema - RN,8251,8463,212,13575,60.78,62.34,1.56
sidra_9541_PercMoradDPPOColetTot_munic_22_pol.fid-703dc0a5_191866d88cb_-14e5,2414704,Várzea - RN,3597,4651,1054,5229,68.79,88.95,20.16
sidra_9541_PercMoradDPPOColetTot_munic_22_pol.fid-703dc0a5_191866d88cb_-14e4,2414753,Venha-Ver - RN,1888,2043,155,3014,62.64,67.78,5.14
sidra_9541_PercMoradDPPOColetTot_munic_22_pol.fid-703dc0a5_191866d88cb_-14e3,2414803,Vera Cruz - RN,10149,10189,40,10715,94.72,95.09,0.37
sidra_9541_PercMoradDPPOColetTot_munic_22_pol.fid-703dc0a5_191866d88cb_-14e2,2414902,Viçosa - RN,748,1797,1049,1821,41.08,98.68,57.61
sidra_9541_PercMoradDPPOColetTot_munic_22_pol.fid-703dc0a5_191866d88cb_-14e1,2415008,Vila Flor - RN,2315,3123,808,3173,72.96,98.42,25.46
sidra_9541_PercMoradDPPOColetTot_munic_22_pol.fid-703dc0a5_191866d88cb_-14e0,2502052,Bernardino Batista - PB,2804,2951,147,3504,80.02,84.22,4.2
sidra_9541_PercMoradDPPOColetTot_munic_22_pol.fid-703dc0a5_191866d88cb_-14df,2500106,Água Branca - PB,2015,6463,4448,9335,21.59,69.23,47.65
sidra_9541_PercMoradDPPOColetTot_munic_22_pol.fid-703dc0a5_191866d88cb_-14de,2500205,Aguiar - PB,2850,2922,72,5003,56.97,58.4,1.44
sidra_9541_PercMoradDPPOColetTot_munic_22_pol.fid-703dc0a5_191866d88cb_-14dd,2500304,Alagoa Grande - PB,18709,19995,1286,26006,71.94,76.89,4.95
sidra_9541_PercMoradDPPOColetTot_munic_22_pol.fid-703dc0a5_191866d88cb_-14dc,2500403,Alagoa Nova - PB,11250,12747,1497,20972,53.64,60.78,7.14
sidra_9541_PercMoradDPPOColetTot_munic_22_pol.fid-703dc0a5_191866d88cb_-14db,2505501,Vista Serrana - PB,3038,3058,20,3641,83.44,83.99,0.55
sidra_9541_PercMoradDPPOColetTot_munic_22_pol.fid-703dc0a5_191866d88cb_-14da,2505600,Diamante - PB,3893,3900,7,6299,61.8,61.91,0.11
sidra_9541_PercMoradDPPOColetTot_munic_22_pol.fid-703dc0a5_191866d88cb_-14d9,2505709,Dona Inês - PB,6042,7011,969,10340,58.43,67.8,9.37
sidra_9541_PercMoradDPPOColetTot_munic_22_pol.fid-703dc0a5_191866d88cb_-14d8,2500502,Alagoinha - PB,10451,10826,375,13700,76.28,79.02,2.74
sidra_9541_PercMoradDPPOColetTot_munic_22_pol.fid-703dc0a5_191866d88cb_-14d7,2500536,Alcantil - PB,3700,3845,145,5574,66.38,68.98,2.6
sidra_9541_PercMoradDPPOColetTot_munic_22_pol.fid-703dc0a5_191866d88cb_-14d6,2500577,Algodão de Jandaíra - PB,1753,1759,6,2929,59.85,60.05,0.2
sidra_9541_PercMoradDPPOColetTot_munic_22_pol.fid-703dc0a5_191866d88cb_-14d5,2500601,Alhandra - PB,18379,18837,458,21658,84.86,86.97,2.11
sidra_9541_PercMoradDPPOColetTot_munic_22_pol.fid-703dc0a5_191866d88cb_-14d4,2500700,São João do Rio do Peixe - PB,11573,11899,326,17902,64.65,66.47,1.82
sidra_9541_PercMoradDPPOColetTot_munic_22_pol.fid-703dc0a5_191866d88cb_-14d3,2500734,Amparo - PB,1348,1422,74,2234,60.34,63.65,3.31
sidra_9541_PercMoradDPPOColetTot_munic_22_pol.fid-703dc0a5_191866d88cb_-14d2,2500775,Aparecida - PB,5473,6360,887,7954,68.81,79.96,11.15
sidra_9541_PercMoradDPPOColetTot_munic_22_pol.fid-703dc0a5_191866d88cb_-14d1,2500809,Araçagi - PB,10052,10134,82,16643,60.4,60.89,0.49
sidra_9541_PercMoradDPPOColetTot_munic_22_pol.fid-703dc0a5_191866d88cb_-14d0,2500908,Arara - PB,8707,9645,938,12207,71.33,79.01,7.68
sidra_9541_PercMoradDPPOColetTot_munic_22_pol.fid-703dc0a5_191866d88cb_-14cf,2502300,Bom Sucesso - PB,2423,2747,324,4658,52.02,58.97,6.96
sidra_9541_PercMoradDPPOColetTot_munic_22_pol.fid-703dc0a5_191866d88cb_-14ce,2502409,Bonito de Santa Fé - PB,7544,7934,390,10237,73.69,77.5,3.81
sidra_9541_PercMoradDPPOColetTot_munic_22_pol.fid-703dc0a5_191866d88cb_-14cd,2501005,Araruna - PB,13368,13731,363,17141,77.99,80.11,2.12
sidra_9541_PercMoradDPPOColetTot_munic_22_pol.fid-703dc0a5_191866d88cb_-14cc,2501104,Areia - PB,13601,16050,2449,22581,60.23,71.08,10.85
sidra_9541_PercMoradDPPOColetTot_munic_22_pol.fid-703dc0a5_191866d88cb_-14cb,2501153,Areia de Baraúnas - PB,1024,1064,40,2005,51.07,53.07,2
sidra_9541_PercMoradDPPOColetTot_munic_22_pol.fid-703dc0a5_191866d88cb_-14ca,2502508,Boqueirão - PB,13103,13588,485,17545,74.68,77.45,2.76
sidra_9541_PercMoradDPPOColetTot_munic_22_pol.fid-703dc0a5_191866d88cb_-14c9,2502607,Igaracy - PB,4398,4412,14,5627,78.16,78.41,0.25
sidra_9541_PercMoradDPPOColetTot_munic_22_pol.fid-703dc0a5_191866d88cb_-14c8,2501203,Areial - PB,5221,5637,416,7127,73.26,79.09,5.84
sidra_9541_PercMoradDPPOColetTot_munic_22_pol.fid-703dc0a5_191866d88cb_-14c7,2501302,Aroeiras - PB,9386,9741,355,18674,50.26,52.16,1.9
sidra_9541_PercMoradDPPOColetTot_munic_22_pol.fid-703dc0a5_191866d88cb_-14c6,2501351,Assunção - PB,2034,3406,1372,4143,49.09,82.21,33.12
sidra_9541_PercMoradDPPOColetTot_munic_22_pol.fid-703dc0a5_191866d88cb_-14c5,2501401,Baía da Traição - PB,3675,4267,592,9203,39.93,46.37,6.43
sidra_9541_PercMoradDPPOColetTot_munic_22_pol.fid-703dc0a5_191866d88cb_-14c4,2501500,Bananeiras - PB,14092,16233,2141,23040,61.16,70.46,9.29
sidra_9541_PercMoradDPPOColetTot_munic_22_pol.fid-703dc0a5_191866d88cb_-14c3,2705309,Minador do Negrão - AL,1580,2574,994,4843,32.62,53.15,20.52
sidra_9541_PercMoradDPPOColetTot_munic_22_pol.fid-703dc0a5_191866d88cb_-14c2,2501534,Baraúna - PB,3885,3900,15,4758,81.65,81.97,0.32
sidra_9541_PercMoradDPPOColetTot_munic_22_pol.fid-703dc0a5_191866d88cb_-14c1,2501575,Barra de Santana - PB,2780,2874,94,8056,34.51,35.68,1.17
sidra_9541_PercMoradDPPOColetTot_munic_22_pol.fid-703dc0a5_191866d88cb_-14c0,2501609,Barra de Santa Rosa - PB,8180,8678,498,12901,63.41,67.27,3.86
sidra_9541_PercMoradDPPOColetTot_munic_22_pol.fid-703dc0a5_191866d88cb_-14bf,2501708,Barra de São Miguel - PB,4265,4399,134,5904,72.24,74.51,2.27
sidra_9541_PercMoradDPPOColetTot_munic_22_pol.fid-703dc0a5_191866d88cb_-14be,2501807,Bayeux - PB,76845,80012,3167,82556,93.08,96.92,3.84
sidra_9541_PercMoradDPPOColetTot_munic_22_pol.fid-703dc0a5_191866d88cb_-14bd,2501906,Belém - PB,14263,14307,44,16316,87.42,87.69,0.27
sidra_9541_PercMoradDPPOColetTot_munic_22_pol.fid-703dc0a5_191866d88cb_-14bc,2502003,Belém do Brejo do Cruz - PB,2324,5089,2765,6268,37.08,81.19,44.11
sidra_9541_PercMoradDPPOColetTot_munic_22_pol.fid-703dc0a5_191866d88cb_-14bb,2705408,Monteirópolis - AL,3448,5390,1942,7184,48,75.03,27.03
sidra_9541_PercMoradDPPOColetTot_munic_22_pol.fid-703dc0a5_191866d88cb_-14ba,2502102,Boa Ventura - PB,3959,3993,34,5206,76.05,76.7,0.65
sidra_9541_PercMoradDPPOColetTot_munic_22_pol.fid-703dc0a5_191866d88cb_-14b9,2502151,Boa Vista - PB,3820,3879,59,6373,59.94,60.87,0.93
sidra_9541_PercMoradDPPOColetTot_munic_22_pol.fid-703dc0a5_191866d88cb_-14b8,2502201,Bom Jesus - PB,1718,1720,2,2286,75.15,75.24,0.09
sidra_9541_PercMoradDPPOColetTot_munic_22_pol.fid-703dc0a5_191866d88cb_-14b7,2502706,Borborema - PB,3354,3496,142,4201,79.84,83.22,3.38
sidra_9541_PercMoradDPPOColetTot_munic_22_pol.fid-703dc0a5_191866d88cb_-14b6,2502805,Brejo do Cruz - PB,11090,11114,24,13596,81.57,81.74,0.18
sidra_9541_PercMoradDPPOColetTot_munic_22_pol.fid-703dc0a5_191866d88cb_-14b5,2508554,Logradouro - PB,3638,4303,665,4795,75.87,89.74,13.87
sidra_9541_PercMoradDPPOColetTot_munic_22_pol.fid-703dc0a5_191866d88cb_-14b4,2508604,Lucena - PB,9849,10918,1069,12551,78.47,86.99,8.52
sidra_9541_PercMoradDPPOColetTot_munic_22_pol.fid-703dc0a5_191866d88cb_-14b3,2502904,Brejo dos Santos - PB,4633,5140,507,5742,80.69,89.52,8.83
sidra_9541_PercMoradDPPOColetTot_munic_22_pol.fid-703dc0a5_191866d88cb_-14b2,2503001,Caaporã - PB,17934,18925,991,21191,84.63,89.31,4.68
sidra_9541_PercMoradDPPOColetTot_munic_22_pol.fid-703dc0a5_191866d88cb_-14b1,2503100,Cabaceiras - PB,2536,2578,42,5334,47.54,48.33,0.79
sidra_9541_PercMoradDPPOColetTot_munic_22_pol.fid-703dc0a5_191866d88cb_-14b0,2503209,Cabedelo - PB,61879,65279,3400,66264,93.38,98.51,5.13
sidra_9541_PercMoradDPPOColetTot_munic_22_pol.fid-703dc0a5_191866d88cb_-14af,2503407,Cacimba de Areia - PB,1912,1917,5,3281,58.27,58.43,0.15
sidra_9541_PercMoradDPPOColetTot_munic_22_pol.fid-703dc0a5_191866d88cb_-14ae,2511400,Picuí - PB,13563,13808,245,18304,74.1,75.44,1.34
sidra_9541_PercMoradDPPOColetTot_munic_22_pol.fid-703dc0a5_191866d88cb_-14ad,2511509,Pilar - PB,8166,9834,1668,12250,66.66,80.28,13.62
sidra_9541_PercMoradDPPOColetTot_munic_22_pol.fid-703dc0a5_191866d88cb_-14ac,2511608,Pilões - PB,2820,3970,1150,6813,41.39,58.27,16.88
sidra_9541_PercMoradDPPOColetTot_munic_22_pol.fid-703dc0a5_191866d88cb_-14ab,2503308,Cachoeira dos Índios - PB,4769,4944,175,9149,52.13,54.04,1.91
sidra_9541_PercMoradDPPOColetTot_munic_22_pol.fid-703dc0a5_191866d88cb_-14aa,2504801,Coremas - PB,12719,12852,133,14604,87.09,88,0.91
sidra_9541_PercMoradDPPOColetTot_munic_22_pol.fid-703dc0a5_191866d88cb_-14a9,2503506,Cacimba de Dentro - PB,11270,12250,980,16052,70.21,76.31,6.11
sidra_9541_PercMoradDPPOColetTot_munic_22_pol.fid-703dc0a5_191866d88cb_-14a8,2503555,Cacimbas - PB,2353,3476,1123,7223,32.58,48.12,15.55
sidra_9541_PercMoradDPPOColetTot_munic_22_pol.fid-703dc0a5_191866d88cb_-14a7,2503605,Caiçara - PB,5054,5108,54,6602,76.55,77.37,0.82
sidra_9541_PercMoradDPPOColetTot_munic_22_pol.fid-703dc0a5_191866d88cb_-14a6,2503704,Cajazeiras - PB,52290,54040,1750,62813,83.25,86.03,2.79
sidra_9541_PercMoradDPPOColetTot_munic_22_pol.fid-703dc0a5_191866d88cb_-14a5,2503753,Cajazeirinhas - PB,1008,1493,485,2736,36.84,54.57,17.73
sidra_9541_PercMoradDPPOColetTot_munic_22_pol.fid-703dc0a5_191866d88cb_-14a4,2503803,Caldas Brandão - PB,4637,4895,258,5748,80.67,85.16,4.49
sidra_9541_PercMoradDPPOColetTot_munic_22_pol.fid-703dc0a5_191866d88cb_-14a3,2503902,Camalaú - PB,3607,3622,15,6057,59.55,59.8,0.25
sidra_9541_PercMoradDPPOColetTot_munic_22_pol.fid-703dc0a5_191866d88cb_-14a2,2504009,Campina Grande - PB,396181,406009,9828,417053,95,97.35,2.36
sidra_9541_PercMoradDPPOColetTot_munic_22_pol.fid-703dc0a5_191866d88cb_-14a1,2504033,Capim - PB,6172,6194,22,6964,88.63,88.94,0.32
sidra_9541_PercMoradDPPOColetTot_munic_22_pol.fid-703dc0a5_191866d88cb_-14a0,2504074,Caraúbas - PB,2293,2651,358,3944,58.14,67.22,9.08
sidra_9541_PercMoradDPPOColetTot_munic_22_pol.fid-703dc0a5_191866d88cb_-149f,2705507,Murici - AL,21632,22644,1012,25083,86.24,90.28,4.03
sidra_9541_PercMoradDPPOColetTot_munic_22_pol.fid-703dc0a5_191866d88cb_-149e,2504108,Carrapateira - PB,2079,2207,128,2312,89.92,95.46,5.54
sidra_9541_PercMoradDPPOColetTot_munic_22_pol.fid-703dc0a5_191866d88cb_-149d,2504157,Casserengue - PB,4274,4339,65,6888,62.05,62.99,0.94
sidra_9541_PercMoradDPPOColetTot_munic_22_pol.fid-703dc0a5_191866d88cb_-149c,2504207,Catingueira - PB,2604,2929,325,4491,57.98,65.22,7.24
sidra_9541_PercMoradDPPOColetTot_munic_22_pol.fid-703dc0a5_191866d88cb_-149b,2504306,Catolé do Rocha - PB,25400,26884,1484,30470,83.36,88.23,4.87
sidra_9541_PercMoradDPPOColetTot_munic_22_pol.fid-703dc0a5_191866d88cb_-149a,2504355,Caturité - PB,4507,4514,7,5254,85.78,85.92,0.13
sidra_9541_PercMoradDPPOColetTot_munic_22_pol.fid-703dc0a5_191866d88cb_-1499,2504405,Conceição - PB,10168,11812,1644,18207,55.85,64.88,9.03
sidra_9541_PercMoradDPPOColetTot_munic_22_pol.fid-703dc0a5_191866d88cb_-1498,2504504,Condado - PB,4777,4786,9,6431,74.28,74.42,0.14
sidra_9541_PercMoradDPPOColetTot_munic_22_pol.fid-703dc0a5_191866d88cb_-1497,2504603,Conde - PB,22506,23452,946,27433,82.04,85.49,3.45
sidra_9541_PercMoradDPPOColetTot_munic_22_pol.fid-703dc0a5_191866d88cb_-1496,2505204,Cuitegi - PB,5861,6392,531,6730,87.09,94.98,7.89
sidra_9541_PercMoradDPPOColetTot_munic_22_pol.fid-703dc0a5_191866d88cb_-1495,2505238,Cuité de Mamanguape - PB,3071,3764,693,6245,49.18,60.27,11.1
sidra_9541_PercMoradDPPOColetTot_munic_22_pol.fid-703dc0a5_191866d88cb_-1494,2505279,Curral de Cima - PB,1129,1189,60,5254,21.49,22.63,1.14
sidra_9541_PercMoradDPPOColetTot_munic_22_pol.fid-703dc0a5_191866d88cb_-1493,2504702,Congo - PB,3541,3604,63,4930,71.83,73.1,1.28
sidra_9541_PercMoradDPPOColetTot_munic_22_pol.fid-703dc0a5_191866d88cb_-1492,2504850,Coxixola - PB,10,937,927,1824,0.55,51.37,50.82
sidra_9541_PercMoradDPPOColetTot_munic_22_pol.fid-703dc0a5_191866d88cb_-1491,2504900,Cruz do Espírito Santo - PB,6836,8137,1301,17089,40,47.62,7.61
sidra_9541_PercMoradDPPOColetTot_munic_22_pol.fid-703dc0a5_191866d88cb_-1490,2505006,Cubati - PB,4606,5061,455,7542,61.07,67.1,6.03
sidra_9541_PercMoradDPPOColetTot_munic_22_pol.fid-703dc0a5_191866d88cb_-148f,2505105,Cuité - PB,14248,14397,149,19624,72.6,73.36,0.76
sidra_9541_PercMoradDPPOColetTot_munic_22_pol.fid-703dc0a5_191866d88cb_-148e,2505303,Curral Velho - PB,890,1416,526,2287,38.92,61.92,23
sidra_9541_PercMoradDPPOColetTot_munic_22_pol.fid-703dc0a5_191866d88cb_-148d,2505352,Damião - PB,2866,3437,571,4980,57.55,69.02,11.47
sidra_9541_PercMoradDPPOColetTot_munic_22_pol.fid-703dc0a5_191866d88cb_-148c,2505402,Desterro - PB,3592,5542,1950,8067,44.53,68.7,24.17
sidra_9541_PercMoradDPPOColetTot_munic_22_pol.fid-703dc0a5_191866d88cb_-148b,2505808,Duas Estradas - PB,2661,2755,94,3315,80.27,83.11,2.84
sidra_9541_PercMoradDPPOColetTot_munic_22_pol.fid-703dc0a5_191866d88cb_-148a,2505907,Emas - PB,2231,2231,,3001,74.34,74.34,
sidra_9541_PercMoradDPPOColetTot_munic_22_pol.fid-703dc0a5_191866d88cb_-1489,2506004,Esperança - PB,17990,24635,6645,31141,57.77,79.11,21.34
sidra_9541_PercMoradDPPOColetTot_munic_22_pol.fid-703dc0a5_191866d88cb_-1488,2506103,Fagundes - PB,5794,5812,18,11046,52.45,52.62,0.16
sidra_9541_PercMoradDPPOColetTot_munic_22_pol.fid-703dc0a5_191866d88cb_-1487,2705705,Olho d'Água das Flores - AL,14715,15410,695,20640,71.29,74.66,3.37
sidra_9541_PercMoradDPPOColetTot_munic_22_pol.fid-703dc0a5_191866d88cb_-1486,2705804,Olho d'Água do Casado - AL,4888,5034,146,8342,58.6,60.35,1.75
sidra_9541_PercMoradDPPOColetTot_munic_22_pol.fid-703dc0a5_191866d88cb_-1485,2506202,Frei Martinho - PB,377,2191,1814,2841,13.27,77.12,63.85
sidra_9541_PercMoradDPPOColetTot_munic_22_pol.fid-703dc0a5_191866d88cb_-1484,2506251,Gado Bravo - PB,2283,2569,286,8175,27.93,31.43,3.5
sidra_9541_PercMoradDPPOColetTot_munic_22_pol.fid-703dc0a5_191866d88cb_-1483,2506301,Guarabira - PB,52226,53704,1478,57020,91.59,94.18,2.59
sidra_9541_PercMoradDPPOColetTot_munic_22_pol.fid-703dc0a5_191866d88cb_-1482,2506400,Gurinhém - PB,9326,9814,488,13757,67.79,71.34,3.55
sidra_9541_PercMoradDPPOColetTot_munic_22_pol.fid-703dc0a5_191866d88cb_-1481,2506509,Gurjão - PB,1249,2325,1076,3240,38.55,71.76,33.21
sidra_9541_PercMoradDPPOColetTot_munic_22_pol.fid-703dc0a5_191866d88cb_-1480,2506608,Ibiara - PB,1449,4039,2590,5627,25.75,71.78,46.03
sidra_9541_PercMoradDPPOColetTot_munic_22_pol.fid-703dc0a5_191866d88cb_-147f,2506707,Imaculada - PB,3447,5840,2393,10378,33.21,56.27,23.06
sidra_9541_PercMoradDPPOColetTot_munic_22_pol.fid-703dc0a5_191866d88cb_-147e,2506806,Ingá - PB,13677,13906,229,17637,77.55,78.85,1.3
sidra_9541_PercMoradDPPOColetTot_munic_22_pol.fid-703dc0a5_191866d88cb_-147d,2506905,Itabaiana - PB,20039,20183,144,23076,86.84,87.46,0.62
sidra_9541_PercMoradDPPOColetTot_munic_22_pol.fid-703dc0a5_191866d88cb_-147c,2507002,Itaporanga - PB,19107,19417,310,23858,80.09,81.39,1.3
sidra_9541_PercMoradDPPOColetTot_munic_22_pol.fid-703dc0a5_191866d88cb_-147b,2507101,Itapororoca - PB,10320,12154,1834,18376,56.16,66.14,9.98
sidra_9541_PercMoradDPPOColetTot_munic_22_pol.fid-703dc0a5_191866d88cb_-147a,2513208,Santa Cruz - PB,4542,4601,59,5945,76.4,77.39,0.99
sidra_9541_PercMoradDPPOColetTot_munic_22_pol.fid-703dc0a5_191866d88cb_-1479,2513307,Santa Helena - PB,4314,4318,4,5855,73.68,73.75,0.07
sidra_9541_PercMoradDPPOColetTot_munic_22_pol.fid-703dc0a5_191866d88cb_-1478,2507200,Itatuba - PB,7703,7979,276,10459,73.65,76.29,2.64
sidra_9541_PercMoradDPPOColetTot_munic_22_pol.fid-703dc0a5_191866d88cb_-1477,2507309,Jacaraú - PB,10181,10427,246,14449,70.46,72.16,1.7
sidra_9541_PercMoradDPPOColetTot_munic_22_pol.fid-703dc0a5_191866d88cb_-1476,2507408,Jericó - PB,5275,6162,887,7505,70.29,82.11,11.82
sidra_9541_PercMoradDPPOColetTot_munic_22_pol.fid-703dc0a5_191866d88cb_-1475,2507507,João Pessoa - PB,783944,822718,38774,828564,94.61,99.29,4.68
sidra_9541_PercMoradDPPOColetTot_munic_22_pol.fid-703dc0a5_191866d88cb_-1474,2507606,Juarez Távora - PB,5088,5997,909,7794,65.28,76.94,11.66
sidra_9541_PercMoradDPPOColetTot_munic_22_pol.fid-703dc0a5_191866d88cb_-1473,4302253,Boa Vista do Sul - RS,2581,2711,130,2774,93.04,97.73,4.69
sidra_9541_PercMoradDPPOColetTot_munic_22_pol.fid-703dc0a5_191866d88cb_-1472,4302303,Bom Jesus - RS,5361,9835,4474,11160,48.04,88.13,40.09
sidra_9541_PercMoradDPPOColetTot_munic_22_pol.fid-703dc0a5_191866d88cb_-1471,4302352,Bom Princípio - RS,12460,13030,570,13085,95.22,99.58,4.36
sidra_9541_PercMoradDPPOColetTot_munic_22_pol.fid-703dc0a5_191866d88cb_-1470,2507705,Juazeirinho - PB,8745,9731,986,16999,51.44,57.24,5.8
sidra_9541_PercMoradDPPOColetTot_munic_22_pol.fid-703dc0a5_191866d88cb_-146f,2507804,Junco do Seridó - PB,1920,5052,3132,6783,28.31,74.48,46.17
sidra_9541_PercMoradDPPOColetTot_munic_22_pol.fid-703dc0a5_191866d88cb_-146e,2507903,Juripiranga - PB,9484,9666,182,9999,94.85,96.67,1.82
sidra_9541_PercMoradDPPOColetTot_munic_22_pol.fid-703dc0a5_191866d88cb_-146d,2508000,Juru - PB,4798,5835,1037,9229,51.99,63.22,11.24
sidra_9541_PercMoradDPPOColetTot_munic_22_pol.fid-703dc0a5_191866d88cb_-146c,2508109,Lagoa - PB,2608,2715,107,4384,59.49,61.93,2.44
sidra_9541_PercMoradDPPOColetTot_munic_22_pol.fid-703dc0a5_191866d88cb_-146b,2508208,Lagoa de Dentro - PB,5771,5809,38,7812,73.87,74.36,0.49
sidra_9541_PercMoradDPPOColetTot_munic_22_pol.fid-703dc0a5_191866d88cb_-146a,2508307,Lagoa Seca - PB,19433,21802,2369,27623,70.35,78.93,8.58
sidra_9541_PercMoradDPPOColetTot_munic_22_pol.fid-703dc0a5_191866d88cb_-1469,2508406,Lastro - PB,1748,2318,570,3150,55.49,73.59,18.1
sidra_9541_PercMoradDPPOColetTot_munic_22_pol.fid-703dc0a5_191866d88cb_-1468,2508505,Livramento - PB,2357,3766,1409,6877,34.27,54.76,20.49
sidra_9541_PercMoradDPPOColetTot_munic_22_pol.fid-703dc0a5_191866d88cb_-1467,2508703,Mãe d'Água - PB,2465,2468,3,3583,68.8,68.88,0.08
sidra_9541_PercMoradDPPOColetTot_munic_22_pol.fid-703dc0a5_191866d88cb_-1466,2508802,Malta - PB,5369,5378,9,5998,89.51,89.66,0.15
sidra_9541_PercMoradDPPOColetTot_munic_22_pol.fid-703dc0a5_191866d88cb_-1465,2508901,Mamanguape - PB,39856,40187,331,44549,89.47,90.21,0.74
sidra_9541_PercMoradDPPOColetTot_munic_22_pol.fid-703dc0a5_191866d88cb_-1464,2509008,Manaíra - PB,6599,6612,13,10434,63.25,63.37,0.12
sidra_9541_PercMoradDPPOColetTot_munic_22_pol.fid-703dc0a5_191866d88cb_-1463,2509057,Marcação - PB,4134,4359,225,8999,45.94,48.44,2.5
sidra_9541_PercMoradDPPOColetTot_munic_22_pol.fid-703dc0a5_191866d88cb_-1462,2509107,Mari - PB,18678,18775,97,21372,87.39,87.85,0.45
sidra_9541_PercMoradDPPOColetTot_munic_22_pol.fid-703dc0a5_191866d88cb_-1461,2509156,Marizópolis - PB,4710,6009,1299,6701,70.29,89.67,19.39
sidra_9541_PercMoradDPPOColetTot_munic_22_pol.fid-703dc0a5_191866d88cb_-1460,2509206,Massaranduba - PB,8152,9330,1178,14137,57.66,66,8.33
sidra_9541_PercMoradDPPOColetTot_munic_22_pol.fid-703dc0a5_191866d88cb_-145f,2509305,Mataraca - PB,6702,7500,798,8223,81.5,91.21,9.7
sidra_9541_PercMoradDPPOColetTot_munic_22_pol.fid-703dc0a5_191866d88cb_-145e,2509339,Matinhas - PB,324,1105,781,4571,7.09,24.17,17.09
sidra_9541_PercMoradDPPOColetTot_munic_22_pol.fid-703dc0a5_191866d88cb_-145d,2509370,Mato Grosso - PB,1355,1417,62,2540,53.35,55.79,2.44
sidra_9541_PercMoradDPPOColetTot_munic_22_pol.fid-703dc0a5_191866d88cb_-145c,2509396,Maturéia - PB,4746,4791,45,6429,73.82,74.52,0.7
sidra_9541_PercMoradDPPOColetTot_munic_22_pol.fid-703dc0a5_191866d88cb_-145b,2509404,Mogeiro - PB,9026,9355,329,13897,64.95,67.32,2.37
sidra_9541_PercMoradDPPOColetTot_munic_22_pol.fid-703dc0a5_191866d88cb_-145a,2904209,Botuporã - BA,5206,5664,458,11020,47.24,51.4,4.16
sidra_9541_PercMoradDPPOColetTot_munic_22_pol.fid-703dc0a5_191866d88cb_-1459,2509503,Montadas - PB,4623,4996,373,5811,79.56,85.97,6.42
sidra_9541_PercMoradDPPOColetTot_munic_22_pol.fid-703dc0a5_191866d88cb_-1458,2509602,Monte Horebe - PB,2682,2711,29,4313,62.18,62.86,0.67
sidra_9541_PercMoradDPPOColetTot_munic_22_pol.fid-703dc0a5_191866d88cb_-1457,2509701,Monteiro - PB,18943,21358,2415,32139,58.94,66.46,7.51
sidra_9541_PercMoradDPPOColetTot_munic_22_pol.fid-703dc0a5_191866d88cb_-1456,2509800,Mulungu - PB,5706,5814,108,8775,65.03,66.26,1.23
sidra_9541_PercMoradDPPOColetTot_munic_22_pol.fid-703dc0a5_191866d88cb_-1455,2509909,Natuba - PB,4478,5273,795,8943,50.07,58.96,8.89
sidra_9541_PercMoradDPPOColetTot_munic_22_pol.fid-703dc0a5_191866d88cb_-1454,2510006,Nazarezinho - PB,3621,3726,105,7202,50.28,51.74,1.46
sidra_9541_PercMoradDPPOColetTot_munic_22_pol.fid-703dc0a5_191866d88cb_-1453,2510105,Nova Floresta - PB,8108,9040,932,9712,83.48,93.08,9.6
sidra_9541_PercMoradDPPOColetTot_munic_22_pol.fid-703dc0a5_191866d88cb_-1452,2510204,Nova Olinda - PB,3609,3663,54,5787,62.36,63.3,0.93
sidra_9541_PercMoradDPPOColetTot_munic_22_pol.fid-703dc0a5_191866d88cb_-1451,2510303,Nova Palmeira - PB,2618,2894,276,4250,61.6,68.09,6.49
sidra_9541_PercMoradDPPOColetTot_munic_22_pol.fid-703dc0a5_191866d88cb_-1450,2510402,Olho d'Água - PB,3713,3752,39,6060,61.27,61.91,0.64
sidra_9541_PercMoradDPPOColetTot_munic_22_pol.fid-703dc0a5_191866d88cb_-144f,2904308,Brejões - BA,7461,9517,2056,12900,57.84,73.78,15.94
sidra_9541_PercMoradDPPOColetTot_munic_22_pol.fid-703dc0a5_191866d88cb_-144e,2904407,Brejolândia - BA,3208,3280,72,9100,35.25,36.04,0.79
sidra_9541_PercMoradDPPOColetTot_munic_22_pol.fid-703dc0a5_191866d88cb_-144d,2904506,Brotas de Macaúbas - BA,6510,7125,615,11725,55.52,60.77,5.25
sidra_9541_PercMoradDPPOColetTot_munic_22_pol.fid-703dc0a5_191866d88cb_-144c,2904605,Brumado - BA,53729,54951,1222,70462,76.25,77.99,1.73
sidra_9541_PercMoradDPPOColetTot_munic_22_pol.fid-703dc0a5_191866d88cb_-144b,2904704,Buerarema - BA,12842,13016,174,14771,86.94,88.12,1.18
sidra_9541_PercMoradDPPOColetTot_munic_22_pol.fid-703dc0a5_191866d88cb_-144a,2904753,Buritirama - BA,8253,8257,4,19576,42.16,42.18,0.02
sidra_9541_PercMoradDPPOColetTot_munic_22_pol.fid-703dc0a5_191866d88cb_-1449,2904803,Caatiba - BA,4617,4623,6,6189,74.6,74.7,0.1
sidra_9541_PercMoradDPPOColetTot_munic_22_pol.fid-703dc0a5_191866d88cb_-1448,2904852,Cabaceiras do Paraguaçu - BA,7214,8972,1758,16529,43.64,54.28,10.64
sidra_9541_PercMoradDPPOColetTot_munic_22_pol.fid-703dc0a5_191866d88cb_-1447,2904902,Cachoeira - BA,15050,23918,8868,29182,51.57,81.96,30.39
sidra_9541_PercMoradDPPOColetTot_munic_22_pol.fid-703dc0a5_191866d88cb_-1446,2905008,Caculé - BA,14068,15686,1618,22428,62.73,69.94,7.21
sidra_9541_PercMoradDPPOColetTot_munic_22_pol.fid-703dc0a5_191866d88cb_-1445,2905107,Caém - BA,6845,7005,160,10374,65.98,67.52,1.54
sidra_9541_PercMoradDPPOColetTot_munic_22_pol.fid-703dc0a5_191866d88cb_-1444,2510501,Olivedos - PB,1133,2169,1036,3580,31.65,60.59,28.94
sidra_9541_PercMoradDPPOColetTot_munic_22_pol.fid-703dc0a5_191866d88cb_-1443,2510600,Ouro Velho - PB,2053,2076,23,2918,70.36,71.14,0.79
sidra_9541_PercMoradDPPOColetTot_munic_22_pol.fid-703dc0a5_191866d88cb_-1442,2510659,Parari - PB,1,881,880,1720,0.06,51.22,51.16
sidra_9541_PercMoradDPPOColetTot_munic_22_pol.fid-703dc0a5_191866d88cb_-1441,2510709,Passagem - PB,2016,2025,9,2463,81.85,82.22,0.37
sidra_9541_PercMoradDPPOColetTot_munic_22_pol.fid-703dc0a5_191866d88cb_-1440,2510808,Patos - PB,91355,97083,5728,102435,89.18,94.78,5.59
sidra_9541_PercMoradDPPOColetTot_munic_22_pol.fid-703dc0a5_191866d88cb_-143f,2905156,Caetanos - BA,3208,3496,288,11243,28.53,31.09,2.56
sidra_9541_PercMoradDPPOColetTot_munic_22_pol.fid-703dc0a5_191866d88cb_-143e,2905206,Caetité - BA,28166,33367,5201,51887,54.28,64.31,10.02
sidra_9541_PercMoradDPPOColetTot_munic_22_pol.fid-703dc0a5_191866d88cb_-143d,2510907,Paulista - PB,5190,6882,1692,11821,43.9,58.22,14.31
sidra_9541_PercMoradDPPOColetTot_munic_22_pol.fid-703dc0a5_191866d88cb_-143c,2511004,Pedra Branca - PB,2560,2563,3,3733,68.58,68.66,0.08
sidra_9541_PercMoradDPPOColetTot_munic_22_pol.fid-703dc0a5_191866d88cb_-143b,2511103,Pedra Lavrada - PB,3046,3096,50,6841,44.53,45.26,0.73
sidra_9541_PercMoradDPPOColetTot_munic_22_pol.fid-703dc0a5_191866d88cb_-143a,2906873,Capim Grosso - BA,25988,29201,3213,33212,78.25,87.92,9.67
sidra_9541_PercMoradDPPOColetTot_munic_22_pol.fid-703dc0a5_191866d88cb_-1439,2906899,Caraíbas - BA,3032,3346,314,9914,30.58,33.75,3.17
sidra_9541_PercMoradDPPOColetTot_munic_22_pol.fid-703dc0a5_191866d88cb_-1438,2906907,Caravelas - BA,16414,16601,187,20496,80.08,81,0.91
sidra_9541_PercMoradDPPOColetTot_munic_22_pol.fid-703dc0a5_191866d88cb_-1437,2907004,Cardeal da Silva - BA,6075,6672,597,8353,72.73,79.88,7.15
sidra_9541_PercMoradDPPOColetTot_munic_22_pol.fid-703dc0a5_191866d88cb_-1436,2907103,Carinhanha - BA,18498,18842,344,28808,64.21,65.41,1.19
sidra_9541_PercMoradDPPOColetTot_munic_22_pol.fid-703dc0a5_191866d88cb_-1435,2907202,Casa Nova - BA,46404,47847,1443,72040,64.41,66.42,2
sidra_9541_PercMoradDPPOColetTot_munic_22_pol.fid-703dc0a5_191866d88cb_-1434,2907301,Castro Alves - BA,14328,16173,1845,24673,58.07,65.55,7.48
sidra_9541_PercMoradDPPOColetTot_munic_22_pol.fid-703dc0a5_191866d88cb_-1433,2907400,Catolândia - BA,1369,1403,34,3430,39.91,40.9,0.99
sidra_9541_PercMoradDPPOColetTot_munic_22_pol.fid-703dc0a5_191866d88cb_-1432,2907509,Catu - BA,39696,43153,3457,48122,82.49,89.67,7.18
sidra_9541_PercMoradDPPOColetTot_munic_22_pol.fid-703dc0a5_191866d88cb_-1431,2907558,Caturama - BA,3276,3809,533,8812,37.18,43.23,6.05
sidra_9541_PercMoradDPPOColetTot_munic_22_pol.fid-703dc0a5_191866d88cb_-1430,2511202,Pedras de Fogo - PB,20875,21744,869,29574,70.59,73.52,2.94
sidra_9541_PercMoradDPPOColetTot_munic_22_pol.fid-703dc0a5_191866d88cb_-142f,2511301,Piancó - PB,10616,11484,868,16399,64.74,70.03,5.29
sidra_9541_PercMoradDPPOColetTot_munic_22_pol.fid-703dc0a5_191866d88cb_-142e,2511707,Pilõezinhos - PB,2498,3553,1055,5329,46.88,66.67,19.8
sidra_9541_PercMoradDPPOColetTot_munic_22_pol.fid-703dc0a5_191866d88cb_-142d,2511806,Pirpirituba - PB,7479,7541,62,9337,80.1,80.76,0.66
sidra_9541_PercMoradDPPOColetTot_munic_22_pol.fid-703dc0a5_191866d88cb_-142c,2511905,Pitimbu - PB,13709,13985,276,16744,81.87,83.52,1.65
sidra_9541_PercMoradDPPOColetTot_munic_22_pol.fid-703dc0a5_191866d88cb_-142b,2512002,Pocinhos - PB,11931,11982,51,17463,68.32,68.61,0.29
sidra_9541_PercMoradDPPOColetTot_munic_22_pol.fid-703dc0a5_191866d88cb_-142a,2705903,Olho d'Água Grande - AL,2811,2827,16,4329,64.93,65.3,0.37
sidra_9541_PercMoradDPPOColetTot_munic_22_pol.fid-703dc0a5_191866d88cb_-1429,2908606,Conde - BA,16279,18013,1734,23571,69.06,76.42,7.36
sidra_9541_PercMoradDPPOColetTot_munic_22_pol.fid-703dc0a5_191866d88cb_-1428,2908705,Condeúba - BA,6899,8309,1410,17047,40.47,48.74,8.27
sidra_9541_PercMoradDPPOColetTot_munic_22_pol.fid-703dc0a5_191866d88cb_-1427,2512036,Poço Dantas - PB,2323,2551,228,3830,60.65,66.61,5.95
sidra_9541_PercMoradDPPOColetTot_munic_22_pol.fid-703dc0a5_191866d88cb_-1426,2513505,Santana de Mangueira - PB,2351,2354,3,5003,46.99,47.05,0.06
sidra_9541_PercMoradDPPOColetTot_munic_22_pol.fid-703dc0a5_191866d88cb_-1425,2512077,Poço de José de Moura - PB,2620,2633,13,4006,65.4,65.73,0.32
sidra_9541_PercMoradDPPOColetTot_munic_22_pol.fid-703dc0a5_191866d88cb_-1424,2512101,Pombal - PB,26885,27062,177,32402,82.97,83.52,0.55
sidra_9541_PercMoradDPPOColetTot_munic_22_pol.fid-703dc0a5_191866d88cb_-1423,2513604,Santana dos Garrotes - PB,3559,3993,434,6567,54.2,60.8,6.61
sidra_9541_PercMoradDPPOColetTot_munic_22_pol.fid-703dc0a5_191866d88cb_-1422,2513653,Joca Claudino - PB,2393,2393,,2539,94.25,94.25,
sidra_9541_PercMoradDPPOColetTot_munic_22_pol.fid-703dc0a5_191866d88cb_-1421,2513703,Santa Rita - PB,141262,142102,840,149240,94.65,95.22,0.56
sidra_9541_PercMoradDPPOColetTot_munic_22_pol.fid-703dc0a5_191866d88cb_-1420,2908804,Contendas do Sincorá - BA,2741,2937,196,4327,63.35,67.88,4.53
sidra_9541_PercMoradDPPOColetTot_munic_22_pol.fid-703dc0a5_191866d88cb_-141f,2908903,Coração de Maria - BA,12802,13171,369,26656,48.03,49.41,1.38
sidra_9541_PercMoradDPPOColetTot_munic_22_pol.fid-703dc0a5_191866d88cb_-141e,2909000,Cordeiros - BA,3301,3429,128,7546,43.75,45.44,1.7
sidra_9541_PercMoradDPPOColetTot_munic_22_pol.fid-703dc0a5_191866d88cb_-141d,2909109,Coribe - BA,7795,9357,1562,13961,55.83,67.02,11.19
sidra_9541_PercMoradDPPOColetTot_munic_22_pol.fid-703dc0a5_191866d88cb_-141c,2909208,Coronel João Sá - BA,9382,10245,863,17047,55.04,60.1,5.06
sidra_9541_PercMoradDPPOColetTot_munic_22_pol.fid-703dc0a5_191866d88cb_-141b,2909307,Correntina - BA,17406,19452,2046,32401,53.72,60.04,6.31
sidra_9541_PercMoradDPPOColetTot_munic_22_pol.fid-703dc0a5_191866d88cb_-141a,2909406,Cotegipe - BA,6711,7244,533,13040,51.46,55.55,4.09
sidra_9541_PercMoradDPPOColetTot_munic_22_pol.fid-703dc0a5_191866d88cb_-1419,2512200,Prata - PB,2602,2705,103,3907,66.6,69.23,2.64
sidra_9541_PercMoradDPPOColetTot_munic_22_pol.fid-703dc0a5_191866d88cb_-1418,2512309,Princesa Isabel - PB,17475,17563,88,21060,82.98,83.4,0.42
sidra_9541_PercMoradDPPOColetTot_munic_22_pol.fid-703dc0a5_191866d88cb_-1417,2512408,Puxinanã - PB,10682,10927,245,14213,75.16,76.88,1.72
sidra_9541_PercMoradDPPOColetTot_munic_22_pol.fid-703dc0a5_191866d88cb_-1416,2512507,Queimadas - PB,39601,40666,1065,47617,83.17,85.4,2.24
sidra_9541_PercMoradDPPOColetTot_munic_22_pol.fid-703dc0a5_191866d88cb_-1415,2512606,Quixaba - PB,1070,1073,3,1737,61.6,61.77,0.17
sidra_9541_PercMoradDPPOColetTot_munic_22_pol.fid-703dc0a5_191866d88cb_-1414,2512705,Remígio - PB,12820,14937,2117,17796,72.04,83.93,11.9
sidra_9541_PercMoradDPPOColetTot_munic_22_pol.fid-703dc0a5_191866d88cb_-1413,2512721,Pedro Régis - PB,3528,3565,37,5763,61.22,61.86,0.64
sidra_9541_PercMoradDPPOColetTot_munic_22_pol.fid-703dc0a5_191866d88cb_-1412,2512747,Riachão - PB,1518,1707,189,2927,51.86,58.32,6.46
sidra_9541_PercMoradDPPOColetTot_munic_22_pol.fid-703dc0a5_191866d88cb_-1411,2909505,Cravolândia - BA,1423,3702,2279,4415,32.23,83.85,51.62
sidra_9541_PercMoradDPPOColetTot_munic_22_pol.fid-703dc0a5_191866d88cb_-1410,2909604,Crisópolis - BA,12372,13411,1039,19692,62.83,68.1,5.28
sidra_9541_PercMoradDPPOColetTot_munic_22_pol.fid-703dc0a5_191866d88cb_-140f,2909703,Cristópolis - BA,6723,7049,326,13978,48.1,50.43,2.33
sidra_9541_PercMoradDPPOColetTot_munic_22_pol.fid-703dc0a5_191866d88cb_-140e,2909802,Cruz das Almas - BA,54779,55725,946,60257,90.91,92.48,1.57
sidra_9541_PercMoradDPPOColetTot_munic_22_pol.fid-703dc0a5_191866d88cb_-140d,2909901,Curaçá - BA,19870,20912,1042,34149,58.19,61.24,3.05
sidra_9541_PercMoradDPPOColetTot_munic_22_pol.fid-703dc0a5_191866d88cb_-140c,2910008,Dário Meira - BA,6810,7643,833,10805,63.03,70.74,7.71
sidra_9541_PercMoradDPPOColetTot_munic_22_pol.fid-703dc0a5_191866d88cb_-140b,2910057,Dias d'Ávila - BA,58474,65439,6965,71279,82.04,91.81,9.77
sidra_9541_PercMoradDPPOColetTot_munic_22_pol.fid-703dc0a5_191866d88cb_-140a,2910107,Dom Basílio - BA,6320,7931,1611,11878,53.21,66.77,13.56
sidra_9541_PercMoradDPPOColetTot_munic_22_pol.fid-703dc0a5_191866d88cb_-1409,2910206,Dom Macedo Costa - BA,1048,2806,1758,4405,23.79,63.7,39.91
sidra_9541_PercMoradDPPOColetTot_munic_22_pol.fid-703dc0a5_191866d88cb_-1408,2910305,Elísio Medrado - BA,6008,6152,144,7797,77.06,78.9,1.85
sidra_9541_PercMoradDPPOColetTot_munic_22_pol.fid-703dc0a5_191866d88cb_-1407,2910404,Encruzilhada - BA,11492,13291,1799,19081,60.23,69.66,9.43
sidra_9541_PercMoradDPPOColetTot_munic_22_pol.fid-703dc0a5_191866d88cb_-1406,2910503,Entre Rios - BA,29841,32110,2269,37860,78.82,84.81,5.99
sidra_9541_PercMoradDPPOColetTot_munic_22_pol.fid-703dc0a5_191866d88cb_-1405,2910602,Esplanada - BA,25633,28118,2485,32519,78.82,86.47,7.64
sidra_9541_PercMoradDPPOColetTot_munic_22_pol.fid-703dc0a5_191866d88cb_-1404,2512754,Riachão do Bacamarte - PB,3591,3650,59,4690,76.57,77.83,1.26
sidra_9541_PercMoradDPPOColetTot_munic_22_pol.fid-703dc0a5_191866d88cb_-1403,2512762,Riachão do Poço - PB,2382,2386,4,4737,50.28,50.37,0.08
sidra_9541_PercMoradDPPOColetTot_munic_22_pol.fid-703dc0a5_191866d88cb_-1402,2512788,Riacho de Santo Antônio - PB,1524,1524,,1946,78.31,78.31,
sidra_9541_PercMoradDPPOColetTot_munic_22_pol.fid-703dc0a5_191866d88cb_-1401,2512804,Riacho dos Cavalos - PB,4331,4950,619,8491,51.01,58.3,7.29
sidra_9541_PercMoradDPPOColetTot_munic_22_pol.fid-703dc0a5_191866d88cb_-1400,2512903,Rio Tinto - PB,15971,17892,1921,24546,65.07,72.89,7.83
sidra_9541_PercMoradDPPOColetTot_munic_22_pol.fid-703dc0a5_191866d88cb_-13ff,2513000,Salgadinho - PB,1689,1889,200,3355,50.34,56.3,5.96
sidra_9541_PercMoradDPPOColetTot_munic_22_pol.fid-703dc0a5_191866d88cb_-13fe,2513109,Salgado de São Félix - PB,6720,6845,125,11492,58.48,59.56,1.09
sidra_9541_PercMoradDPPOColetTot_munic_22_pol.fid-703dc0a5_191866d88cb_-13fd,2513158,Santa Cecília - PB,4018,4147,129,7664,52.43,54.11,1.68
sidra_9541_PercMoradDPPOColetTot_munic_22_pol.fid-703dc0a5_191866d88cb_-13fc,2910701,Euclides da Cunha - BA,45287,51117,5830,61361,73.8,83.31,9.5
sidra_9541_PercMoradDPPOColetTot_munic_22_pol.fid-703dc0a5_191866d88cb_-13fb,2910727,Eunápolis - BA,105105,106959,1854,113177,92.87,94.51,1.64
sidra_9541_PercMoradDPPOColetTot_munic_22_pol.fid-703dc0a5_191866d88cb_-13fa,2910750,Fátima - BA,14054,16021,1967,17894,78.54,89.53,10.99
sidra_9541_PercMoradDPPOColetTot_munic_22_pol.fid-703dc0a5_191866d88cb_-13f9,2910776,Feira da Mata - BA,3527,3557,30,5625,62.7,63.24,0.53
sidra_9541_PercMoradDPPOColetTot_munic_22_pol.fid-703dc0a5_191866d88cb_-13f8,2910800,Feira de Santana - BA,563204,589763,26559,614310,91.68,96,4.32
sidra_9541_PercMoradDPPOColetTot_munic_22_pol.fid-703dc0a5_191866d88cb_-13f7,2910859,Filadélfia - BA,10127,13636,3509,17895,56.59,76.2,19.61
sidra_9541_PercMoradDPPOColetTot_munic_22_pol.fid-703dc0a5_191866d88cb_-13f6,2513356,Santa Inês - PB,459,1592,1133,3221,14.25,49.43,35.18
sidra_9541_PercMoradDPPOColetTot_munic_22_pol.fid-703dc0a5_191866d88cb_-13f5,2513406,Santa Luzia - PB,13263,13357,94,14899,89.02,89.65,0.63
sidra_9541_PercMoradDPPOColetTot_munic_22_pol.fid-703dc0a5_191866d88cb_-13f4,2913705,Inhambupe - BA,17399,23108,5709,33745,51.56,68.48,16.92
sidra_9541_PercMoradDPPOColetTot_munic_22_pol.fid-703dc0a5_191866d88cb_-13f3,2913804,Ipecaetá - BA,472,4960,4488,13694,3.45,36.22,32.77
sidra_9541_PercMoradDPPOColetTot_munic_22_pol.fid-703dc0a5_191866d88cb_-13f2,2913903,Ipiaú - BA,37227,38398,1171,40553,91.8,94.69,2.89
sidra_9541_PercMoradDPPOColetTot_munic_22_pol.fid-703dc0a5_191866d88cb_-13f1,2914000,Ipirá - BA,38519,39558,1039,56832,67.78,69.61,1.83
sidra_9541_PercMoradDPPOColetTot_munic_22_pol.fid-703dc0a5_191866d88cb_-13f0,2513802,Santa Teresinha - PB,2661,2679,18,4401,60.46,60.87,0.41
sidra_9541_PercMoradDPPOColetTot_munic_22_pol.fid-703dc0a5_191866d88cb_-13ef,2513851,Santo André - PB,1152,1224,72,2620,43.97,46.72,2.75
sidra_9541_PercMoradDPPOColetTot_munic_22_pol.fid-703dc0a5_191866d88cb_-13ee,2513901,São Bento - PB,27814,28913,1099,32200,86.38,89.79,3.41
sidra_9541_PercMoradDPPOColetTot_munic_22_pol.fid-703dc0a5_191866d88cb_-13ed,2513927,São Bentinho - PB,3220,3228,8,4327,74.42,74.6,0.18
sidra_9541_PercMoradDPPOColetTot_munic_22_pol.fid-703dc0a5_191866d88cb_-13ec,2513943,São Domingos do Cariri - PB,1451,1454,3,2585,56.13,56.25,0.12
sidra_9541_PercMoradDPPOColetTot_munic_22_pol.fid-703dc0a5_191866d88cb_-13eb,2513968,São Domingos - PB,1161,1161,,2593,44.77,44.77,
sidra_9541_PercMoradDPPOColetTot_munic_22_pol.fid-703dc0a5_191866d88cb_-13ea,2514404,São José de Espinharas - PB,847,1706,859,4067,20.83,41.95,21.12
sidra_9541_PercMoradDPPOColetTot_munic_22_pol.fid-703dc0a5_191866d88cb_-13e9,2513984,São Francisco - PB,2865,2865,,3137,91.33,91.33,
sidra_9541_PercMoradDPPOColetTot_munic_22_pol.fid-703dc0a5_191866d88cb_-13e8,2514008,São João do Cariri - PB,928,2918,1990,4194,22.13,69.58,47.45
sidra_9541_PercMoradDPPOColetTot_munic_22_pol.fid-703dc0a5_191866d88cb_-13e7,2514107,São João do Tigre - PB,940,2011,1071,4260,22.07,47.21,25.14
sidra_9541_PercMoradDPPOColetTot_munic_22_pol.fid-703dc0a5_191866d88cb_-13e6,2514453,São José dos Ramos - PB,3037,3194,157,5877,51.68,54.35,2.67
sidra_9541_PercMoradDPPOColetTot_munic_22_pol.fid-703dc0a5_191866d88cb_-13e5,2514503,São José de Piranhas - PB,14252,14784,532,18998,75.02,77.82,2.8
sidra_9541_PercMoradDPPOColetTot_munic_22_pol.fid-703dc0a5_191866d88cb_-13e4,2514552,São José de Princesa - PB,204,833,629,3413,5.98,24.41,18.43
sidra_9541_PercMoradDPPOColetTot_munic_22_pol.fid-703dc0a5_191866d88cb_-13e3,2514602,São José do Bonfim - PB,1906,1915,9,3241,58.81,59.09,0.28
sidra_9541_PercMoradDPPOColetTot_munic_22_pol.fid-703dc0a5_191866d88cb_-13e2,2514651,São José do Brejo do Cruz - PB,595,1371,776,1696,35.08,80.84,45.75
sidra_9541_PercMoradDPPOColetTot_munic_22_pol.fid-703dc0a5_191866d88cb_-13e1,2914109,Ipupiara - BA,6948,7531,583,9932,69.96,75.83,5.87
sidra_9541_PercMoradDPPOColetTot_munic_22_pol.fid-703dc0a5_191866d88cb_-13e0,2914208,Irajuba - BA,4116,4941,825,6090,67.59,81.13,13.55
sidra_9541_PercMoradDPPOColetTot_munic_22_pol.fid-703dc0a5_191866d88cb_-13df,2914307,Iramaia - BA,5903,5970,67,10730,55.01,55.64,0.62
sidra_9541_PercMoradDPPOColetTot_munic_22_pol.fid-703dc0a5_191866d88cb_-13de,2914406,Iraquara - BA,12255,14509,2254,23848,51.39,60.84,9.45
sidra_9541_PercMoradDPPOColetTot_munic_22_pol.fid-703dc0a5_191866d88cb_-13dd,2914505,Irará - BA,13414,15545,2131,27985,47.93,55.55,7.61
sidra_9541_PercMoradDPPOColetTot_munic_22_pol.fid-703dc0a5_191866d88cb_-13dc,2914604,Irecê - BA,69658,73559,3901,74348,93.69,98.94,5.25
sidra_9541_PercMoradDPPOColetTot_munic_22_pol.fid-703dc0a5_191866d88cb_-13db,2914653,Itabela - BA,22357,24825,2468,28079,79.62,88.41,8.79
sidra_9541_PercMoradDPPOColetTot_munic_22_pol.fid-703dc0a5_191866d88cb_-13da,2914703,Itaberaba - BA,53424,56622,3198,64926,82.28,87.21,4.93
sidra_9541_PercMoradDPPOColetTot_munic_22_pol.fid-703dc0a5_191866d88cb_-13d9,2914802,Itabuna - BA,159190,174675,15485,185314,85.9,94.26,8.36
sidra_9541_PercMoradDPPOColetTot_munic_22_pol.fid-703dc0a5_191866d88cb_-13d8,2914901,Itacaré - BA,15020,20691,5671,27451,54.72,75.37,20.66
sidra_9541_PercMoradDPPOColetTot_munic_22_pol.fid-703dc0a5_191866d88cb_-13d7,2915007,Itaeté - BA,9782,10405,623,13455,72.7,77.33,4.63
sidra_9541_PercMoradDPPOColetTot_munic_22_pol.fid-703dc0a5_191866d88cb_-13d6,2915106,Itagi - BA,9869,10607,738,13778,71.63,76.99,5.36
sidra_9541_PercMoradDPPOColetTot_munic_22_pol.fid-703dc0a5_191866d88cb_-13d5,2915205,Itagibá - BA,11661,12930,1269,15284,76.3,84.6,8.3
sidra_9541_PercMoradDPPOColetTot_munic_22_pol.fid-703dc0a5_191866d88cb_-13d4,2915304,Itagimirim - BA,4384,5453,1069,6324,69.32,86.23,16.9
sidra_9541_PercMoradDPPOColetTot_munic_22_pol.fid-703dc0a5_191866d88cb_-13d3,2915353,Itaguaçu da Bahia - BA,7076,7211,135,12282,57.61,58.71,1.1
sidra_9541_PercMoradDPPOColetTot_munic_22_pol.fid-703dc0a5_191866d88cb_-13d2,2915403,Itaju do Colônia - BA,4909,4972,63,6034,81.36,82.4,1.04
sidra_9541_PercMoradDPPOColetTot_munic_22_pol.fid-703dc0a5_191866d88cb_-13d1,2915502,Itajuípe - BA,16837,17118,281,18768,89.71,91.21,1.5
sidra_9541_PercMoradDPPOColetTot_munic_22_pol.fid-703dc0a5_191866d88cb_-13d0,2915601,Itamaraju - BA,47770,50710,2940,59498,80.29,85.23,4.94
sidra_9541_PercMoradDPPOColetTot_munic_22_pol.fid-703dc0a5_191866d88cb_-13cf,2915700,Itamari - BA,4196,5600,1404,7048,59.53,79.46,19.92
sidra_9541_PercMoradDPPOColetTot_munic_22_pol.fid-703dc0a5_191866d88cb_-13ce,2915809,Itambé - BA,20733,20886,153,24328,85.22,85.85,0.63
sidra_9541_PercMoradDPPOColetTot_munic_22_pol.fid-703dc0a5_191866d88cb_-13cd,2915908,Itanagra - BA,3974,4869,895,5911,67.23,82.37,15.14
sidra_9541_PercMoradDPPOColetTot_munic_22_pol.fid-703dc0a5_191866d88cb_-13cc,2916005,Itanhém - BA,13917,14294,377,17781,78.27,80.39,2.12
sidra_9541_PercMoradDPPOColetTot_munic_22_pol.fid-703dc0a5_191866d88cb_-13cb,2514206,São José da Lagoa Tapada - PB,4223,4427,204,7122,59.3,62.16,2.86
sidra_9541_PercMoradDPPOColetTot_munic_22_pol.fid-703dc0a5_191866d88cb_-13ca,2514305,São José de Caiana - PB,2922,2939,17,5034,58.05,58.38,0.34
sidra_9541_PercMoradDPPOColetTot_munic_22_pol.fid-703dc0a5_191866d88cb_-13c9,2515609,Serra da Raiz - PB,2562,2575,13,3094,82.81,83.23,0.42
sidra_9541_PercMoradDPPOColetTot_munic_22_pol.fid-703dc0a5_191866d88cb_-13c8,2515708,Serra Grande - PB,2267,2277,10,2941,77.08,77.42,0.34
sidra_9541_PercMoradDPPOColetTot_munic_22_pol.fid-703dc0a5_191866d88cb_-13c7,2919405,Licínio de Almeida - BA,6667,6844,177,11834,56.34,57.83,1.5
sidra_9541_PercMoradDPPOColetTot_munic_22_pol.fid-703dc0a5_191866d88cb_-13c6,2919504,Livramento de Nossa Senhora - BA,24618,27559,2941,43884,56.1,62.8,6.7
sidra_9541_PercMoradDPPOColetTot_munic_22_pol.fid-703dc0a5_191866d88cb_-13c5,2919553,Luís Eduardo Magalhães - BA,102972,106669,3697,107688,95.62,99.05,3.43
sidra_9541_PercMoradDPPOColetTot_munic_22_pol.fid-703dc0a5_191866d88cb_-13c4,2919603,Macajuba - BA,5990,6752,762,10452,57.31,64.6,7.29
sidra_9541_PercMoradDPPOColetTot_munic_22_pol.fid-703dc0a5_191866d88cb_-13c3,2919702,Macarani - BA,16800,17895,1095,21571,77.88,82.96,5.08
sidra_9541_PercMoradDPPOColetTot_munic_22_pol.fid-703dc0a5_191866d88cb_-13c2,2919801,Macaúbas - BA,21607,22161,554,41763,51.74,53.06,1.33
sidra_9541_PercMoradDPPOColetTot_munic_22_pol.fid-703dc0a5_191866d88cb_-13c1,2919900,Macururé - BA,1364,2346,982,7253,18.81,32.35,13.54
sidra_9541_PercMoradDPPOColetTot_munic_22_pol.fid-703dc0a5_191866d88cb_-13c0,2514701,São José do Sabugi - PB,2799,3000,201,4129,67.79,72.66,4.87
sidra_9541_PercMoradDPPOColetTot_munic_22_pol.fid-703dc0a5_191866d88cb_-13bf,2514800,São José dos Cordeiros - PB,1784,1788,4,3411,52.3,52.42,0.12
sidra_9541_PercMoradDPPOColetTot_munic_22_pol.fid-703dc0a5_191866d88cb_-13be,2514909,São Mamede - PB,5950,6112,162,7460,79.76,81.93,2.17
sidra_9541_PercMoradDPPOColetTot_munic_22_pol.fid-703dc0a5_191866d88cb_-13bd,2515005,São Miguel de Taipu - PB,3171,3256,85,7061,44.91,46.11,1.2
sidra_9541_PercMoradDPPOColetTot_munic_22_pol.fid-703dc0a5_191866d88cb_-13bc,2515104,São Sebastião de Lagoa de Roça - PB,5273,5618,345,11026,47.82,50.95,3.13
sidra_9541_PercMoradDPPOColetTot_munic_22_pol.fid-703dc0a5_191866d88cb_-13bb,2515203,São Sebastião do Umbuzeiro - PB,1796,2303,507,3275,54.84,70.32,15.48
sidra_9541_PercMoradDPPOColetTot_munic_22_pol.fid-703dc0a5_191866d88cb_-13ba,2515302,Sapé - PB,43046,43930,884,51169,84.13,85.85,1.73
sidra_9541_PercMoradDPPOColetTot_munic_22_pol.fid-703dc0a5_191866d88cb_-13b9,2515401,São Vicente do Seridó - PB,4909,5039,130,10290,47.71,48.97,1.26
sidra_9541_PercMoradDPPOColetTot_munic_22_pol.fid-703dc0a5_191866d88cb_-13b8,2919926,Madre de Deus - BA,17501,18334,833,18406,95.08,99.61,4.53
sidra_9541_PercMoradDPPOColetTot_munic_22_pol.fid-703dc0a5_191866d88cb_-13b7,2919959,Maetinga - BA,3406,3457,51,6972,48.85,49.58,0.73
sidra_9541_PercMoradDPPOColetTot_munic_22_pol.fid-703dc0a5_191866d88cb_-13b6,2515500,Serra Branca - PB,8845,9977,1132,13543,65.31,73.67,8.36
sidra_9541_PercMoradDPPOColetTot_munic_22_pol.fid-703dc0a5_191866d88cb_-13b5,2920007,Maiquinique - BA,6810,7289,479,8730,78.01,83.49,5.49
sidra_9541_PercMoradDPPOColetTot_munic_22_pol.fid-703dc0a5_191866d88cb_-13b4,2920106,Mairi - BA,12152,13703,1551,17660,68.81,77.59,8.78
sidra_9541_PercMoradDPPOColetTot_munic_22_pol.fid-703dc0a5_191866d88cb_-13b3,2920205,Malhada - BA,8884,10473,1589,15355,57.86,68.21,10.35
sidra_9541_PercMoradDPPOColetTot_munic_22_pol.fid-703dc0a5_191866d88cb_-13b2,2920304,Malhada de Pedras - BA,3686,3735,49,8670,42.51,43.08,0.57
sidra_9541_PercMoradDPPOColetTot_munic_22_pol.fid-703dc0a5_191866d88cb_-13b1,2920403,Manoel Vitorino - BA,7109,7943,834,13856,51.31,57.33,6.02
sidra_9541_PercMoradDPPOColetTot_munic_22_pol.fid-703dc0a5_191866d88cb_-13b0,2920452,Mansidão - BA,6129,6143,14,13871,44.19,44.29,0.1
sidra_9541_PercMoradDPPOColetTot_munic_22_pol.fid-703dc0a5_191866d88cb_-13af,2920502,Maracás - BA,22010,22370,360,27582,79.8,81.1,1.31
sidra_9541_PercMoradDPPOColetTot_munic_22_pol.fid-703dc0a5_191866d88cb_-13ae,2920601,Maragogipe - BA,21322,23606,2284,35791,59.57,65.96,6.38
sidra_9541_PercMoradDPPOColetTot_munic_22_pol.fid-703dc0a5_191866d88cb_-13ad,2920700,Maraú - BA,13011,17455,4444,24459,53.2,71.36,18.17
sidra_9541_PercMoradDPPOColetTot_munic_22_pol.fid-703dc0a5_191866d88cb_-13ac,2920809,Marcionílio Souza - BA,6762,6864,102,9259,73.03,74.13,1.1
sidra_9541_PercMoradDPPOColetTot_munic_22_pol.fid-703dc0a5_191866d88cb_-13ab,2920908,Mascote - BA,11238,11617,379,13538,83.01,85.81,2.8
sidra_9541_PercMoradDPPOColetTot_munic_22_pol.fid-703dc0a5_191866d88cb_-13aa,2515807,Serra Redonda - PB,4128,4656,528,6821,60.52,68.26,7.74
sidra_9541_PercMoradDPPOColetTot_munic_22_pol.fid-703dc0a5_191866d88cb_-13a9,2515906,Serraria - PB,3317,3478,161,4882,67.94,71.24,3.3
sidra_9541_PercMoradDPPOColetTot_munic_22_pol.fid-703dc0a5_191866d88cb_-13a8,2921005,Mata de São João - BA,28379,40059,11680,42541,66.71,94.17,27.46
sidra_9541_PercMoradDPPOColetTot_munic_22_pol.fid-703dc0a5_191866d88cb_-13a7,2921054,Matina - BA,4302,4350,48,10328,41.65,42.12,0.46
sidra_9541_PercMoradDPPOColetTot_munic_22_pol.fid-703dc0a5_191866d88cb_-13a6,2921104,Medeiros Neto - BA,18054,19371,1317,22166,81.45,87.39,5.94
sidra_9541_PercMoradDPPOColetTot_munic_22_pol.fid-703dc0a5_191866d88cb_-13a5,2921203,Miguel Calmon - BA,16679,18491,1812,24619,67.75,75.11,7.36
sidra_9541_PercMoradDPPOColetTot_munic_22_pol.fid-703dc0a5_191866d88cb_-13a4,2921302,Milagres - BA,8344,8966,622,11068,75.39,81.01,5.62
sidra_9541_PercMoradDPPOColetTot_munic_22_pol.fid-703dc0a5_191866d88cb_-13a3,2921401,Mirangaba - BA,10778,13249,2471,15730,68.52,84.23,15.71
sidra_9541_PercMoradDPPOColetTot_munic_22_pol.fid-703dc0a5_191866d88cb_-13a2,2921450,Mirante - BA,3248,3317,69,10181,31.9,32.58,0.68
sidra_9541_PercMoradDPPOColetTot_munic_22_pol.fid-703dc0a5_191866d88cb_-13a1,2921500,Monte Santo - BA,13249,23960,10711,47747,27.75,50.18,22.43
sidra_9541_PercMoradDPPOColetTot_munic_22_pol.fid-703dc0a5_191866d88cb_-13a0,2921609,Morpará - BA,4924,5188,264,7976,61.74,65.05,3.31
sidra_9541_PercMoradDPPOColetTot_munic_22_pol.fid-703dc0a5_191866d88cb_-139f,2921708,Morro do Chapéu - BA,26570,26835,265,33471,79.38,80.17,0.79
sidra_9541_PercMoradDPPOColetTot_munic_22_pol.fid-703dc0a5_191866d88cb_-139e,2921807,Mortugaba - BA,6160,6332,172,11132,55.34,56.88,1.55
sidra_9541_PercMoradDPPOColetTot_munic_22_pol.fid-703dc0a5_191866d88cb_-139d,2921906,Mucugê - BA,8102,8576,474,12073,67.11,71.03,3.93
sidra_9541_PercMoradDPPOColetTot_munic_22_pol.fid-703dc0a5_191866d88cb_-139c,2922003,Mucuri - BA,33273,33811,538,37876,87.85,89.27,1.42
sidra_9541_PercMoradDPPOColetTot_munic_22_pol.fid-703dc0a5_191866d88cb_-139b,2515930,Sertãozinho - PB,4191,4251,60,5054,82.92,84.11,1.19
sidra_9541_PercMoradDPPOColetTot_munic_22_pol.fid-703dc0a5_191866d88cb_-139a,2515971,Sobrado - PB,1704,1774,70,8236,20.69,21.54,0.85
sidra_9541_PercMoradDPPOColetTot_munic_22_pol.fid-703dc0a5_191866d88cb_-1399,2516003,Solânea - PB,21446,21886,440,26675,80.4,82.05,1.65
sidra_9541_PercMoradDPPOColetTot_munic_22_pol.fid-703dc0a5_191866d88cb_-1398,2600609,Alagoinha - PE,10271,10937,666,13535,75.88,80.81,4.92
sidra_9541_PercMoradDPPOColetTot_munic_22_pol.fid-703dc0a5_191866d88cb_-1397,2600708,Aliança - PE,28683,30301,1618,35719,80.3,84.83,4.53
sidra_9541_PercMoradDPPOColetTot_munic_22_pol.fid-703dc0a5_191866d88cb_-1396,2600807,Altinho - PE,14412,14580,168,20670,69.72,70.54,0.81
sidra_9541_PercMoradDPPOColetTot_munic_22_pol.fid-703dc0a5_191866d88cb_-1395,2600906,Amaraji - PE,11611,14196,2585,18199,63.8,78,14.2
sidra_9541_PercMoradDPPOColetTot_munic_22_pol.fid-703dc0a5_191866d88cb_-1394,2516102,Soledade - PB,10436,10531,95,13877,75.2,75.89,0.68
sidra_9541_PercMoradDPPOColetTot_munic_22_pol.fid-703dc0a5_191866d88cb_-1393,2602209,Bom Jardim - PE,17206,21867,4661,37603,45.76,58.15,12.4
sidra_9541_PercMoradDPPOColetTot_munic_22_pol.fid-703dc0a5_191866d88cb_-1392,2602308,Bonito - PE,27798,30252,2454,37445,74.24,80.79,6.55
sidra_9541_PercMoradDPPOColetTot_munic_22_pol.fid-703dc0a5_191866d88cb_-1391,2922102,Mundo Novo - BA,13230,13877,647,17278,76.57,80.32,3.74
sidra_9541_PercMoradDPPOColetTot_munic_22_pol.fid-703dc0a5_191866d88cb_-1390,2922201,Muniz Ferreira - BA,5817,5984,167,7185,80.96,83.28,2.32
sidra_9541_PercMoradDPPOColetTot_munic_22_pol.fid-703dc0a5_191866d88cb_-138f,2922250,Muquém do São Francisco - BA,5468,5528,60,10440,52.38,52.95,0.57
sidra_9541_PercMoradDPPOColetTot_munic_22_pol.fid-703dc0a5_191866d88cb_-138e,2922300,Muritiba - BA,24395,25879,1484,28643,85.17,90.35,5.18
sidra_9541_PercMoradDPPOColetTot_munic_22_pol.fid-703dc0a5_191866d88cb_-138d,2922409,Mutuípe - BA,9555,11131,1576,20017,47.73,55.61,7.87
sidra_9541_PercMoradDPPOColetTot_munic_22_pol.fid-703dc0a5_191866d88cb_-138c,2922508,Nazaré - BA,21303,21950,647,26990,78.93,81.33,2.4
sidra_9541_PercMoradDPPOColetTot_munic_22_pol.fid-703dc0a5_191866d88cb_-138b,2922607,Nilo Peçanha - BA,7075,7703,628,12049,58.72,63.93,5.21
sidra_9541_PercMoradDPPOColetTot_munic_22_pol.fid-703dc0a5_191866d88cb_-138a,2922656,Nordestina - BA,3430,7777,4347,18350,18.69,42.38,23.69
sidra_9541_PercMoradDPPOColetTot_munic_22_pol.fid-703dc0a5_191866d88cb_-1389,2922706,Nova Canaã - BA,8251,9168,917,13703,60.21,66.91,6.69
sidra_9541_PercMoradDPPOColetTot_munic_22_pol.fid-703dc0a5_191866d88cb_-1388,2516151,Sossêgo - PB,2081,2099,18,3345,62.21,62.75,0.54
sidra_9541_PercMoradDPPOColetTot_munic_22_pol.fid-703dc0a5_191866d88cb_-1387,2516201,Sousa - PB,52691,57891,5200,66913,78.75,86.52,7.77
sidra_9541_PercMoradDPPOColetTot_munic_22_pol.fid-703dc0a5_191866d88cb_-1386,2516300,Sumé - PB,12918,13658,740,17109,75.5,79.83,4.33
sidra_9541_PercMoradDPPOColetTot_munic_22_pol.fid-703dc0a5_191866d88cb_-1385,2516409,Tacima - PB,4955,6470,1515,7997,61.96,80.91,18.94
sidra_9541_PercMoradDPPOColetTot_munic_22_pol.fid-703dc0a5_191866d88cb_-1384,2516508,Taperoá - PB,9365,9489,124,14063,66.59,67.47,0.88
sidra_9541_PercMoradDPPOColetTot_munic_22_pol.fid-703dc0a5_191866d88cb_-1383,2516607,Tavares - PB,9122,9775,653,14097,64.71,69.34,4.63
sidra_9541_PercMoradDPPOColetTot_munic_22_pol.fid-703dc0a5_191866d88cb_-1382,2516706,Teixeira - PB,6604,10375,3771,14589,45.27,71.12,25.85
sidra_9541_PercMoradDPPOColetTot_munic_22_pol.fid-703dc0a5_191866d88cb_-1381,2516755,Tenório - PB,2314,2323,9,2964,78.07,78.37,0.3
sidra_9541_PercMoradDPPOColetTot_munic_22_pol.fid-703dc0a5_191866d88cb_-1380,2516805,Triunfo - PB,5428,5997,569,9879,54.94,60.7,5.76
sidra_9541_PercMoradDPPOColetTot_munic_22_pol.fid-703dc0a5_191866d88cb_-137f,2602704,Buenos Aires - PE,5611,10303,4692,12801,43.83,80.49,36.65
sidra_9541_PercMoradDPPOColetTot_munic_22_pol.fid-703dc0a5_191866d88cb_-137e,2602803,Buíque - PE,21472,22976,1504,51902,41.37,44.27,2.9
sidra_9541_PercMoradDPPOColetTot_munic_22_pol.fid-703dc0a5_191866d88cb_-137d,2602902,Cabo de Santo Agostinho - PE,144276,189041,44765,202831,71.13,93.2,22.07
sidra_9541_PercMoradDPPOColetTot_munic_22_pol.fid-703dc0a5_191866d88cb_-137c,2603009,Cabrobó - PE,20028,20948,920,30264,66.18,69.22,3.04
sidra_9541_PercMoradDPPOColetTot_munic_22_pol.fid-703dc0a5_191866d88cb_-137b,2924009,Paulo Afonso - BA,101943,104862,2919,112377,90.72,93.31,2.6
sidra_9541_PercMoradDPPOColetTot_munic_22_pol.fid-703dc0a5_191866d88cb_-137a,2924058,Pé de Serra - BA,9222,9299,77,13215,69.78,70.37,0.58
sidra_9541_PercMoradDPPOColetTot_munic_22_pol.fid-703dc0a5_191866d88cb_-1379,2924108,Pedrão - BA,3201,3549,348,6232,51.36,56.95,5.58
sidra_9541_PercMoradDPPOColetTot_munic_22_pol.fid-703dc0a5_191866d88cb_-1378,2924207,Pedro Alexandre - BA,5922,6244,322,13904,42.59,44.91,2.32
sidra_9541_PercMoradDPPOColetTot_munic_22_pol.fid-703dc0a5_191866d88cb_-1377,2924306,Piatã - BA,7387,12090,4703,20040,36.86,60.33,23.47
sidra_9541_PercMoradDPPOColetTot_munic_22_pol.fid-703dc0a5_191866d88cb_-1376,2924405,Pilão Arcado - BA,14302,14486,184,35290,40.53,41.05,0.52
sidra_9541_PercMoradDPPOColetTot_munic_22_pol.fid-703dc0a5_191866d88cb_-1375,2924504,Pindaí - BA,4899,5630,731,14711,33.3,38.27,4.97
sidra_9541_PercMoradDPPOColetTot_munic_22_pol.fid-703dc0a5_191866d88cb_-1374,2516904,Uiraúna - PB,12844,13008,164,14903,86.18,87.28,1.1
sidra_9541_PercMoradDPPOColetTot_munic_22_pol.fid-703dc0a5_191866d88cb_-1373,2517001,Umbuzeiro - PB,4313,5023,710,9101,47.39,55.19,7.8
sidra_9541_PercMoradDPPOColetTot_munic_22_pol.fid-703dc0a5_191866d88cb_-1372,2517100,Várzea - PB,1557,2098,541,2665,58.42,78.72,20.3
sidra_9541_PercMoradDPPOColetTot_munic_22_pol.fid-703dc0a5_191866d88cb_-1371,2517209,Vieirópolis - PB,2134,3350,1216,4857,43.94,68.97,25.04
sidra_9541_PercMoradDPPOColetTot_munic_22_pol.fid-703dc0a5_191866d88cb_-1370,2517407,Zabelê - PB,947,1588,641,2220,42.66,71.53,28.87
sidra_9541_PercMoradDPPOColetTot_munic_22_pol.fid-703dc0a5_191866d88cb_-136f,2600054,Abreu e Lima - PE,84559,91177,6618,96683,87.46,94.31,6.85
sidra_9541_PercMoradDPPOColetTot_munic_22_pol.fid-703dc0a5_191866d88cb_-136e,2924603,Pindobaçu - BA,15219,16701,1482,19033,79.96,87.75,7.79
sidra_9541_PercMoradDPPOColetTot_munic_22_pol.fid-703dc0a5_191866d88cb_-136d,2924652,Pintadas - BA,7191,7691,500,10303,69.8,74.65,4.85
sidra_9541_PercMoradDPPOColetTot_munic_22_pol.fid-703dc0a5_191866d88cb_-136c,2924678,Piraí do Norte - BA,3252,5143,1891,10940,29.73,47.01,17.29
sidra_9541_PercMoradDPPOColetTot_munic_22_pol.fid-703dc0a5_191866d88cb_-136b,2924702,Piripá - BA,5187,5533,346,9147,56.71,60.49,3.78
sidra_9541_PercMoradDPPOColetTot_munic_22_pol.fid-703dc0a5_191866d88cb_-136a,2924801,Piritiba - BA,12404,14606,2202,17528,70.77,83.33,12.56
sidra_9541_PercMoradDPPOColetTot_munic_22_pol.fid-703dc0a5_191866d88cb_-1369,2924900,Planaltino - BA,4441,5802,1361,8002,55.5,72.51,17.01
sidra_9541_PercMoradDPPOColetTot_munic_22_pol.fid-703dc0a5_191866d88cb_-1368,2925006,Planalto - BA,18411,18505,94,23325,78.93,79.34,0.4
sidra_9541_PercMoradDPPOColetTot_munic_22_pol.fid-703dc0a5_191866d88cb_-1367,2925105,Poções - BA,37691,39258,1567,48239,78.13,81.38,3.25
sidra_9541_PercMoradDPPOColetTot_munic_22_pol.fid-703dc0a5_191866d88cb_-1366,2925204,Pojuca - BA,29416,30369,953,32115,91.6,94.56,2.97
sidra_9541_PercMoradDPPOColetTot_munic_22_pol.fid-703dc0a5_191866d88cb_-1365,2600104,Afogados da Ingazeira - PE,30700,33008,2308,40159,76.45,82.19,5.75
sidra_9541_PercMoradDPPOColetTot_munic_22_pol.fid-703dc0a5_191866d88cb_-1364,2600203,Afrânio - PE,3677,7621,3944,18641,19.73,40.88,21.16
sidra_9541_PercMoradDPPOColetTot_munic_22_pol.fid-703dc0a5_191866d88cb_-1363,2925253,Ponto Novo - BA,11578,14115,2537,17928,64.58,78.73,14.15
sidra_9541_PercMoradDPPOColetTot_munic_22_pol.fid-703dc0a5_191866d88cb_-1362,2925303,Porto Seguro - BA,142157,152134,9977,167420,84.91,90.87,5.96
sidra_9541_PercMoradDPPOColetTot_munic_22_pol.fid-703dc0a5_191866d88cb_-1361,2925402,Potiraguá - BA,9307,9400,93,10267,90.65,91.56,0.91
sidra_9541_PercMoradDPPOColetTot_munic_22_pol.fid-703dc0a5_191866d88cb_-1360,2925501,Prado - BA,22848,24193,1345,34522,66.18,70.08,3.9
sidra_9541_PercMoradDPPOColetTot_munic_22_pol.fid-703dc0a5_191866d88cb_-135f,2925600,Presidente Dutra - BA,13780,13945,165,15120,91.14,92.23,1.09
sidra_9541_PercMoradDPPOColetTot_munic_22_pol.fid-703dc0a5_191866d88cb_-135e,2925709,Presidente Jânio Quadros - BA,5311,5355,44,12618,42.09,42.44,0.35
sidra_9541_PercMoradDPPOColetTot_munic_22_pol.fid-703dc0a5_191866d88cb_-135d,2925758,Presidente Tancredo Neves - BA,12205,16104,3899,27716,44.04,58.1,14.07
sidra_9541_PercMoradDPPOColetTot_munic_22_pol.fid-703dc0a5_191866d88cb_-135c,2925808,Queimadas - BA,15663,17287,1624,25974,60.3,66.56,6.25
sidra_9541_PercMoradDPPOColetTot_munic_22_pol.fid-703dc0a5_191866d88cb_-135b,2925907,Quijingue - BA,16732,19802,3070,25268,66.22,78.37,12.15
sidra_9541_PercMoradDPPOColetTot_munic_22_pol.fid-703dc0a5_191866d88cb_-135a,2925931,Quixabeira - BA,6624,7247,623,9447,70.12,76.71,6.59
sidra_9541_PercMoradDPPOColetTot_munic_22_pol.fid-703dc0a5_191866d88cb_-1359,2600302,Agrestina - PE,21176,21469,293,23755,89.14,90.38,1.23
sidra_9541_PercMoradDPPOColetTot_munic_22_pol.fid-703dc0a5_191866d88cb_-1358,2600401,Água Preta - PE,17779,18532,753,26417,67.3,70.15,2.85
sidra_9541_PercMoradDPPOColetTot_munic_22_pol.fid-703dc0a5_191866d88cb_-1357,2603108,Cachoeirinha - PE,16685,16950,265,19896,83.86,85.19,1.33
sidra_9541_PercMoradDPPOColetTot_munic_22_pol.fid-703dc0a5_191866d88cb_-1356,2925956,Rafael Jambeiro - BA,8206,10874,2668,19651,41.76,55.34,13.58
sidra_9541_PercMoradDPPOColetTot_munic_22_pol.fid-703dc0a5_191866d88cb_-1355,2926004,Remanso - BA,25884,26797,913,40545,63.84,66.09,2.25
sidra_9541_PercMoradDPPOColetTot_munic_22_pol.fid-703dc0a5_191866d88cb_-1354,2926103,Retirolândia - BA,10766,12047,1281,13623,79.03,88.43,9.4
sidra_9541_PercMoradDPPOColetTot_munic_22_pol.fid-703dc0a5_191866d88cb_-1353,2926202,Riachão das Neves - BA,10534,12095,1561,21613,48.74,55.96,7.22
sidra_9541_PercMoradDPPOColetTot_munic_22_pol.fid-703dc0a5_191866d88cb_-1352,2926301,Riachão do Jacuípe - BA,24840,27894,3054,33343,74.5,83.66,9.16
sidra_9541_PercMoradDPPOColetTot_munic_22_pol.fid-703dc0a5_191866d88cb_-1351,2926400,Riacho de Santana - BA,13205,15068,1863,30694,43.02,49.09,6.07
sidra_9541_PercMoradDPPOColetTot_munic_22_pol.fid-703dc0a5_191866d88cb_-1350,2600500,Águas Belas - PE,22388,25223,2835,41513,53.93,60.76,6.83
sidra_9541_PercMoradDPPOColetTot_munic_22_pol.fid-703dc0a5_191866d88cb_-134f,2926509,Ribeira do Amparo - BA,5810,6119,309,13779,42.17,44.41,2.24
sidra_9541_PercMoradDPPOColetTot_munic_22_pol.fid-703dc0a5_191866d88cb_-134e,2926608,Ribeira do Pombal - BA,35406,41582,6176,53986,65.58,77.02,11.44
sidra_9541_PercMoradDPPOColetTot_munic_22_pol.fid-703dc0a5_191866d88cb_-134d,2926657,Ribeirão do Largo - BA,3939,4657,718,9619,40.95,48.41,7.46
sidra_9541_PercMoradDPPOColetTot_munic_22_pol.fid-703dc0a5_191866d88cb_-134c,2926707,Rio de Contas - BA,8402,8883,481,13179,63.75,67.4,3.65
sidra_9541_PercMoradDPPOColetTot_munic_22_pol.fid-703dc0a5_191866d88cb_-134b,2926806,Rio do Antônio - BA,5857,6430,573,13140,44.57,48.93,4.36
sidra_9541_PercMoradDPPOColetTot_munic_22_pol.fid-703dc0a5_191866d88cb_-134a,2926905,Rio do Pires - BA,5682,6463,781,10492,54.16,61.6,7.44
sidra_9541_PercMoradDPPOColetTot_munic_22_pol.fid-703dc0a5_191866d88cb_-1349,2927002,Rio Real - BA,28544,29581,1037,35244,80.99,83.93,2.94
sidra_9541_PercMoradDPPOColetTot_munic_22_pol.fid-703dc0a5_191866d88cb_-1348,2927101,Rodelas - BA,7534,9783,2249,10295,73.18,95.03,21.85
sidra_9541_PercMoradDPPOColetTot_munic_22_pol.fid-703dc0a5_191866d88cb_-1347,2927200,Ruy Barbosa - BA,23341,23838,497,28234,82.67,84.43,1.76
sidra_9541_PercMoradDPPOColetTot_munic_22_pol.fid-703dc0a5_191866d88cb_-1346,2601003,Angelim - PE,6951,7120,169,10226,67.97,69.63,1.65
sidra_9541_PercMoradDPPOColetTot_munic_22_pol.fid-703dc0a5_191866d88cb_-1345,2601052,Araçoiaba - PE,16190,16434,244,19234,84.17,85.44,1.27
sidra_9541_PercMoradDPPOColetTot_munic_22_pol.fid-703dc0a5_191866d88cb_-1344,2601102,Araripina - PE,51103,53110,2007,85065,60.08,62.43,2.36
sidra_9541_PercMoradDPPOColetTot_munic_22_pol.fid-703dc0a5_191866d88cb_-1343,2928059,Santa Luzia - BA,8539,9077,538,13808,61.84,65.74,3.9
sidra_9541_PercMoradDPPOColetTot_munic_22_pol.fid-703dc0a5_191866d88cb_-1342,2928109,Santa Maria da Vitória - BA,25119,26891,1772,38542,65.17,69.77,4.6
sidra_9541_PercMoradDPPOColetTot_munic_22_pol.fid-703dc0a5_191866d88cb_-1341,2928208,Santana - BA,12598,14161,1563,24692,51.02,57.35,6.33
sidra_9541_PercMoradDPPOColetTot_munic_22_pol.fid-703dc0a5_191866d88cb_-1340,2601201,Arcoverde - PE,70186,72259,2073,76761,91.43,94.14,2.7
sidra_9541_PercMoradDPPOColetTot_munic_22_pol.fid-703dc0a5_191866d88cb_-133f,2928307,Santanópolis - BA,4653,5906,1253,8716,53.38,67.76,14.38
sidra_9541_PercMoradDPPOColetTot_munic_22_pol.fid-703dc0a5_191866d88cb_-133e,2928406,Santa Rita de Cássia - BA,17448,18256,808,27339,63.82,66.78,2.96
sidra_9541_PercMoradDPPOColetTot_munic_22_pol.fid-703dc0a5_191866d88cb_-133d,2928505,Santa Terezinha - BA,6473,6872,399,10425,62.09,65.92,3.83
sidra_9541_PercMoradDPPOColetTot_munic_22_pol.fid-703dc0a5_191866d88cb_-133c,2928604,Santo Amaro - BA,46685,48968,2283,55771,83.71,87.8,4.09
sidra_9541_PercMoradDPPOColetTot_munic_22_pol.fid-703dc0a5_191866d88cb_-133b,2928703,Santo Antônio de Jesus - BA,82929,92298,9369,102788,80.68,89.79,9.11
sidra_9541_PercMoradDPPOColetTot_munic_22_pol.fid-703dc0a5_191866d88cb_-133a,2928802,Santo Estêvão - BA,34211,36374,2163,52213,65.52,69.66,4.14
sidra_9541_PercMoradDPPOColetTot_munic_22_pol.fid-703dc0a5_191866d88cb_-1339,2928901,São Desidério - BA,19545,21223,1678,32675,59.82,64.95,5.14
sidra_9541_PercMoradDPPOColetTot_munic_22_pol.fid-703dc0a5_191866d88cb_-1338,2928950,São Domingos - BA,6863,7514,651,8426,81.45,89.18,7.73
sidra_9541_PercMoradDPPOColetTot_munic_22_pol.fid-703dc0a5_191866d88cb_-1337,2929008,São Félix - BA,5789,7221,1432,11021,52.53,65.52,12.99
sidra_9541_PercMoradDPPOColetTot_munic_22_pol.fid-703dc0a5_191866d88cb_-1336,2929057,São Félix do Coribe - BA,11320,11697,377,15183,74.56,77.04,2.48
sidra_9541_PercMoradDPPOColetTot_munic_22_pol.fid-703dc0a5_191866d88cb_-1335,2929107,São Felipe - BA,13246,15679,2433,20162,65.7,77.77,12.07
sidra_9541_PercMoradDPPOColetTot_munic_22_pol.fid-703dc0a5_191866d88cb_-1334,2929206,São Francisco do Conde - BA,23214,37537,14323,38675,60.02,97.06,37.03
sidra_9541_PercMoradDPPOColetTot_munic_22_pol.fid-703dc0a5_191866d88cb_-1333,2929255,São Gabriel - BA,15406,15611,205,18582,82.91,84.01,1.1
sidra_9541_PercMoradDPPOColetTot_munic_22_pol.fid-703dc0a5_191866d88cb_-1332,2929305,São Gonçalo dos Campos - BA,33204,33832,628,39496,84.07,85.66,1.59
sidra_9541_PercMoradDPPOColetTot_munic_22_pol.fid-703dc0a5_191866d88cb_-1331,2929354,São José da Vitória - BA,4234,4506,272,5314,79.68,84.79,5.12
sidra_9541_PercMoradDPPOColetTot_munic_22_pol.fid-703dc0a5_191866d88cb_-1330,2929370,São José do Jacuípe - BA,5885,8179,2294,10176,57.83,80.38,22.54
sidra_9541_PercMoradDPPOColetTot_munic_22_pol.fid-703dc0a5_191866d88cb_-132f,2929404,São Miguel das Matas - BA,3979,4251,272,10333,38.51,41.14,2.63
sidra_9541_PercMoradDPPOColetTot_munic_22_pol.fid-703dc0a5_191866d88cb_-132e,2929503,São Sebastião do Passé - BA,31322,35389,4067,40913,76.56,86.5,9.94
sidra_9541_PercMoradDPPOColetTot_munic_22_pol.fid-703dc0a5_191866d88cb_-132d,2929602,Sapeaçu - BA,12394,13421,1027,17943,69.07,74.8,5.72
sidra_9541_PercMoradDPPOColetTot_munic_22_pol.fid-703dc0a5_191866d88cb_-132c,2929701,Sátiro Dias - BA,9050,9560,510,15985,56.62,59.81,3.19
sidra_9541_PercMoradDPPOColetTot_munic_22_pol.fid-703dc0a5_191866d88cb_-132b,2929750,Saubara - BA,8941,10927,1986,11411,78.35,95.76,17.4
sidra_9541_PercMoradDPPOColetTot_munic_22_pol.fid-703dc0a5_191866d88cb_-132a,2929800,Saúde - BA,6618,7679,1061,10466,63.23,73.37,10.14
sidra_9541_PercMoradDPPOColetTot_munic_22_pol.fid-703dc0a5_191866d88cb_-1329,2929909,Seabra - BA,32155,34313,2158,46112,69.73,74.41,4.68
sidra_9541_PercMoradDPPOColetTot_munic_22_pol.fid-703dc0a5_191866d88cb_-1328,2930006,Sebastião Laranjeiras - BA,4268,5423,1155,9353,45.63,57.98,12.35
sidra_9541_PercMoradDPPOColetTot_munic_22_pol.fid-703dc0a5_191866d88cb_-1327,2930105,Senhor do Bonfim - BA,66014,67835,1821,74355,88.78,91.23,2.45
sidra_9541_PercMoradDPPOColetTot_munic_22_pol.fid-703dc0a5_191866d88cb_-1326,2930154,Serra do Ramalho - BA,11267,12904,1637,34159,32.98,37.78,4.79
sidra_9541_PercMoradDPPOColetTot_munic_22_pol.fid-703dc0a5_191866d88cb_-1325,2930204,Sento Sé - BA,28276,29275,999,37966,74.48,77.11,2.63
sidra_9541_PercMoradDPPOColetTot_munic_22_pol.fid-703dc0a5_191866d88cb_-1324,2601300,Barra de Guabiraba - PE,10705,10980,275,12248,87.4,89.65,2.25
sidra_9541_PercMoradDPPOColetTot_munic_22_pol.fid-703dc0a5_191866d88cb_-1323,2930303,Serra Dourada - BA,8143,8290,147,17056,47.74,48.6,0.86
sidra_9541_PercMoradDPPOColetTot_munic_22_pol.fid-703dc0a5_191866d88cb_-1322,2930402,Serra Preta - BA,9876,12647,2771,17970,54.96,70.38,15.42
sidra_9541_PercMoradDPPOColetTot_munic_22_pol.fid-703dc0a5_191866d88cb_-1321,2930501,Serrinha - BA,61135,64365,3230,80108,76.32,80.35,4.03
sidra_9541_PercMoradDPPOColetTot_munic_22_pol.fid-703dc0a5_191866d88cb_-1320,2930600,Serrolândia - BA,10652,11631,979,13306,80.05,87.41,7.36
sidra_9541_PercMoradDPPOColetTot_munic_22_pol.fid-703dc0a5_191866d88cb_-131f,2930709,Simões Filho - BA,57884,107688,49804,113990,50.78,94.47,43.69
sidra_9541_PercMoradDPPOColetTot_munic_22_pol.fid-703dc0a5_191866d88cb_-131e,2930758,Sítio do Mato - BA,5935,7187,1252,13393,44.31,53.66,9.35
sidra_9541_PercMoradDPPOColetTot_munic_22_pol.fid-703dc0a5_191866d88cb_-131d,2930766,Sítio do Quinto - BA,9859,11202,1343,14755,66.82,75.92,9.1
sidra_9541_PercMoradDPPOColetTot_munic_22_pol.fid-703dc0a5_191866d88cb_-131c,2930774,Sobradinho - BA,22887,23070,183,25442,89.96,90.68,0.72
sidra_9541_PercMoradDPPOColetTot_munic_22_pol.fid-703dc0a5_191866d88cb_-131b,2930808,Souto Soares - BA,9573,9961,388,17051,56.14,58.42,2.28
sidra_9541_PercMoradDPPOColetTot_munic_22_pol.fid-703dc0a5_191866d88cb_-131a,2930907,Tabocas do Brejo Velho - BA,4459,4611,152,11965,37.27,38.54,1.27
sidra_9541_PercMoradDPPOColetTot_munic_22_pol.fid-703dc0a5_191866d88cb_-1319,2931004,Tanhaçu - BA,9244,9988,744,21004,44.01,47.55,3.54
sidra_9541_PercMoradDPPOColetTot_munic_22_pol.fid-703dc0a5_191866d88cb_-1318,2931053,Tanque Novo - BA,9278,9469,191,17148,54.11,55.22,1.11
sidra_9541_PercMoradDPPOColetTot_munic_22_pol.fid-703dc0a5_191866d88cb_-1317,2931103,Tanquinho - BA,5992,6505,513,7713,77.69,84.34,6.65
sidra_9541_PercMoradDPPOColetTot_munic_22_pol.fid-703dc0a5_191866d88cb_-1316,2931202,Taperoá - BA,6649,10813,4164,18003,36.93,60.06,23.13
sidra_9541_PercMoradDPPOColetTot_munic_22_pol.fid-703dc0a5_191866d88cb_-1315,2931301,Tapiramutá - BA,12443,12900,457,15789,78.81,81.7,2.89
sidra_9541_PercMoradDPPOColetTot_munic_22_pol.fid-703dc0a5_191866d88cb_-1314,2931350,Teixeira de Freitas - BA,138083,140145,2062,144546,95.53,96.96,1.43
sidra_9541_PercMoradDPPOColetTot_munic_22_pol.fid-703dc0a5_191866d88cb_-1313,2931400,Teodoro Sampaio - BA,5040,6015,975,7091,71.08,84.83,13.75
sidra_9541_PercMoradDPPOColetTot_munic_22_pol.fid-703dc0a5_191866d88cb_-1312,2931509,Teofilândia - BA,15725,16614,889,21085,74.58,78.8,4.22
sidra_9541_PercMoradDPPOColetTot_munic_22_pol.fid-703dc0a5_191866d88cb_-1311,2931608,Teolândia - BA,4658,6484,1826,15308,30.43,42.36,11.93
sidra_9541_PercMoradDPPOColetTot_munic_22_pol.fid-703dc0a5_191866d88cb_-1310,2601409,Barreiros - PE,29723,35052,5329,40068,74.18,87.48,13.3
sidra_9541_PercMoradDPPOColetTot_munic_22_pol.fid-703dc0a5_191866d88cb_-130f,2931707,Terra Nova - BA,8631,9820,1189,10790,79.99,91.01,11.02
sidra_9541_PercMoradDPPOColetTot_munic_22_pol.fid-703dc0a5_191866d88cb_-130e,2931806,Tremedal - BA,5032,5776,744,16288,30.89,35.46,4.57
sidra_9541_PercMoradDPPOColetTot_munic_22_pol.fid-703dc0a5_191866d88cb_-130d,2931905,Tucano - BA,35836,39052,3216,48660,73.65,80.25,6.61
sidra_9541_PercMoradDPPOColetTot_munic_22_pol.fid-703dc0a5_191866d88cb_-130c,2932002,Uauá - BA,12636,14882,2246,24620,51.32,60.45,9.12
sidra_9541_PercMoradDPPOColetTot_munic_22_pol.fid-703dc0a5_191866d88cb_-130b,2932101,Ubaíra - BA,11190,11628,438,18615,60.11,62.47,2.35
sidra_9541_PercMoradDPPOColetTot_munic_22_pol.fid-703dc0a5_191866d88cb_-130a,2932200,Ubaitaba - BA,14671,16387,1716,17590,83.41,93.16,9.76
sidra_9541_PercMoradDPPOColetTot_munic_22_pol.fid-703dc0a5_191866d88cb_-1309,2932309,Ubatã - BA,13735,14376,641,16089,85.37,89.35,3.98
sidra_9541_PercMoradDPPOColetTot_munic_22_pol.fid-703dc0a5_191866d88cb_-1308,2932408,Uibaí - BA,13084,13111,27,13426,97.45,97.65,0.2
sidra_9541_PercMoradDPPOColetTot_munic_22_pol.fid-703dc0a5_191866d88cb_-1307,2932457,Umburanas - BA,7008,9863,2855,13621,51.45,72.41,20.96
sidra_9541_PercMoradDPPOColetTot_munic_22_pol.fid-703dc0a5_191866d88cb_-1306,2932507,Una - BA,12561,13862,1301,18031,69.66,76.88,7.22
sidra_9541_PercMoradDPPOColetTot_munic_22_pol.fid-703dc0a5_191866d88cb_-1305,2932606,Urandi - BA,8712,9118,406,15354,56.74,59.39,2.64
sidra_9541_PercMoradDPPOColetTot_munic_22_pol.fid-703dc0a5_191866d88cb_-1304,2932705,Uruçuca - BA,15423,16708,1285,21318,72.35,78.38,6.03
sidra_9541_PercMoradDPPOColetTot_munic_22_pol.fid-703dc0a5_191866d88cb_-1303,2601508,Belém de Maria - PE,6611,7505,894,10376,63.71,72.33,8.62
sidra_9541_PercMoradDPPOColetTot_munic_22_pol.fid-703dc0a5_191866d88cb_-1302,2601607,Belém do São Francisco - PE,10936,11036,100,18282,59.82,60.37,0.55
sidra_9541_PercMoradDPPOColetTot_munic_22_pol.fid-703dc0a5_191866d88cb_-1301,2603603,Camutanga - PE,6093,6481,388,7747,78.65,83.66,5.01
sidra_9541_PercMoradDPPOColetTot_munic_22_pol.fid-703dc0a5_191866d88cb_-1300,3103801,Arapuá - MG,2117,2161,44,2620,80.8,82.48,1.68
sidra_9541_PercMoradDPPOColetTot_munic_22_pol.fid-703dc0a5_191866d88cb_-12ff,3103900,Araújos - MG,7887,8840,953,9170,86.01,96.4,10.39
sidra_9541_PercMoradDPPOColetTot_munic_22_pol.fid-703dc0a5_191866d88cb_-12fe,2601706,Belo Jardim - PE,69530,71540,2010,79394,87.58,90.11,2.53
sidra_9541_PercMoradDPPOColetTot_munic_22_pol.fid-703dc0a5_191866d88cb_-12fd,3104007,Araxá - MG,108169,109913,1744,111064,97.39,98.96,1.57
sidra_9541_PercMoradDPPOColetTot_munic_22_pol.fid-703dc0a5_191866d88cb_-12fc,3104106,Arceburgo - MG,8289,8955,666,9126,90.83,98.13,7.3
sidra_9541_PercMoradDPPOColetTot_munic_22_pol.fid-703dc0a5_191866d88cb_-12fb,3104205,Arcos - MG,39519,40407,888,41110,96.13,98.29,2.16
sidra_9541_PercMoradDPPOColetTot_munic_22_pol.fid-703dc0a5_191866d88cb_-12fa,3104304,Areado - MG,12863,13404,541,13797,93.23,97.15,3.92
sidra_9541_PercMoradDPPOColetTot_munic_22_pol.fid-703dc0a5_191866d88cb_-12f9,3104403,Argirita - MG,2122,2360,238,2687,78.97,87.83,8.86
sidra_9541_PercMoradDPPOColetTot_munic_22_pol.fid-703dc0a5_191866d88cb_-12f8,3104452,Aricanduva - MG,2332,2346,14,4705,49.56,49.86,0.3
sidra_9541_PercMoradDPPOColetTot_munic_22_pol.fid-703dc0a5_191866d88cb_-12f7,3104502,Arinos - MG,11751,12027,276,17205,68.3,69.9,1.6
sidra_9541_PercMoradDPPOColetTot_munic_22_pol.fid-703dc0a5_191866d88cb_-12f6,3104601,Astolfo Dutra - MG,12551,12885,334,14100,89.01,91.38,2.37
sidra_9541_PercMoradDPPOColetTot_munic_22_pol.fid-703dc0a5_191866d88cb_-12f5,3104700,Ataléia - MG,6880,8130,1250,13709,50.19,59.3,9.12
sidra_9541_PercMoradDPPOColetTot_munic_22_pol.fid-703dc0a5_191866d88cb_-12f4,2601805,Betânia - PE,3905,3933,28,11216,34.82,35.07,0.25
sidra_9541_PercMoradDPPOColetTot_munic_22_pol.fid-703dc0a5_191866d88cb_-12f3,2601904,Bezerros - PE,51623,54759,3136,61540,83.89,88.98,5.1
sidra_9541_PercMoradDPPOColetTot_munic_22_pol.fid-703dc0a5_191866d88cb_-12f2,3104809,Augusto de Lima - MG,3641,3664,23,4515,80.64,81.15,0.51
sidra_9541_PercMoradDPPOColetTot_munic_22_pol.fid-703dc0a5_191866d88cb_-12f1,3104908,Baependi - MG,14199,15724,1525,18227,77.9,86.27,8.37
sidra_9541_PercMoradDPPOColetTot_munic_22_pol.fid-703dc0a5_191866d88cb_-12f0,3105004,Baldim - MG,5760,6312,552,7435,77.47,84.9,7.42
sidra_9541_PercMoradDPPOColetTot_munic_22_pol.fid-703dc0a5_191866d88cb_-12ef,3105103,Bambuí - MG,20821,21907,1086,23448,88.8,93.43,4.63
sidra_9541_PercMoradDPPOColetTot_munic_22_pol.fid-703dc0a5_191866d88cb_-12ee,3105202,Bandeira - MG,2729,3039,310,4721,57.81,64.37,6.57
sidra_9541_PercMoradDPPOColetTot_munic_22_pol.fid-703dc0a5_191866d88cb_-12ed,3105301,Bandeira do Sul - MG,5598,5915,317,5942,94.21,99.55,5.33
sidra_9541_PercMoradDPPOColetTot_munic_22_pol.fid-703dc0a5_191866d88cb_-12ec,3105400,Barão de Cocais - MG,22359,30002,7643,30681,72.88,97.79,24.91
sidra_9541_PercMoradDPPOColetTot_munic_22_pol.fid-703dc0a5_191866d88cb_-12eb,3105509,Barão de Monte Alto - MG,4413,4524,111,4963,88.92,91.15,2.24
sidra_9541_PercMoradDPPOColetTot_munic_22_pol.fid-703dc0a5_191866d88cb_-12ea,3105608,Barbacena - MG,114807,119486,4679,124441,92.26,96.02,3.76
sidra_9541_PercMoradDPPOColetTot_munic_22_pol.fid-703dc0a5_191866d88cb_-12e9,3105707,Barra Longa - MG,2729,4551,1822,5656,48.25,80.46,32.21
sidra_9541_PercMoradDPPOColetTot_munic_22_pol.fid-703dc0a5_191866d88cb_-12e8,3105905,Barroso - MG,19637,19802,165,20018,98.1,98.92,0.82
sidra_9541_PercMoradDPPOColetTot_munic_22_pol.fid-703dc0a5_191866d88cb_-12e7,3106002,Bela Vista de Minas - MG,9786,9853,67,10163,96.29,96.95,0.66
sidra_9541_PercMoradDPPOColetTot_munic_22_pol.fid-703dc0a5_191866d88cb_-12e6,3106101,Belmiro Braga - MG,2852,2949,97,3243,87.94,90.93,2.99
sidra_9541_PercMoradDPPOColetTot_munic_22_pol.fid-703dc0a5_191866d88cb_-12e5,3106200,Belo Horizonte - MG,2211570,2293200,81630,2306189,95.9,99.44,3.54
sidra_9541_PercMoradDPPOColetTot_munic_22_pol.fid-703dc0a5_191866d88cb_-12e4,3106309,Belo Oriente - MG,22074,22314,240,23907,92.33,93.34,1
sidra_9541_PercMoradDPPOColetTot_munic_22_pol.fid-703dc0a5_191866d88cb_-12e3,2602001,Bodocó - PE,11336,15686,4350,34441,32.91,45.54,12.63
sidra_9541_PercMoradDPPOColetTot_munic_22_pol.fid-703dc0a5_191866d88cb_-12e2,2604007,Carpina - PE,67681,70009,2328,79059,85.61,88.55,2.94
sidra_9541_PercMoradDPPOColetTot_munic_22_pol.fid-703dc0a5_191866d88cb_-12e1,2604106,Caruaru - PE,347710,359324,11614,376443,92.37,95.45,3.09
sidra_9541_PercMoradDPPOColetTot_munic_22_pol.fid-703dc0a5_191866d88cb_-12e0,3106408,Belo Vale - MG,5675,7409,1734,8610,65.91,86.05,20.14
sidra_9541_PercMoradDPPOColetTot_munic_22_pol.fid-703dc0a5_191866d88cb_-12df,3106507,Berilo - MG,4795,5175,380,9823,48.81,52.68,3.87
sidra_9541_PercMoradDPPOColetTot_munic_22_pol.fid-703dc0a5_191866d88cb_-12de,3106606,Bertópolis - MG,2665,2685,20,4444,59.97,60.42,0.45
sidra_9541_PercMoradDPPOColetTot_munic_22_pol.fid-703dc0a5_191866d88cb_-12dd,3106655,Berizal - MG,3462,3473,11,4185,82.72,82.99,0.26
sidra_9541_PercMoradDPPOColetTot_munic_22_pol.fid-703dc0a5_191866d88cb_-12dc,2602100,Bom Conselho - PE,26499,31052,4553,44205,59.95,70.25,10.3
sidra_9541_PercMoradDPPOColetTot_munic_22_pol.fid-703dc0a5_191866d88cb_-12db,2602407,Brejão - PE,4161,5435,1274,9071,45.87,59.92,14.04
sidra_9541_PercMoradDPPOColetTot_munic_22_pol.fid-703dc0a5_191866d88cb_-12da,2602506,Brejinho - PE,3828,5563,1735,7712,49.64,72.13,22.5
sidra_9541_PercMoradDPPOColetTot_munic_22_pol.fid-703dc0a5_191866d88cb_-12d9,2602605,Brejo da Madre de Deus - PE,32620,40824,8204,48591,67.13,84.02,16.88
sidra_9541_PercMoradDPPOColetTot_munic_22_pol.fid-703dc0a5_191866d88cb_-12d8,3106705,Betim - MG,397871,408970,11099,411186,96.76,99.46,2.7
sidra_9541_PercMoradDPPOColetTot_munic_22_pol.fid-703dc0a5_191866d88cb_-12d7,3106804,Bias Fortes - MG,2472,2635,163,3355,73.68,78.54,4.86
sidra_9541_PercMoradDPPOColetTot_munic_22_pol.fid-703dc0a5_191866d88cb_-12d6,3106903,Bicas - MG,13117,13480,363,13896,94.39,97.01,2.61
sidra_9541_PercMoradDPPOColetTot_munic_22_pol.fid-703dc0a5_191866d88cb_-12d5,2603207,Caetés - PE,8952,10504,1552,28810,31.07,36.46,5.39
sidra_9541_PercMoradDPPOColetTot_munic_22_pol.fid-703dc0a5_191866d88cb_-12d4,2603306,Calçado - PE,5891,6145,254,11082,53.16,55.45,2.29
sidra_9541_PercMoradDPPOColetTot_munic_22_pol.fid-703dc0a5_191866d88cb_-12d3,3107000,Biquinhas - MG,1728,1823,95,2383,72.51,76.5,3.99
sidra_9541_PercMoradDPPOColetTot_munic_22_pol.fid-703dc0a5_191866d88cb_-12d2,3107109,Boa Esperança - MG,28711,37413,8702,39727,72.27,94.18,21.9
sidra_9541_PercMoradDPPOColetTot_munic_22_pol.fid-703dc0a5_191866d88cb_-12d1,3107208,Bocaina de Minas - MG,3319,4611,1292,5322,62.36,86.64,24.28
sidra_9541_PercMoradDPPOColetTot_munic_22_pol.fid-703dc0a5_191866d88cb_-12d0,3107307,Bocaiúva - MG,40550,41540,990,47877,84.7,86.76,2.07
sidra_9541_PercMoradDPPOColetTot_munic_22_pol.fid-703dc0a5_191866d88cb_-12cf,3107406,Bom Despacho - MG,45659,49201,3542,51592,88.5,95.37,6.87
sidra_9541_PercMoradDPPOColetTot_munic_22_pol.fid-703dc0a5_191866d88cb_-12ce,3107505,Bom Jardim de Minas - MG,6242,6424,182,6757,92.38,95.07,2.69
sidra_9541_PercMoradDPPOColetTot_munic_22_pol.fid-703dc0a5_191866d88cb_-12cd,2603405,Calumbi - PE,2203,2404,201,5228,42.14,45.98,3.84
sidra_9541_PercMoradDPPOColetTot_munic_22_pol.fid-703dc0a5_191866d88cb_-12cc,2603454,Camaragibe - PE,118387,136827,18440,147459,80.28,92.79,12.51
sidra_9541_PercMoradDPPOColetTot_munic_22_pol.fid-703dc0a5_191866d88cb_-12cb,2604155,Casinhas - PE,4821,5631,810,12965,37.18,43.43,6.25
sidra_9541_PercMoradDPPOColetTot_munic_22_pol.fid-703dc0a5_191866d88cb_-12ca,2604205,Catende - PE,23941,24758,817,32063,74.67,77.22,2.55
sidra_9541_PercMoradDPPOColetTot_munic_22_pol.fid-703dc0a5_191866d88cb_-12c9,3107604,Bom Jesus da Penha - MG,3521,4194,673,4447,79.18,94.31,15.13
sidra_9541_PercMoradDPPOColetTot_munic_22_pol.fid-703dc0a5_191866d88cb_-12c8,3107703,Bom Jesus do Amparo - MG,4904,4953,49,5626,87.17,88.04,0.87
sidra_9541_PercMoradDPPOColetTot_munic_22_pol.fid-703dc0a5_191866d88cb_-12c7,3107802,Bom Jesus do Galho - MG,10070,10456,386,14491,69.49,72.16,2.66
sidra_9541_PercMoradDPPOColetTot_munic_22_pol.fid-703dc0a5_191866d88cb_-12c6,3107901,Bom Repouso - MG,10279,12000,1721,12644,81.3,94.91,13.61
sidra_9541_PercMoradDPPOColetTot_munic_22_pol.fid-703dc0a5_191866d88cb_-12c5,3108008,Bom Sucesso - MG,15253,16224,971,16984,89.81,95.53,5.72
sidra_9541_PercMoradDPPOColetTot_munic_22_pol.fid-703dc0a5_191866d88cb_-12c4,3108107,Bonfim - MG,4813,6191,1378,7388,65.15,83.8,18.65
sidra_9541_PercMoradDPPOColetTot_munic_22_pol.fid-703dc0a5_191866d88cb_-12c3,3108206,Bonfinópolis de Minas - MG,3826,4173,347,5457,70.11,76.47,6.36
sidra_9541_PercMoradDPPOColetTot_munic_22_pol.fid-703dc0a5_191866d88cb_-12c2,3108255,Bonito de Minas - MG,3506,3523,17,10200,34.37,34.54,0.17
sidra_9541_PercMoradDPPOColetTot_munic_22_pol.fid-703dc0a5_191866d88cb_-12c1,3108305,Borda da Mata - MG,15057,16548,1491,17359,86.74,95.33,8.59
sidra_9541_PercMoradDPPOColetTot_munic_22_pol.fid-703dc0a5_191866d88cb_-12c0,3108404,Botelhos - MG,11620,13978,2358,14683,79.14,95.2,16.06
sidra_9541_PercMoradDPPOColetTot_munic_22_pol.fid-703dc0a5_191866d88cb_-12bf,3108503,Botumirim - MG,3307,3385,78,5779,57.22,58.57,1.35
sidra_9541_PercMoradDPPOColetTot_munic_22_pol.fid-703dc0a5_191866d88cb_-12be,2603504,Camocim de São Félix - PE,12353,16416,4063,17389,71.04,94.4,23.37
sidra_9541_PercMoradDPPOColetTot_munic_22_pol.fid-703dc0a5_191866d88cb_-12bd,2607307,Ipubi - PE,17114,17455,341,28996,59.02,60.2,1.18
sidra_9541_PercMoradDPPOColetTot_munic_22_pol.fid-703dc0a5_191866d88cb_-12bc,3108552,Brasilândia de Minas - MG,13588,13706,118,15014,90.5,91.29,0.79
sidra_9541_PercMoradDPPOColetTot_munic_22_pol.fid-703dc0a5_191866d88cb_-12bb,3108602,Brasília de Minas - MG,20596,22085,1489,31982,64.4,69.05,4.66
sidra_9541_PercMoradDPPOColetTot_munic_22_pol.fid-703dc0a5_191866d88cb_-12ba,3108701,Brás Pires - MG,2834,3306,472,4215,67.24,78.43,11.2
sidra_9541_PercMoradDPPOColetTot_munic_22_pol.fid-703dc0a5_191866d88cb_-12b9,3108800,Braúnas - MG,1963,2200,237,4437,44.24,49.58,5.34
sidra_9541_PercMoradDPPOColetTot_munic_22_pol.fid-703dc0a5_191866d88cb_-12b8,3108909,Brazópolis - MG,10403,13777,3374,14154,73.5,97.34,23.84
sidra_9541_PercMoradDPPOColetTot_munic_22_pol.fid-703dc0a5_191866d88cb_-12b7,3109006,Brumadinho - MG,33343,38080,4737,38678,86.21,98.45,12.25
sidra_9541_PercMoradDPPOColetTot_munic_22_pol.fid-703dc0a5_191866d88cb_-12b6,3109105,Bueno Brandão - MG,5757,10271,4514,10851,53.06,94.65,41.6
sidra_9541_PercMoradDPPOColetTot_munic_22_pol.fid-703dc0a5_191866d88cb_-12b5,3109204,Buenópolis - MG,7343,7442,99,9091,80.77,81.86,1.09
sidra_9541_PercMoradDPPOColetTot_munic_22_pol.fid-703dc0a5_191866d88cb_-12b4,3109253,Bugre - MG,3114,3422,308,4040,77.08,84.7,7.62
sidra_9541_PercMoradDPPOColetTot_munic_22_pol.fid-703dc0a5_191866d88cb_-12b3,3109303,Buritis - MG,17349,19059,1710,23853,72.73,79.9,7.17
sidra_9541_PercMoradDPPOColetTot_munic_22_pol.fid-703dc0a5_191866d88cb_-12b2,2603702,Canhotinho - PE,15514,16433,919,22630,68.56,72.62,4.06
sidra_9541_PercMoradDPPOColetTot_munic_22_pol.fid-703dc0a5_191866d88cb_-12b1,2607406,Itacuruba - PE,3362,3486,124,4283,78.5,81.39,2.9
sidra_9541_PercMoradDPPOColetTot_munic_22_pol.fid-703dc0a5_191866d88cb_-12b0,2603801,Capoeiras - PE,7878,7939,61,18307,43.03,43.37,0.33
sidra_9541_PercMoradDPPOColetTot_munic_22_pol.fid-703dc0a5_191866d88cb_-12af,2607505,Itaíba - PE,11176,13387,2211,32603,34.28,41.06,6.78
sidra_9541_PercMoradDPPOColetTot_munic_22_pol.fid-703dc0a5_191866d88cb_-12ae,3109402,Buritizeiro - MG,21592,21664,72,23868,90.46,90.77,0.3
sidra_9541_PercMoradDPPOColetTot_munic_22_pol.fid-703dc0a5_191866d88cb_-12ad,3109451,Cabeceira Grande - MG,5526,5799,273,6627,83.39,87.51,4.12
sidra_9541_PercMoradDPPOColetTot_munic_22_pol.fid-703dc0a5_191866d88cb_-12ac,3109501,Cabo Verde - MG,9124,10956,1832,11380,80.18,96.27,16.1
sidra_9541_PercMoradDPPOColetTot_munic_22_pol.fid-703dc0a5_191866d88cb_-12ab,3109600,Cachoeira da Prata - MG,3516,3611,95,3692,95.23,97.81,2.57
sidra_9541_PercMoradDPPOColetTot_munic_22_pol.fid-703dc0a5_191866d88cb_-12aa,3109709,Cachoeira de Minas - MG,10126,11205,1079,11851,85.44,94.55,9.1
sidra_9541_PercMoradDPPOColetTot_munic_22_pol.fid-703dc0a5_191866d88cb_-12a9,3109808,Cachoeira Dourada - MG,2051,2117,66,2298,89.25,92.12,2.87
sidra_9541_PercMoradDPPOColetTot_munic_22_pol.fid-703dc0a5_191866d88cb_-12a8,3109907,Caetanópolis - MG,8834,9030,196,11412,77.41,79.13,1.72
sidra_9541_PercMoradDPPOColetTot_munic_22_pol.fid-703dc0a5_191866d88cb_-12a7,3110004,Caeté - MG,34340,35892,1552,38618,88.92,92.94,4.02
sidra_9541_PercMoradDPPOColetTot_munic_22_pol.fid-703dc0a5_191866d88cb_-12a6,3110103,Caiana - MG,3624,4716,1092,5300,68.38,88.98,20.6
sidra_9541_PercMoradDPPOColetTot_munic_22_pol.fid-703dc0a5_191866d88cb_-12a5,3110202,Cajuri - MG,2758,3814,1056,4087,67.48,93.32,25.84
sidra_9541_PercMoradDPPOColetTot_munic_22_pol.fid-703dc0a5_191866d88cb_-12a4,3110301,Caldas - MG,9566,12269,2703,14162,67.55,86.63,19.09
sidra_9541_PercMoradDPPOColetTot_munic_22_pol.fid-703dc0a5_191866d88cb_-12a3,3110400,Camacho - MG,1989,2080,91,2835,70.16,73.37,3.21
sidra_9541_PercMoradDPPOColetTot_munic_22_pol.fid-703dc0a5_191866d88cb_-12a2,2603900,Carnaíba - PE,9037,10647,1610,18642,48.48,57.11,8.64
sidra_9541_PercMoradDPPOColetTot_munic_22_pol.fid-703dc0a5_191866d88cb_-12a1,2607901,Jaboatão dos Guararapes - PE,487447,615324,127877,642816,75.83,95.72,19.89
sidra_9541_PercMoradDPPOColetTot_munic_22_pol.fid-703dc0a5_191866d88cb_-12a0,3110509,Camanducaia - MG,20917,25425,4508,25929,80.67,98.06,17.39
sidra_9541_PercMoradDPPOColetTot_munic_22_pol.fid-703dc0a5_191866d88cb_-129f,3110608,Cambuí - MG,26746,29175,2429,29459,90.79,99.04,8.25
sidra_9541_PercMoradDPPOColetTot_munic_22_pol.fid-703dc0a5_191866d88cb_-129e,3110707,Cambuquira - MG,10682,11237,555,12239,87.28,91.81,4.53
sidra_9541_PercMoradDPPOColetTot_munic_22_pol.fid-703dc0a5_191866d88cb_-129d,3110806,Campanário - MG,2347,2509,162,2922,80.32,85.87,5.54
sidra_9541_PercMoradDPPOColetTot_munic_22_pol.fid-703dc0a5_191866d88cb_-129c,3110905,Campanha - MG,14092,14732,640,15802,89.18,93.23,4.05
sidra_9541_PercMoradDPPOColetTot_munic_22_pol.fid-703dc0a5_191866d88cb_-129b,3111002,Campestre - MG,14548,17837,3289,20596,70.64,86.6,15.97
sidra_9541_PercMoradDPPOColetTot_munic_22_pol.fid-703dc0a5_191866d88cb_-129a,3111101,Campina Verde - MG,13853,15086,1233,17908,77.36,84.24,6.89
sidra_9541_PercMoradDPPOColetTot_munic_22_pol.fid-703dc0a5_191866d88cb_-1299,3111150,Campo Azul - MG,2159,2160,1,3707,58.24,58.27,0.03
sidra_9541_PercMoradDPPOColetTot_munic_22_pol.fid-703dc0a5_191866d88cb_-1298,3111200,Campo Belo - MG,50468,51159,691,51989,97.07,98.4,1.33
sidra_9541_PercMoradDPPOColetTot_munic_22_pol.fid-703dc0a5_191866d88cb_-1297,3111309,Campo do Meio - MG,8071,10197,2126,11324,71.27,90.05,18.77
sidra_9541_PercMoradDPPOColetTot_munic_22_pol.fid-703dc0a5_191866d88cb_-1296,3111408,Campo Florido - MG,6714,7514,800,8436,79.59,89.07,9.48
sidra_9541_PercMoradDPPOColetTot_munic_22_pol.fid-703dc0a5_191866d88cb_-1295,3111507,Campos Altos - MG,11847,12173,326,12946,91.51,94.03,2.52
sidra_9541_PercMoradDPPOColetTot_munic_22_pol.fid-703dc0a5_191866d88cb_-1294,3111606,Campos Gerais - MG,18969,21304,2335,25947,73.11,82.11,9
sidra_9541_PercMoradDPPOColetTot_munic_22_pol.fid-703dc0a5_191866d88cb_-1293,3111705,Canaã - MG,2761,4300,1539,4710,58.62,91.3,32.68
sidra_9541_PercMoradDPPOColetTot_munic_22_pol.fid-703dc0a5_191866d88cb_-1292,3111804,Canápolis - MG,9724,10015,291,10521,92.42,95.19,2.77
sidra_9541_PercMoradDPPOColetTot_munic_22_pol.fid-703dc0a5_191866d88cb_-1291,3111903,Cana Verde - MG,5025,5059,34,5239,95.92,96.56,0.65
sidra_9541_PercMoradDPPOColetTot_munic_22_pol.fid-703dc0a5_191866d88cb_-1290,3112000,Candeias - MG,10834,11501,667,13881,78.05,82.85,4.81
sidra_9541_PercMoradDPPOColetTot_munic_22_pol.fid-703dc0a5_191866d88cb_-128f,3112059,Cantagalo - MG,1914,2658,744,3974,48.16,66.88,18.72
sidra_9541_PercMoradDPPOColetTot_munic_22_pol.fid-703dc0a5_191866d88cb_-128e,3112109,Caparaó - MG,3017,4322,1305,5039,59.87,85.77,25.9
sidra_9541_PercMoradDPPOColetTot_munic_22_pol.fid-703dc0a5_191866d88cb_-128d,3112208,Capela Nova - MG,3421,3515,94,4359,78.48,80.64,2.16
sidra_9541_PercMoradDPPOColetTot_munic_22_pol.fid-703dc0a5_191866d88cb_-128c,3112307,Capelinha - MG,32730,33118,388,39460,82.94,83.93,0.98
sidra_9541_PercMoradDPPOColetTot_munic_22_pol.fid-703dc0a5_191866d88cb_-128b,3112406,Capetinga - MG,5687,6215,528,6513,87.32,95.42,8.11
sidra_9541_PercMoradDPPOColetTot_munic_22_pol.fid-703dc0a5_191866d88cb_-128a,3112505,Capim Branco - MG,10091,10440,349,10631,94.92,98.2,3.28
sidra_9541_PercMoradDPPOColetTot_munic_22_pol.fid-703dc0a5_191866d88cb_-1289,3112604,Capinópolis - MG,13810,14103,293,14612,94.51,96.52,2.01
sidra_9541_PercMoradDPPOColetTot_munic_22_pol.fid-703dc0a5_191866d88cb_-1288,3112653,Capitão Andrade - MG,3642,3644,2,4570,79.69,79.74,0.04
sidra_9541_PercMoradDPPOColetTot_munic_22_pol.fid-703dc0a5_191866d88cb_-1287,3112703,Capitão Enéas - MG,11194,11834,640,14084,79.48,84.02,4.54
sidra_9541_PercMoradDPPOColetTot_munic_22_pol.fid-703dc0a5_191866d88cb_-1286,3112802,Capitólio - MG,8028,9982,1954,10311,77.86,96.81,18.95
sidra_9541_PercMoradDPPOColetTot_munic_22_pol.fid-703dc0a5_191866d88cb_-1285,3112901,Caputira - MG,6001,7332,1331,8935,67.16,82.06,14.9
sidra_9541_PercMoradDPPOColetTot_munic_22_pol.fid-703dc0a5_191866d88cb_-1284,3113008,Caraí - MG,7438,10463,3025,19515,38.11,53.62,15.5
sidra_9541_PercMoradDPPOColetTot_munic_22_pol.fid-703dc0a5_191866d88cb_-1283,2603926,Carnaubeira da Penha - PE,1998,2114,116,12239,16.32,17.27,0.95
sidra_9541_PercMoradDPPOColetTot_munic_22_pol.fid-703dc0a5_191866d88cb_-1282,3113107,Caranaíba - MG,1819,1819,,2933,62.02,62.02,
sidra_9541_PercMoradDPPOColetTot_munic_22_pol.fid-703dc0a5_191866d88cb_-1281,3113206,Carandaí - MG,21248,22535,1287,23810,89.24,94.65,5.41
sidra_9541_PercMoradDPPOColetTot_munic_22_pol.fid-703dc0a5_191866d88cb_-1280,3113305,Carangola - MG,24741,27615,2874,30961,79.91,89.19,9.28
sidra_9541_PercMoradDPPOColetTot_munic_22_pol.fid-703dc0a5_191866d88cb_-127f,3113404,Caratinga - MG,56366,76751,20385,86560,65.12,88.67,23.55
sidra_9541_PercMoradDPPOColetTot_munic_22_pol.fid-703dc0a5_191866d88cb_-127e,3113503,Carbonita - MG,7399,7503,104,8496,87.09,88.31,1.22
sidra_9541_PercMoradDPPOColetTot_munic_22_pol.fid-703dc0a5_191866d88cb_-127d,3113602,Careaçu - MG,5560,6549,989,6777,82.04,96.64,14.59
sidra_9541_PercMoradDPPOColetTot_munic_22_pol.fid-703dc0a5_191866d88cb_-127c,3113701,Carlos Chagas - MG,13331,13565,234,18503,72.05,73.31,1.26
sidra_9541_PercMoradDPPOColetTot_munic_22_pol.fid-703dc0a5_191866d88cb_-127b,3113800,Carmésia - MG,2006,2146,140,2605,77.01,82.38,5.37
sidra_9541_PercMoradDPPOColetTot_munic_22_pol.fid-703dc0a5_191866d88cb_-127a,3113909,Carmo da Cachoeira - MG,9188,9922,734,11358,80.89,87.36,6.46
sidra_9541_PercMoradDPPOColetTot_munic_22_pol.fid-703dc0a5_191866d88cb_-1279,3114006,Carmo da Mata - MG,10184,10356,172,10964,92.89,94.45,1.57
sidra_9541_PercMoradDPPOColetTot_munic_22_pol.fid-703dc0a5_191866d88cb_-1278,3114105,Carmo de Minas - MG,11530,12069,539,13669,84.35,88.29,3.94
sidra_9541_PercMoradDPPOColetTot_munic_22_pol.fid-703dc0a5_191866d88cb_-1277,3114204,Carmo do Cajuru - MG,21824,22760,936,23389,93.31,97.31,4
sidra_9541_PercMoradDPPOColetTot_munic_22_pol.fid-703dc0a5_191866d88cb_-1276,3114303,Carmo do Paranaíba - MG,23925,25814,1889,28657,83.49,90.08,6.59
sidra_9541_PercMoradDPPOColetTot_munic_22_pol.fid-703dc0a5_191866d88cb_-1275,3114402,Carmo do Rio Claro - MG,16825,19852,3027,20890,80.54,95.03,14.49
sidra_9541_PercMoradDPPOColetTot_munic_22_pol.fid-703dc0a5_191866d88cb_-1274,3114501,Carmópolis de Minas - MG,14823,16552,1729,17855,83.02,92.7,9.68
sidra_9541_PercMoradDPPOColetTot_munic_22_pol.fid-703dc0a5_191866d88cb_-1273,3114550,Carneirinho - MG,7601,8312,711,9406,80.81,88.37,7.56
sidra_9541_PercMoradDPPOColetTot_munic_22_pol.fid-703dc0a5_191866d88cb_-1272,3114600,Carrancas - MG,3139,3588,449,3992,78.63,89.88,11.25
sidra_9541_PercMoradDPPOColetTot_munic_22_pol.fid-703dc0a5_191866d88cb_-1271,3114709,Carvalhópolis - MG,3016,3207,191,3319,90.87,96.63,5.75
sidra_9541_PercMoradDPPOColetTot_munic_22_pol.fid-703dc0a5_191866d88cb_-1270,3114808,Carvalhos - MG,2983,3515,532,4387,68,80.12,12.13
sidra_9541_PercMoradDPPOColetTot_munic_22_pol.fid-703dc0a5_191866d88cb_-126f,3114907,Casa Grande - MG,646,1798,1152,2214,29.18,81.21,52.03
sidra_9541_PercMoradDPPOColetTot_munic_22_pol.fid-703dc0a5_191866d88cb_-126e,3115003,Cascalho Rico - MG,1905,2095,190,2685,70.95,78.03,7.08
sidra_9541_PercMoradDPPOColetTot_munic_22_pol.fid-703dc0a5_191866d88cb_-126d,3115102,Cássia - MG,14600,16302,1702,17045,85.66,95.64,9.99
sidra_9541_PercMoradDPPOColetTot_munic_22_pol.fid-703dc0a5_191866d88cb_-126c,2604304,Cedro - PE,8716,8874,158,10517,82.88,84.38,1.5
sidra_9541_PercMoradDPPOColetTot_munic_22_pol.fid-703dc0a5_191866d88cb_-126b,2608453,Lagoa do Carro - PE,14896,15586,690,17969,82.9,86.74,3.84
sidra_9541_PercMoradDPPOColetTot_munic_22_pol.fid-703dc0a5_191866d88cb_-126a,3115201,Conceição da Barra de Minas - MG,2553,3067,514,3541,72.1,86.61,14.52
sidra_9541_PercMoradDPPOColetTot_munic_22_pol.fid-703dc0a5_191866d88cb_-1269,3115300,Cataguases - MG,59504,64679,5175,65998,90.16,98,7.84
sidra_9541_PercMoradDPPOColetTot_munic_22_pol.fid-703dc0a5_191866d88cb_-1268,3115359,Catas Altas - MG,5143,5233,90,5467,94.07,95.72,1.65
sidra_9541_PercMoradDPPOColetTot_munic_22_pol.fid-703dc0a5_191866d88cb_-1267,3115409,Catas Altas da Noruega - MG,945,1613,668,3096,30.52,52.1,21.58
sidra_9541_PercMoradDPPOColetTot_munic_22_pol.fid-703dc0a5_191866d88cb_-1266,3115458,Catuji - MG,3068,3915,847,7027,43.66,55.71,12.05
sidra_9541_PercMoradDPPOColetTot_munic_22_pol.fid-703dc0a5_191866d88cb_-1265,3115474,Catuti - MG,2851,3036,185,4739,60.16,64.06,3.9
sidra_9541_PercMoradDPPOColetTot_munic_22_pol.fid-703dc0a5_191866d88cb_-1264,3115508,Caxambu - MG,19757,20711,954,20943,94.34,98.89,4.56
sidra_9541_PercMoradDPPOColetTot_munic_22_pol.fid-703dc0a5_191866d88cb_-1263,3115607,Cedro do Abaeté - MG,949,1021,72,1081,87.79,94.45,6.66
sidra_9541_PercMoradDPPOColetTot_munic_22_pol.fid-703dc0a5_191866d88cb_-1262,3115706,Central de Minas - MG,4489,5303,814,6159,72.89,86.1,13.22
sidra_9541_PercMoradDPPOColetTot_munic_22_pol.fid-703dc0a5_191866d88cb_-1261,2604403,Chã de Alegria - PE,7580,9170,1590,12983,58.38,70.63,12.25
sidra_9541_PercMoradDPPOColetTot_munic_22_pol.fid-703dc0a5_191866d88cb_-1260,3115805,Centralina - MG,9795,9882,87,10183,96.19,97.04,0.85
sidra_9541_PercMoradDPPOColetTot_munic_22_pol.fid-703dc0a5_191866d88cb_-125f,3115904,Chácara - MG,2435,2889,454,3074,79.21,93.98,14.77
sidra_9541_PercMoradDPPOColetTot_munic_22_pol.fid-703dc0a5_191866d88cb_-125e,3116001,Chalé - MG,3310,4491,1181,5996,55.2,74.9,19.7
sidra_9541_PercMoradDPPOColetTot_munic_22_pol.fid-703dc0a5_191866d88cb_-125d,3116100,Chapada do Norte - MG,4522,4644,122,10336,43.75,44.93,1.18
sidra_9541_PercMoradDPPOColetTot_munic_22_pol.fid-703dc0a5_191866d88cb_-125c,3116159,Chapada Gaúcha - MG,8021,8190,169,12313,65.14,66.52,1.37
sidra_9541_PercMoradDPPOColetTot_munic_22_pol.fid-703dc0a5_191866d88cb_-125b,3116209,Chiador - MG,2448,2491,43,2800,87.43,88.96,1.54
sidra_9541_PercMoradDPPOColetTot_munic_22_pol.fid-703dc0a5_191866d88cb_-125a,3116308,Cipotânea - MG,1007,3638,2631,5535,18.19,65.73,47.53
sidra_9541_PercMoradDPPOColetTot_munic_22_pol.fid-703dc0a5_191866d88cb_-1259,3116407,Claraval - MG,2885,3874,989,4638,62.2,83.53,21.32
sidra_9541_PercMoradDPPOColetTot_munic_22_pol.fid-703dc0a5_191866d88cb_-1258,3116506,Claro dos Poções - MG,5354,5421,67,7162,74.76,75.69,0.94
sidra_9541_PercMoradDPPOColetTot_munic_22_pol.fid-703dc0a5_191866d88cb_-1257,3116605,Cláudio - MG,22392,28330,5938,30033,74.56,94.33,19.77
sidra_9541_PercMoradDPPOColetTot_munic_22_pol.fid-703dc0a5_191866d88cb_-1256,3116704,Coimbra - MG,6141,6801,660,7107,86.41,95.69,9.29
sidra_9541_PercMoradDPPOColetTot_munic_22_pol.fid-703dc0a5_191866d88cb_-1255,3116803,Coluna - MG,4154,4891,737,8107,51.24,60.33,9.09
sidra_9541_PercMoradDPPOColetTot_munic_22_pol.fid-703dc0a5_191866d88cb_-1254,3116902,Comendador Gomes - MG,1816,2096,280,2771,65.54,75.64,10.1
sidra_9541_PercMoradDPPOColetTot_munic_22_pol.fid-703dc0a5_191866d88cb_-1253,3117009,Comercinho - MG,3348,3390,42,6656,50.3,50.93,0.63
sidra_9541_PercMoradDPPOColetTot_munic_22_pol.fid-703dc0a5_191866d88cb_-1252,3117108,Conceição da Aparecida - MG,7469,8538,1069,10337,72.26,82.6,10.34
sidra_9541_PercMoradDPPOColetTot_munic_22_pol.fid-703dc0a5_191866d88cb_-1251,3117207,Conceição das Pedras - MG,2176,2718,542,2772,78.5,98.05,19.55
sidra_9541_PercMoradDPPOColetTot_munic_22_pol.fid-703dc0a5_191866d88cb_-1250,3117306,Conceição das Alagoas - MG,26632,27080,448,28179,94.51,96.1,1.59
sidra_9541_PercMoradDPPOColetTot_munic_22_pol.fid-703dc0a5_191866d88cb_-124f,3117405,Conceição de Ipanema - MG,3184,3291,107,4405,72.28,74.71,2.43
sidra_9541_PercMoradDPPOColetTot_munic_22_pol.fid-703dc0a5_191866d88cb_-124e,3117504,Conceição do Mato Dentro - MG,13843,19557,5714,23139,59.83,84.52,24.69
sidra_9541_PercMoradDPPOColetTot_munic_22_pol.fid-703dc0a5_191866d88cb_-124d,3117603,Conceição do Pará - MG,4750,5134,384,5407,87.85,94.95,7.1
sidra_9541_PercMoradDPPOColetTot_munic_22_pol.fid-703dc0a5_191866d88cb_-124c,3117702,Conceição do Rio Verde - MG,11511,11619,108,12471,92.3,93.17,0.87
sidra_9541_PercMoradDPPOColetTot_munic_22_pol.fid-703dc0a5_191866d88cb_-124b,3117801,Conceição dos Ouros - MG,9504,10514,1010,10851,87.59,96.89,9.31
sidra_9541_PercMoradDPPOColetTot_munic_22_pol.fid-703dc0a5_191866d88cb_-124a,2604502,Chã Grande - PE,7271,17565,10294,20529,35.42,85.56,50.14
sidra_9541_PercMoradDPPOColetTot_munic_22_pol.fid-703dc0a5_191866d88cb_-1249,2604601,Condado - PE,21395,23656,2261,24516,87.27,96.49,9.22
sidra_9541_PercMoradDPPOColetTot_munic_22_pol.fid-703dc0a5_191866d88cb_-1248,3117836,Cônego Marinho - MG,4183,4256,73,7232,57.84,58.85,1.01
sidra_9541_PercMoradDPPOColetTot_munic_22_pol.fid-703dc0a5_191866d88cb_-1247,3117876,Confins - MG,6823,7288,465,7322,93.18,99.54,6.35
sidra_9541_PercMoradDPPOColetTot_munic_22_pol.fid-703dc0a5_191866d88cb_-1246,2604700,Correntes - PE,10607,11260,653,17092,62.06,65.88,3.82
sidra_9541_PercMoradDPPOColetTot_munic_22_pol.fid-703dc0a5_191866d88cb_-1245,2604809,Cortês - PE,6270,8989,2719,10197,61.49,88.15,26.66
sidra_9541_PercMoradDPPOColetTot_munic_22_pol.fid-703dc0a5_191866d88cb_-1244,2615409,Toritama - PE,39553,40245,692,41124,96.18,97.86,1.68
sidra_9541_PercMoradDPPOColetTot_munic_22_pol.fid-703dc0a5_191866d88cb_-1243,3117900,Congonhal - MG,8698,10237,1539,11004,79.04,93.03,13.99
sidra_9541_PercMoradDPPOColetTot_munic_22_pol.fid-703dc0a5_191866d88cb_-1242,3118007,Congonhas - MG,50662,52336,1674,52775,96,99.17,3.17
sidra_9541_PercMoradDPPOColetTot_munic_22_pol.fid-703dc0a5_191866d88cb_-1241,2604908,Cumaru - PE,10069,10405,336,15904,63.31,65.42,2.11
sidra_9541_PercMoradDPPOColetTot_munic_22_pol.fid-703dc0a5_191866d88cb_-1240,2605004,Cupira - PE,19252,22522,3270,23508,81.9,95.81,13.91
sidra_9541_PercMoradDPPOColetTot_munic_22_pol.fid-703dc0a5_191866d88cb_-123f,3118106,Congonhas do Norte - MG,1635,3766,2131,4818,33.94,78.17,44.23
sidra_9541_PercMoradDPPOColetTot_munic_22_pol.fid-703dc0a5_191866d88cb_-123e,3118205,Conquista - MG,5891,6297,406,6662,88.43,94.52,6.09
sidra_9541_PercMoradDPPOColetTot_munic_22_pol.fid-703dc0a5_191866d88cb_-123d,3118304,Conselheiro Lafaiete - MG,126261,129630,3369,131063,96.34,98.91,2.57
sidra_9541_PercMoradDPPOColetTot_munic_22_pol.fid-703dc0a5_191866d88cb_-123c,3118403,Conselheiro Pena - MG,16606,17032,426,20676,80.32,82.38,2.06
sidra_9541_PercMoradDPPOColetTot_munic_22_pol.fid-703dc0a5_191866d88cb_-123b,3118502,Consolação - MG,1137,1485,348,1552,73.26,95.68,22.42
sidra_9541_PercMoradDPPOColetTot_munic_22_pol.fid-703dc0a5_191866d88cb_-123a,3118601,Contagem - MG,599722,617008,17286,619131,96.87,99.66,2.79
sidra_9541_PercMoradDPPOColetTot_munic_22_pol.fid-703dc0a5_191866d88cb_-1239,2605103,Custódia - PE,21160,24876,3716,37671,56.17,66.03,9.86
sidra_9541_PercMoradDPPOColetTot_munic_22_pol.fid-703dc0a5_191866d88cb_-1238,2605152,Dormentes - PE,7045,7895,850,17185,41,45.94,4.95
sidra_9541_PercMoradDPPOColetTot_munic_22_pol.fid-703dc0a5_191866d88cb_-1237,2605202,Escada - PE,41707,50371,8664,59736,69.82,84.32,14.5
sidra_9541_PercMoradDPPOColetTot_munic_22_pol.fid-703dc0a5_191866d88cb_-1236,2605301,Exu - PE,15665,16116,451,31822,49.23,50.64,1.42
sidra_9541_PercMoradDPPOColetTot_munic_22_pol.fid-703dc0a5_191866d88cb_-1235,3118700,Coqueiral - MG,7091,7379,288,8981,78.96,82.16,3.21
sidra_9541_PercMoradDPPOColetTot_munic_22_pol.fid-703dc0a5_191866d88cb_-1234,3118809,Coração de Jesus - MG,11435,12239,804,25315,45.17,48.35,3.18
sidra_9541_PercMoradDPPOColetTot_munic_22_pol.fid-703dc0a5_191866d88cb_-1233,3118908,Cordisburgo - MG,5283,5309,26,7526,70.2,70.54,0.35
sidra_9541_PercMoradDPPOColetTot_munic_22_pol.fid-703dc0a5_191866d88cb_-11be,3119005,Cordislândia - MG,2814,2977,163,3175,88.63,93.76,5.13
sidra_9541_PercMoradDPPOColetTot_munic_22_pol.fid-703dc0a5_191866d88cb_-11bd,3119104,Corinto - MG,20954,21282,328,23403,89.54,90.94,1.4
sidra_9541_PercMoradDPPOColetTot_munic_22_pol.fid-703dc0a5_191866d88cb_-11bc,3119203,Coroaci - MG,4745,6401,1656,10870,43.65,58.89,15.23
sidra_9541_PercMoradDPPOColetTot_munic_22_pol.fid-703dc0a5_191866d88cb_-11bb,3119302,Coromandel - MG,24465,25559,1094,28797,84.96,88.76,3.8
sidra_9541_PercMoradDPPOColetTot_munic_22_pol.fid-703dc0a5_191866d88cb_-11ba,3119401,Coronel Fabriciano - MG,101966,103527,1561,104116,97.94,99.43,1.5
sidra_9541_PercMoradDPPOColetTot_munic_22_pol.fid-703dc0a5_191866d88cb_-11b9,3119500,Coronel Murta - MG,6361,6387,26,8191,77.66,77.98,0.32
sidra_9541_PercMoradDPPOColetTot_munic_22_pol.fid-703dc0a5_191866d88cb_-11b8,2605400,Feira Nova - PE,16618,17494,876,21426,77.56,81.65,4.09
sidra_9541_PercMoradDPPOColetTot_munic_22_pol.fid-703dc0a5_191866d88cb_-11b7,2605459,Fernando de Noronha - PE,2091,2140,49,2147,97.39,99.67,2.28
sidra_9541_PercMoradDPPOColetTot_munic_22_pol.fid-703dc0a5_191866d88cb_-11b5,2605509,Ferreiros - PE,12416,13435,1019,15005,82.75,89.54,6.79
sidra_9541_PercMoradDPPOColetTot_munic_22_pol.fid-703dc0a5_191866d88cb_-11b4,2608503,Lagoa de Itaenga - PE,16062,16819,757,18991,84.58,88.56,3.99
sidra_9541_PercMoradDPPOColetTot_munic_22_pol.fid-703dc0a5_191866d88cb_-11b3,3119609,Coronel Pacheco - MG,2559,2660,101,2759,92.75,96.41,3.66
sidra_9541_PercMoradDPPOColetTot_munic_22_pol.fid-703dc0a5_191866d88cb_-11b2,3119708,Coronel Xavier Chaves - MG,3017,3363,346,3486,86.55,96.47,9.93
sidra_9541_PercMoradDPPOColetTot_munic_22_pol.fid-703dc0a5_191866d88cb_-11b1,3119807,Córrego Danta - MG,2097,2259,162,2925,71.69,77.23,5.54
sidra_9541_PercMoradDPPOColetTot_munic_22_pol.fid-703dc0a5_191866d88cb_-11b0,2605608,Flores - PE,9422,9719,297,20315,46.38,47.84,1.46
sidra_9541_PercMoradDPPOColetTot_munic_22_pol.fid-703dc0a5_191866d88cb_-11af,2605707,Floresta - PE,21715,22050,335,30101,72.14,73.25,1.11
sidra_9541_PercMoradDPPOColetTot_munic_22_pol.fid-703dc0a5_191866d88cb_-11ae,2616506,Xexéu - PE,7758,10168,2410,11610,66.82,87.58,20.76
sidra_9541_PercMoradDPPOColetTot_munic_22_pol.fid-703dc0a5_191866d88cb_-11ad,2700102,Água Branca - AL,7709,8955,1246,19003,40.57,47.12,6.56
sidra_9541_PercMoradDPPOColetTot_munic_22_pol.fid-703dc0a5_191866d88cb_-11ac,2700201,Anadia - AL,10970,11879,909,13966,78.55,85.06,6.51
sidra_9541_PercMoradDPPOColetTot_munic_22_pol.fid-703dc0a5_191866d88cb_-11ab,2605806,Frei Miguelinho - PE,8914,9427,513,13624,65.43,69.19,3.77
sidra_9541_PercMoradDPPOColetTot_munic_22_pol.fid-703dc0a5_191866d88cb_-11aa,2609204,Maraial - PE,6595,7347,752,9353,70.51,78.55,8.04
sidra_9541_PercMoradDPPOColetTot_munic_22_pol.fid-703dc0a5_191866d88cb_-11a9,2700300,Arapiraca - AL,222526,226277,3751,233950,95.12,96.72,1.6
sidra_9541_PercMoradDPPOColetTot_munic_22_pol.fid-703dc0a5_191866d88cb_-11a8,2700409,Atalaia - AL,30229,33708,3479,37455,80.71,90,9.29
sidra_9541_PercMoradDPPOColetTot_munic_22_pol.fid-703dc0a5_191866d88cb_-11a7,2700508,Barra de Santo Antônio - AL,15316,15611,295,16307,93.92,95.73,1.81
sidra_9541_PercMoradDPPOColetTot_munic_22_pol.fid-703dc0a5_191866d88cb_-11a6,2605905,Gameleira - PE,13439,14007,568,18195,73.86,76.98,3.12
sidra_9541_PercMoradDPPOColetTot_munic_22_pol.fid-703dc0a5_191866d88cb_-11a5,2606002,Garanhuns - PE,107325,129659,22334,142079,75.54,91.26,15.72
sidra_9541_PercMoradDPPOColetTot_munic_22_pol.fid-703dc0a5_191866d88cb_-11a4,2700706,Batalha - AL,13365,14485,1120,16434,81.33,88.14,6.82
sidra_9541_PercMoradDPPOColetTot_munic_22_pol.fid-703dc0a5_191866d88cb_-11a3,2700805,Belém - AL,3307,3330,23,4719,70.08,70.57,0.49
sidra_9541_PercMoradDPPOColetTot_munic_22_pol.fid-703dc0a5_191866d88cb_-11a1,2700904,Belo Monte - AL,3435,3464,29,5935,57.88,58.37,0.49
sidra_9541_PercMoradDPPOColetTot_munic_22_pol.fid-703dc0a5_191866d88cb_-11a0,2606101,Glória do Goitá - PE,18215,19096,881,29339,62.08,65.09,3
sidra_9541_PercMoradDPPOColetTot_munic_22_pol.fid-703dc0a5_191866d88cb_-119f,2606200,Goiana - PE,69827,71958,2131,80855,86.36,89,2.64
sidra_9541_PercMoradDPPOColetTot_munic_22_pol.fid-703dc0a5_191866d88cb_-119e,2606309,Granito - PE,3341,3811,470,6945,48.11,54.87,6.77
sidra_9541_PercMoradDPPOColetTot_munic_22_pol.fid-703dc0a5_191866d88cb_-119d,2606408,Gravatá - PE,64642,75300,10658,86322,74.88,87.23,12.35
sidra_9541_PercMoradDPPOColetTot_munic_22_pol.fid-703dc0a5_191866d88cb_-119c,3119906,Córrego do Bom Jesus - MG,3139,4175,1036,4269,73.53,97.8,24.27
sidra_9541_PercMoradDPPOColetTot_munic_22_pol.fid-703dc0a5_191866d88cb_-119b,3119955,Córrego Fundo - MG,5689,5913,224,6107,93.16,96.82,3.67
sidra_9541_PercMoradDPPOColetTot_munic_22_pol.fid-703dc0a5_191866d88cb_-119a,3120003,Córrego Novo - MG,2231,2260,29,2875,77.6,78.61,1.01
sidra_9541_PercMoradDPPOColetTot_munic_22_pol.fid-703dc0a5_191866d88cb_-1199,2606507,Iati - PE,9407,9845,438,17157,54.83,57.38,2.55
sidra_9541_PercMoradDPPOColetTot_munic_22_pol.fid-703dc0a5_191866d88cb_-1198,2606606,Ibimirim - PE,17069,18577,1508,26561,64.26,69.94,5.68
sidra_9541_PercMoradDPPOColetTot_munic_22_pol.fid-703dc0a5_191866d88cb_-1197,2606705,Ibirajuba - PE,4246,4566,320,7140,59.47,63.95,4.48
sidra_9541_PercMoradDPPOColetTot_munic_22_pol.fid-703dc0a5_191866d88cb_-1196,3120102,Couto de Magalhães de Minas - MG,3748,3804,56,4179,89.69,91.03,1.34
sidra_9541_PercMoradDPPOColetTot_munic_22_pol.fid-703dc0a5_191866d88cb_-1195,3120151,Crisólita - MG,2979,3362,383,5260,56.63,63.92,7.28
sidra_9541_PercMoradDPPOColetTot_munic_22_pol.fid-703dc0a5_191866d88cb_-1194,3120201,Cristais - MG,10091,10581,490,12119,83.27,87.31,4.04
sidra_9541_PercMoradDPPOColetTot_munic_22_pol.fid-703dc0a5_191866d88cb_-1192,3120300,Cristália - MG,2803,3000,197,5116,54.79,58.64,3.85
sidra_9541_PercMoradDPPOColetTot_munic_22_pol.fid-703dc0a5_191866d88cb_-1191,3120409,Cristiano Otoni - MG,4070,4358,288,4667,87.21,93.38,6.17
sidra_9541_PercMoradDPPOColetTot_munic_22_pol.fid-703dc0a5_191866d88cb_-1190,3120508,Cristina - MG,8453,9486,1033,10330,81.83,91.83,10
sidra_9541_PercMoradDPPOColetTot_munic_22_pol.fid-703dc0a5_191866d88cb_-118f,3120607,Crucilândia - MG,5035,5228,193,5331,94.45,98.07,3.62
sidra_9541_PercMoradDPPOColetTot_munic_22_pol.fid-703dc0a5_191866d88cb_-118e,2606804,Igarassu - PE,101568,105884,4316,114954,88.36,92.11,3.75
sidra_9541_PercMoradDPPOColetTot_munic_22_pol.fid-703dc0a5_191866d88cb_-118d,3120706,Cruzeiro da Fortaleza - MG,3103,3215,112,3521,88.13,91.31,3.18
sidra_9541_PercMoradDPPOColetTot_munic_22_pol.fid-703dc0a5_191866d88cb_-118c,3120805,Cruzília - MG,14069,14260,191,15271,92.13,93.38,1.25
sidra_9541_PercMoradDPPOColetTot_munic_22_pol.fid-703dc0a5_191866d88cb_-118b,3120839,Cuparaque - MG,3447,3500,53,3980,86.61,87.94,1.33
sidra_9541_PercMoradDPPOColetTot_munic_22_pol.fid-703dc0a5_191866d88cb_-118a,3120870,Curral de Dentro - MG,6390,6403,13,7401,86.34,86.52,0.18
sidra_9541_PercMoradDPPOColetTot_munic_22_pol.fid-703dc0a5_191866d88cb_-1188,3120904,Curvelo - MG,74884,75669,785,80346,93.2,94.18,0.98
sidra_9541_PercMoradDPPOColetTot_munic_22_pol.fid-703dc0a5_191866d88cb_-1186,3121001,Datas - MG,4543,4614,71,5465,83.13,84.43,1.3
sidra_9541_PercMoradDPPOColetTot_munic_22_pol.fid-703dc0a5_191866d88cb_-1185,3121100,Delfim Moreira - MG,7483,7565,82,7949,94.14,95.17,1.03
sidra_9541_PercMoradDPPOColetTot_munic_22_pol.fid-703dc0a5_191866d88cb_-1184,3121209,Delfinópolis - MG,6028,7825,1797,8302,72.61,94.25,21.65
sidra_9541_PercMoradDPPOColetTot_munic_22_pol.fid-703dc0a5_191866d88cb_-1183,3121258,Delta - MG,10274,10301,27,10461,98.21,98.47,0.26
sidra_9541_PercMoradDPPOColetTot_munic_22_pol.fid-703dc0a5_191866d88cb_-1181,2606903,Iguaracy - PE,6113,6141,28,11064,55.25,55.5,0.25
sidra_9541_PercMoradDPPOColetTot_munic_22_pol.fid-703dc0a5_191866d88cb_-1180,2607000,Inajá - PE,8970,10380,1410,25590,35.05,40.56,5.51
sidra_9541_PercMoradDPPOColetTot_munic_22_pol.fid-703dc0a5_191866d88cb_-117f,3121308,Descoberto - MG,4204,4387,183,4898,85.83,89.57,3.74
sidra_9541_PercMoradDPPOColetTot_munic_22_pol.fid-703dc0a5_191866d88cb_-117e,3121407,Desterro de Entre Rios - MG,4646,5142,496,7599,61.14,67.67,6.53
sidra_9541_PercMoradDPPOColetTot_munic_22_pol.fid-703dc0a5_191866d88cb_-117d,3121506,Desterro do Melo - MG,1735,1822,87,2974,58.34,61.26,2.93
sidra_9541_PercMoradDPPOColetTot_munic_22_pol.fid-703dc0a5_191866d88cb_-117c,3121605,Diamantina - MG,36209,42531,6322,47454,76.3,89.63,13.32
sidra_9541_PercMoradDPPOColetTot_munic_22_pol.fid-703dc0a5_191866d88cb_-117b,3121704,Diogo de Vasconcelos - MG,150,2350,2200,3549,4.23,66.22,61.99
sidra_9541_PercMoradDPPOColetTot_munic_22_pol.fid-703dc0a5_191866d88cb_-117a,3121803,Dionísio - MG,5913,6346,433,6831,86.56,92.9,6.34
sidra_9541_PercMoradDPPOColetTot_munic_22_pol.fid-703dc0a5_191866d88cb_-1179,3121902,Divinésia - MG,267,3963,3696,4222,6.32,93.87,87.54
sidra_9541_PercMoradDPPOColetTot_munic_22_pol.fid-703dc0a5_191866d88cb_-1178,3122009,Divino - MG,14787,16509,1722,20501,72.13,80.53,8.4
sidra_9541_PercMoradDPPOColetTot_munic_22_pol.fid-703dc0a5_191866d88cb_-1177,3122108,Divino das Laranjeiras - MG,3197,3577,380,4170,76.67,85.78,9.11
sidra_9541_PercMoradDPPOColetTot_munic_22_pol.fid-703dc0a5_191866d88cb_-1176,3122207,Divinolândia de Minas - MG,5221,5873,652,6514,80.15,90.16,10.01
sidra_9541_PercMoradDPPOColetTot_munic_22_pol.fid-703dc0a5_191866d88cb_-1175,3122306,Divinópolis - MG,221271,227525,6254,229990,96.21,98.93,2.72
sidra_9541_PercMoradDPPOColetTot_munic_22_pol.fid-703dc0a5_191866d88cb_-1173,3122355,Divisa Alegre - MG,6148,6154,6,6313,97.39,97.48,0.1
sidra_9541_PercMoradDPPOColetTot_munic_22_pol.fid-703dc0a5_191866d88cb_-1172,3122405,Divisa Nova - MG,5292,5577,285,5831,90.76,95.64,4.89
sidra_9541_PercMoradDPPOColetTot_munic_22_pol.fid-703dc0a5_191866d88cb_-1171,3122454,Divisópolis - MG,7938,8427,489,10204,77.79,82.59,4.79
sidra_9541_PercMoradDPPOColetTot_munic_22_pol.fid-703dc0a5_191866d88cb_-1170,2607109,Ingazeira - PE,2927,3018,91,4762,61.47,63.38,1.91
sidra_9541_PercMoradDPPOColetTot_munic_22_pol.fid-703dc0a5_191866d88cb_-116f,2607208,Ipojuca - PE,76706,87909,11203,98462,77.9,89.28,11.38
sidra_9541_PercMoradDPPOColetTot_munic_22_pol.fid-703dc0a5_191866d88cb_-116e,3122470,Dom Bosco - MG,2410,2757,347,3697,65.19,74.57,9.39
sidra_9541_PercMoradDPPOColetTot_munic_22_pol.fid-703dc0a5_191866d88cb_-116d,3122504,Dom Cavati - MG,4053,4431,378,4870,83.22,90.99,7.76
sidra_9541_PercMoradDPPOColetTot_munic_22_pol.fid-703dc0a5_191866d88cb_-116c,3122603,Dom Joaquim - MG,3243,3669,426,4895,66.25,74.95,8.7
sidra_9541_PercMoradDPPOColetTot_munic_22_pol.fid-703dc0a5_191866d88cb_-116b,3122702,Dom Silvério - MG,4550,4589,39,5201,87.48,88.23,0.75
sidra_9541_PercMoradDPPOColetTot_munic_22_pol.fid-703dc0a5_191866d88cb_-116a,3122801,Dom Viçoso - MG,2376,2788,412,3095,76.77,90.08,13.31
sidra_9541_PercMoradDPPOColetTot_munic_22_pol.fid-703dc0a5_191866d88cb_-1169,3122900,Dona Euzébia - MG,5345,5439,94,6092,87.74,89.28,1.54
sidra_9541_PercMoradDPPOColetTot_munic_22_pol.fid-703dc0a5_191866d88cb_-1168,3123007,Dores de Campos - MG,8205,9595,1390,10005,82.01,95.9,13.89
sidra_9541_PercMoradDPPOColetTot_munic_22_pol.fid-703dc0a5_191866d88cb_-1167,3123106,Dores de Guanhães - MG,2494,3356,862,5029,49.59,66.73,17.14
sidra_9541_PercMoradDPPOColetTot_munic_22_pol.fid-703dc0a5_191866d88cb_-1166,3123205,Dores do Indaiá - MG,11815,11974,159,12530,94.29,95.56,1.27
sidra_9541_PercMoradDPPOColetTot_munic_22_pol.fid-703dc0a5_191866d88cb_-1165,3123304,Dores do Turvo - MG,2126,3876,1750,4976,42.73,77.89,35.17
sidra_9541_PercMoradDPPOColetTot_munic_22_pol.fid-703dc0a5_191866d88cb_-1164,3123403,Doresópolis - MG,1187,1281,94,1461,81.25,87.68,6.43
sidra_9541_PercMoradDPPOColetTot_munic_22_pol.fid-703dc0a5_191866d88cb_-1163,3123502,Douradoquara - MG,1452,1485,33,1829,79.39,81.19,1.8
sidra_9541_PercMoradDPPOColetTot_munic_22_pol.fid-703dc0a5_191866d88cb_-1162,3123528,Durandé - MG,1319,6317,4998,7811,16.89,80.87,63.99
sidra_9541_PercMoradDPPOColetTot_munic_22_pol.fid-703dc0a5_191866d88cb_-1160,3123601,Elói Mendes - MG,22355,24755,2400,26240,85.19,94.34,9.15
sidra_9541_PercMoradDPPOColetTot_munic_22_pol.fid-703dc0a5_191866d88cb_-115f,3123700,Engenheiro Caldas - MG,10575,10698,123,13602,77.75,78.65,0.9
sidra_9541_PercMoradDPPOColetTot_munic_22_pol.fid-703dc0a5_191866d88cb_-115e,3123809,Engenheiro Navarro - MG,5098,5133,35,6351,80.27,80.82,0.55
sidra_9541_PercMoradDPPOColetTot_munic_22_pol.fid-703dc0a5_191866d88cb_-115d,3123858,Entre Folhas - MG,3994,4222,228,5177,77.15,81.55,4.4
sidra_9541_PercMoradDPPOColetTot_munic_22_pol.fid-703dc0a5_191866d88cb_-115c,2607604,Ilha de Itamaracá - PE,11570,13744,2174,21539,53.72,63.81,10.09
sidra_9541_PercMoradDPPOColetTot_munic_22_pol.fid-703dc0a5_191866d88cb_-115b,2607653,Itambé - PE,27963,31123,3160,34889,80.15,89.21,9.06
sidra_9541_PercMoradDPPOColetTot_munic_22_pol.fid-703dc0a5_191866d88cb_-115a,3123908,Entre Rios de Minas - MG,12517,13662,1145,14700,85.15,92.94,7.79
sidra_9541_PercMoradDPPOColetTot_munic_22_pol.fid-703dc0a5_191866d88cb_-1159,3124005,Ervália - MG,3497,16447,12950,20115,17.39,81.76,64.38
sidra_9541_PercMoradDPPOColetTot_munic_22_pol.fid-703dc0a5_191866d88cb_-1157,3124104,Esmeraldas - MG,74822,80046,5224,85407,87.61,93.72,6.12
sidra_9541_PercMoradDPPOColetTot_munic_22_pol.fid-703dc0a5_191866d88cb_-1156,3124203,Espera Feliz - MG,18459,21956,3497,24006,76.89,91.46,14.57
sidra_9541_PercMoradDPPOColetTot_munic_22_pol.fid-703dc0a5_191866d88cb_-1155,3124302,Espinosa - MG,19368,19577,209,30412,63.69,64.37,0.69
sidra_9541_PercMoradDPPOColetTot_munic_22_pol.fid-703dc0a5_191866d88cb_-1154,3124401,Espírito Santo do Dourado - MG,3529,5494,1965,6099,57.86,90.08,32.22
sidra_9541_PercMoradDPPOColetTot_munic_22_pol.fid-703dc0a5_191866d88cb_-1153,3124500,Estiva - MG,9746,10666,920,11468,84.98,93.01,8.02
sidra_9541_PercMoradDPPOColetTot_munic_22_pol.fid-703dc0a5_191866d88cb_-1152,3124609,Estrela Dalva - MG,428,2054,1626,2181,19.62,94.18,74.55
sidra_9541_PercMoradDPPOColetTot_munic_22_pol.fid-703dc0a5_191866d88cb_-1151,3124708,Estrela do Indaiá - MG,2371,2473,102,2753,86.12,89.83,3.71
sidra_9541_PercMoradDPPOColetTot_munic_22_pol.fid-703dc0a5_191866d88cb_-114f,3124807,Estrela do Sul - MG,5699,5993,294,6812,83.66,87.98,4.32
sidra_9541_PercMoradDPPOColetTot_munic_22_pol.fid-703dc0a5_191866d88cb_-114e,3124906,Eugenópolis - MG,8291,9422,1131,10617,78.09,88.74,10.65
sidra_9541_PercMoradDPPOColetTot_munic_22_pol.fid-703dc0a5_191866d88cb_-114d,3125002,Ewbank da Câmara - MG,3652,3756,104,3867,94.44,97.13,2.69
sidra_9541_PercMoradDPPOColetTot_munic_22_pol.fid-703dc0a5_191866d88cb_-114c,3125101,Extrema - MG,39659,52686,13027,53188,74.56,99.06,24.49
sidra_9541_PercMoradDPPOColetTot_munic_22_pol.fid-703dc0a5_191866d88cb_-114b,3125200,Fama - MG,2021,2473,452,2578,78.39,95.93,17.53
sidra_9541_PercMoradDPPOColetTot_munic_22_pol.fid-703dc0a5_191866d88cb_-114a,3125309,Faria Lemos - MG,2615,2856,241,3186,82.08,89.64,7.56
sidra_9541_PercMoradDPPOColetTot_munic_22_pol.fid-703dc0a5_191866d88cb_-1149,3125408,Felício dos Santos - MG,2771,2957,186,5128,54.04,57.66,3.63
sidra_9541_PercMoradDPPOColetTot_munic_22_pol.fid-703dc0a5_191866d88cb_-1148,3125507,São Gonçalo do Rio Preto - MG,1895,2330,435,3003,63.1,77.59,14.49
sidra_9541_PercMoradDPPOColetTot_munic_22_pol.fid-703dc0a5_191866d88cb_-1147,3125606,Felisburgo - MG,5197,5287,90,6465,80.39,81.78,1.39
sidra_9541_PercMoradDPPOColetTot_munic_22_pol.fid-703dc0a5_191866d88cb_-1146,3125705,Felixlândia - MG,11146,11974,828,13923,80.05,86,5.95
sidra_9541_PercMoradDPPOColetTot_munic_22_pol.fid-703dc0a5_191866d88cb_-1144,3125804,Fernandes Tourinho - MG,2330,2479,149,2785,83.66,89.01,5.35
sidra_9541_PercMoradDPPOColetTot_munic_22_pol.fid-703dc0a5_191866d88cb_-1143,3125903,Ferros - MG,3545,4820,1275,9551,37.12,50.47,13.35
sidra_9541_PercMoradDPPOColetTot_munic_22_pol.fid-703dc0a5_191866d88cb_-1142,3125952,Fervedouro - MG,6794,7411,617,10387,65.41,71.35,5.94
sidra_9541_PercMoradDPPOColetTot_munic_22_pol.fid-703dc0a5_191866d88cb_-1140,3126000,Florestal - MG,6939,7402,463,8013,86.6,92.37,5.78
sidra_9541_PercMoradDPPOColetTot_munic_22_pol.fid-703dc0a5_191866d88cb_-113f,3126109,Formiga - MG,62279,65249,2970,67578,92.16,96.55,4.39
sidra_9541_PercMoradDPPOColetTot_munic_22_pol.fid-703dc0a5_191866d88cb_-113d,3126208,Formoso - MG,5373,5397,24,7903,67.99,68.29,0.3
sidra_9541_PercMoradDPPOColetTot_munic_22_pol.fid-703dc0a5_191866d88cb_-113c,3126307,Fortaleza de Minas - MG,3281,3315,34,3476,94.39,95.37,0.98
sidra_9541_PercMoradDPPOColetTot_munic_22_pol.fid-703dc0a5_191866d88cb_-113b,3126406,Fortuna de Minas - MG,2803,2827,24,3093,90.62,91.4,0.78
sidra_9541_PercMoradDPPOColetTot_munic_22_pol.fid-703dc0a5_191866d88cb_-113a,2607703,Itapetim - PE,5824,9281,3457,13781,42.26,67.35,25.09
sidra_9541_PercMoradDPPOColetTot_munic_22_pol.fid-703dc0a5_191866d88cb_-1139,3126505,Francisco Badaró - MG,3701,3788,87,7363,50.26,51.45,1.18
sidra_9541_PercMoradDPPOColetTot_munic_22_pol.fid-703dc0a5_191866d88cb_-1137,3126604,Francisco Dumont - MG,2888,3539,651,4486,64.38,78.89,14.51
sidra_9541_PercMoradDPPOColetTot_munic_22_pol.fid-703dc0a5_191866d88cb_-1136,3126703,Francisco Sá - MG,14995,15500,505,22891,65.51,67.71,2.21
sidra_9541_PercMoradDPPOColetTot_munic_22_pol.fid-703dc0a5_191866d88cb_-1135,3126752,Franciscópolis - MG,2307,2540,233,5034,45.83,50.46,4.63
sidra_9541_PercMoradDPPOColetTot_munic_22_pol.fid-703dc0a5_191866d88cb_-1134,3126802,Frei Gaspar - MG,3253,3471,218,5640,57.68,61.54,3.87
sidra_9541_PercMoradDPPOColetTot_munic_22_pol.fid-703dc0a5_191866d88cb_-1133,3126901,Frei Inocêncio - MG,6454,6482,28,8111,79.57,79.92,0.35
sidra_9541_PercMoradDPPOColetTot_munic_22_pol.fid-703dc0a5_191866d88cb_-1132,3126950,Frei Lagonegro - MG,1503,1708,205,3391,44.32,50.37,6.05
sidra_9541_PercMoradDPPOColetTot_munic_22_pol.fid-703dc0a5_191866d88cb_-1131,3127008,Fronteira - MG,13720,14106,386,14535,94.39,97.05,2.66
sidra_9541_PercMoradDPPOColetTot_munic_22_pol.fid-703dc0a5_191866d88cb_-1130,3127057,Fronteira dos Vales - MG,3041,3061,20,4343,70.02,70.48,0.46
sidra_9541_PercMoradDPPOColetTot_munic_22_pol.fid-703dc0a5_191866d88cb_-112f,3127073,Fruta de Leite - MG,2748,2770,22,4639,59.24,59.71,0.47
sidra_9541_PercMoradDPPOColetTot_munic_22_pol.fid-703dc0a5_191866d88cb_-112e,3127107,Frutal - MG,55044,55738,694,58194,94.59,95.78,1.19
sidra_9541_PercMoradDPPOColetTot_munic_22_pol.fid-703dc0a5_191866d88cb_-112c,3127206,Funilândia - MG,4162,4346,184,4682,88.89,92.82,3.93
sidra_9541_PercMoradDPPOColetTot_munic_22_pol.fid-703dc0a5_191866d88cb_-112b,3127305,Galiléia - MG,3332,4952,1620,6201,53.73,79.86,26.12
sidra_9541_PercMoradDPPOColetTot_munic_22_pol.fid-703dc0a5_191866d88cb_-112a,3127339,Gameleiras - MG,2731,2741,10,4780,57.13,57.34,0.21
sidra_9541_PercMoradDPPOColetTot_munic_22_pol.fid-703dc0a5_191866d88cb_-1129,3127354,Glaucilândia - MG,1740,1754,14,2928,59.43,59.9,0.48
sidra_9541_PercMoradDPPOColetTot_munic_22_pol.fid-703dc0a5_191866d88cb_-1128,3127370,Goiabeira - MG,2335,2350,15,2830,82.51,83.04,0.53
sidra_9541_PercMoradDPPOColetTot_munic_22_pol.fid-703dc0a5_191866d88cb_-1127,3127388,Goianá - MG,3159,3787,628,4049,78.02,93.53,15.51
sidra_9541_PercMoradDPPOColetTot_munic_22_pol.fid-703dc0a5_191866d88cb_-1126,3127404,Gonçalves - MG,2068,4606,2538,4717,43.84,97.65,53.81
sidra_9541_PercMoradDPPOColetTot_munic_22_pol.fid-703dc0a5_191866d88cb_-1125,3127503,Gonzaga - MG,3458,3493,35,5180,66.76,67.43,0.68
sidra_9541_PercMoradDPPOColetTot_munic_22_pol.fid-703dc0a5_191866d88cb_-1124,3127602,Gouveia - MG,9432,9572,140,11296,83.5,84.74,1.24
sidra_9541_PercMoradDPPOColetTot_munic_22_pol.fid-703dc0a5_191866d88cb_-1123,3127701,Governador Valadares - MG,244329,248898,4569,255251,95.72,97.51,1.79
sidra_9541_PercMoradDPPOColetTot_munic_22_pol.fid-703dc0a5_191866d88cb_-1122,3127800,Grão Mogol - MG,7117,7621,504,13845,51.4,55.05,3.64
sidra_9541_PercMoradDPPOColetTot_munic_22_pol.fid-703dc0a5_191866d88cb_-1121,3127909,Grupiara - MG,1198,1316,118,1392,86.06,94.54,8.48
sidra_9541_PercMoradDPPOColetTot_munic_22_pol.fid-703dc0a5_191866d88cb_-111f,2607752,Itapissuma - PE,22497,23281,784,23986,93.79,97.06,3.27
sidra_9541_PercMoradDPPOColetTot_munic_22_pol.fid-703dc0a5_191866d88cb_-111e,2607802,Itaquitinga - PE,12021,12990,969,15476,77.68,83.94,6.26
sidra_9541_PercMoradDPPOColetTot_munic_22_pol.fid-703dc0a5_191866d88cb_-111d,2607950,Jaqueira - PE,5164,6735,1571,10240,50.43,65.77,15.34
sidra_9541_PercMoradDPPOColetTot_munic_22_pol.fid-703dc0a5_191866d88cb_-111c,2609501,Nazaré da Mata - PE,23409,25436,2027,30545,76.64,83.27,6.64
sidra_9541_PercMoradDPPOColetTot_munic_22_pol.fid-703dc0a5_191866d88cb_-111b,2609600,Olinda - PE,304560,328595,24035,349263,87.2,94.08,6.88
sidra_9541_PercMoradDPPOColetTot_munic_22_pol.fid-703dc0a5_191866d88cb_-111a,2609709,Orobó - PE,8275,14823,6548,21758,38.03,68.13,30.09
sidra_9541_PercMoradDPPOColetTot_munic_22_pol.fid-703dc0a5_191866d88cb_-1119,3128006,Guanhães - MG,26606,28235,1629,32085,82.92,88,5.08
sidra_9541_PercMoradDPPOColetTot_munic_22_pol.fid-703dc0a5_191866d88cb_-1118,3128105,Guapé - MG,9843,11338,1495,13726,71.71,82.6,10.89
sidra_9541_PercMoradDPPOColetTot_munic_22_pol.fid-703dc0a5_191866d88cb_-1117,3128204,Guaraciaba - MG,5344,6346,1002,9706,55.06,65.38,10.32
sidra_9541_PercMoradDPPOColetTot_munic_22_pol.fid-703dc0a5_191866d88cb_-1115,3128253,Guaraciama - MG,3309,3343,34,5046,65.58,66.25,0.67
sidra_9541_PercMoradDPPOColetTot_munic_22_pol.fid-703dc0a5_191866d88cb_-1114,3128303,Guaranésia - MG,17445,18478,1033,18834,92.63,98.11,5.48
sidra_9541_PercMoradDPPOColetTot_munic_22_pol.fid-703dc0a5_191866d88cb_-1113,3128402,Guarani - MG,6475,6647,172,7674,84.38,86.62,2.24
sidra_9541_PercMoradDPPOColetTot_munic_22_pol.fid-703dc0a5_191866d88cb_-1112,2608008,Jataúba - PE,5290,10162,4872,15802,33.48,64.31,30.83
sidra_9541_PercMoradDPPOColetTot_munic_22_pol.fid-703dc0a5_191866d88cb_-1111,2608057,Jatobá - PE,9424,10180,756,13990,67.36,72.77,5.4
sidra_9541_PercMoradDPPOColetTot_munic_22_pol.fid-703dc0a5_191866d88cb_-1110,2608107,João Alfredo - PE,15239,17261,2022,27720,54.97,62.27,7.29
sidra_9541_PercMoradDPPOColetTot_munic_22_pol.fid-703dc0a5_191866d88cb_-110f,3128501,Guarará - MG,2908,2941,33,3149,92.35,93.39,1.05
sidra_9541_PercMoradDPPOColetTot_munic_22_pol.fid-703dc0a5_191866d88cb_-110e,3128600,Guarda-Mor - MG,4353,5122,769,6501,66.96,78.79,11.83
sidra_9541_PercMoradDPPOColetTot_munic_22_pol.fid-703dc0a5_191866d88cb_-110d,3128709,Guaxupé - MG,48121,50358,2237,50695,94.92,99.34,4.41
sidra_9541_PercMoradDPPOColetTot_munic_22_pol.fid-703dc0a5_191866d88cb_-110c,3128808,Guidoval - MG,4807,6180,1373,7103,67.68,87.01,19.33
sidra_9541_PercMoradDPPOColetTot_munic_22_pol.fid-703dc0a5_191866d88cb_-110b,3128907,Guimarânia - MG,7133,7577,444,8455,84.36,89.62,5.25
sidra_9541_PercMoradDPPOColetTot_munic_22_pol.fid-703dc0a5_191866d88cb_-110a,3129004,Guiricema - MG,5133,6367,1234,7761,66.14,82.04,15.9
sidra_9541_PercMoradDPPOColetTot_munic_22_pol.fid-703dc0a5_191866d88cb_-1108,2608206,Joaquim Nabuco - PE,7566,10529,2963,13266,57.03,79.37,22.34
sidra_9541_PercMoradDPPOColetTot_munic_22_pol.fid-703dc0a5_191866d88cb_-1107,3129103,Gurinhatã - MG,2574,3152,578,5166,49.83,61.01,11.19
sidra_9541_PercMoradDPPOColetTot_munic_22_pol.fid-703dc0a5_191866d88cb_-1106,3129202,Heliodora - MG,5561,6009,448,6103,91.12,98.46,7.34
sidra_9541_PercMoradDPPOColetTot_munic_22_pol.fid-703dc0a5_191866d88cb_-1105,3129301,Iapu - MG,9198,9964,766,12002,76.64,83.02,6.38
sidra_9541_PercMoradDPPOColetTot_munic_22_pol.fid-703dc0a5_191866d88cb_-1104,3129400,Ibertioga - MG,4506,4566,60,5143,87.61,88.78,1.17
sidra_9541_PercMoradDPPOColetTot_munic_22_pol.fid-703dc0a5_191866d88cb_-1103,3129509,Ibiá - MG,18369,19850,1481,22093,83.14,89.85,6.7
sidra_9541_PercMoradDPPOColetTot_munic_22_pol.fid-703dc0a5_191866d88cb_-1102,3129608,Ibiaí - MG,5452,5504,52,6279,86.83,87.66,0.83
sidra_9541_PercMoradDPPOColetTot_munic_22_pol.fid-703dc0a5_191866d88cb_-1101,3129657,Ibiracatu - MG,3393,3410,17,5081,66.78,67.11,0.33
sidra_9541_PercMoradDPPOColetTot_munic_22_pol.fid-703dc0a5_191866d88cb_-1100,3129707,Ibiraci - MG,8582,10689,2107,10916,78.62,97.92,19.3
sidra_9541_PercMoradDPPOColetTot_munic_22_pol.fid-703dc0a5_191866d88cb_-10ff,3129806,Ibirité - MG,162444,169455,7011,170250,95.41,99.53,4.12
sidra_9541_PercMoradDPPOColetTot_munic_22_pol.fid-703dc0a5_191866d88cb_-10fe,3129905,Ibitiúra de Minas - MG,2893,3181,288,3320,87.14,95.81,8.67
sidra_9541_PercMoradDPPOColetTot_munic_22_pol.fid-703dc0a5_191866d88cb_-10fd,3130002,Ibituruna - MG,2524,2532,8,2670,94.53,94.83,0.3
sidra_9541_PercMoradDPPOColetTot_munic_22_pol.fid-703dc0a5_191866d88cb_-10fc,3130051,Icaraí de Minas - MG,5215,5660,445,10673,48.86,53.03,4.17
sidra_9541_PercMoradDPPOColetTot_munic_22_pol.fid-703dc0a5_191866d88cb_-10fa,3130101,Igarapé - MG,41518,45074,3556,45760,90.73,98.5,7.77
sidra_9541_PercMoradDPPOColetTot_munic_22_pol.fid-703dc0a5_191866d88cb_-10f9,3130200,Igaratinga - MG,9536,10282,746,10773,88.52,95.44,6.92
sidra_9541_PercMoradDPPOColetTot_munic_22_pol.fid-703dc0a5_191866d88cb_-10f8,3130309,Iguatama - MG,6099,6238,139,6801,89.68,91.72,2.04
sidra_9541_PercMoradDPPOColetTot_munic_22_pol.fid-703dc0a5_191866d88cb_-10f7,3130408,Ijaci - MG,6058,6668,610,6992,86.64,95.37,8.72
sidra_9541_PercMoradDPPOColetTot_munic_22_pol.fid-703dc0a5_191866d88cb_-10f6,3130507,Ilicínea - MG,9721,11169,1448,12715,76.45,87.84,11.39
sidra_9541_PercMoradDPPOColetTot_munic_22_pol.fid-703dc0a5_191866d88cb_-10f4,3130556,Imbé de Minas - MG,2767,5358,2591,6976,39.66,76.81,37.14
sidra_9541_PercMoradDPPOColetTot_munic_22_pol.fid-703dc0a5_191866d88cb_-10f3,3130606,Inconfidentes - MG,6024,7183,1159,7301,82.51,98.38,15.87
sidra_9541_PercMoradDPPOColetTot_munic_22_pol.fid-703dc0a5_191866d88cb_-10f2,3130655,Indaiabira - MG,3213,3282,69,6344,50.65,51.73,1.09
sidra_9541_PercMoradDPPOColetTot_munic_22_pol.fid-703dc0a5_191866d88cb_-10f1,3130705,Indianópolis - MG,4373,5278,905,6106,71.62,86.44,14.82
sidra_9541_PercMoradDPPOColetTot_munic_22_pol.fid-703dc0a5_191866d88cb_-10ef,3130804,Ingaí - MG,1893,2017,124,2555,74.09,78.94,4.85
sidra_9541_PercMoradDPPOColetTot_munic_22_pol.fid-703dc0a5_191866d88cb_-10ee,3130903,Inhapim - MG,12646,16657,4011,22509,56.18,74,17.82
sidra_9541_PercMoradDPPOColetTot_munic_22_pol.fid-703dc0a5_191866d88cb_-10ed,3131000,Inhaúma - MG,5592,5989,397,6239,89.63,95.99,6.36
sidra_9541_PercMoradDPPOColetTot_munic_22_pol.fid-703dc0a5_191866d88cb_-10ec,3131109,Inimutaba - MG,6076,6121,45,7346,82.71,83.32,0.61
sidra_9541_PercMoradDPPOColetTot_munic_22_pol.fid-703dc0a5_191866d88cb_-10eb,3131158,Ipaba - MG,15510,15695,185,15946,97.27,98.43,1.16
sidra_9541_PercMoradDPPOColetTot_munic_22_pol.fid-703dc0a5_191866d88cb_-10ea,3131208,Ipanema - MG,16025,17237,1212,19457,82.36,88.59,6.23
sidra_9541_PercMoradDPPOColetTot_munic_22_pol.fid-703dc0a5_191866d88cb_-10e9,3131307,Ipatinga - MG,225324,226890,1566,227309,99.13,99.82,0.69
sidra_9541_PercMoradDPPOColetTot_munic_22_pol.fid-703dc0a5_191866d88cb_-10e7,2608255,Jucati - PE,5264,5513,249,11513,45.72,47.89,2.16
sidra_9541_PercMoradDPPOColetTot_munic_22_pol.fid-703dc0a5_191866d88cb_-10e6,2608305,Jupi - PE,10613,10838,225,15323,69.26,70.73,1.47
sidra_9541_PercMoradDPPOColetTot_munic_22_pol.fid-703dc0a5_191866d88cb_-10e5,2608404,Jurema - PE,10190,11102,912,13648,74.66,81.35,6.68
sidra_9541_PercMoradDPPOColetTot_munic_22_pol.fid-703dc0a5_191866d88cb_-10e4,3131406,Ipiaçu - MG,3491,3496,5,3753,93.02,93.15,0.13
sidra_9541_PercMoradDPPOColetTot_munic_22_pol.fid-703dc0a5_191866d88cb_-10e3,3131505,Ipuiúna - MG,6664,8223,1559,9088,73.33,90.48,17.15
sidra_9541_PercMoradDPPOColetTot_munic_22_pol.fid-703dc0a5_191866d88cb_-10e2,3131604,Iraí de Minas - MG,6367,6818,451,7172,88.78,95.06,6.29
sidra_9541_PercMoradDPPOColetTot_munic_22_pol.fid-703dc0a5_191866d88cb_-10e1,3131703,Itabira - MG,105686,110024,4338,113151,93.4,97.24,3.83
sidra_9541_PercMoradDPPOColetTot_munic_22_pol.fid-703dc0a5_191866d88cb_-10e0,3131802,Itabirinha - MG,7861,8789,928,10351,75.94,84.91,8.97
sidra_9541_PercMoradDPPOColetTot_munic_22_pol.fid-703dc0a5_191866d88cb_-10df,3131901,Itabirito - MG,47885,52669,4784,53144,90.1,99.11,9
sidra_9541_PercMoradDPPOColetTot_munic_22_pol.fid-703dc0a5_191866d88cb_-10dd,3132008,Itacambira - MG,1416,1787,371,4252,33.3,42.03,8.73
sidra_9541_PercMoradDPPOColetTot_munic_22_pol.fid-703dc0a5_191866d88cb_-10dc,3132107,Itacarambi - MG,13590,13823,233,17120,79.38,80.74,1.36
sidra_9541_PercMoradDPPOColetTot_munic_22_pol.fid-703dc0a5_191866d88cb_-10db,3132206,Itaguara - MG,11118,12730,1612,13789,80.63,92.32,11.69
sidra_9541_PercMoradDPPOColetTot_munic_22_pol.fid-703dc0a5_191866d88cb_-10d9,3132305,Itaipé - MG,4660,5382,722,10426,44.7,51.62,6.93
sidra_9541_PercMoradDPPOColetTot_munic_22_pol.fid-703dc0a5_191866d88cb_-10d8,3132404,Itajubá - MG,86460,91815,5355,91969,94.01,99.83,5.82
sidra_9541_PercMoradDPPOColetTot_munic_22_pol.fid-703dc0a5_191866d88cb_-10d7,3132503,Itamarandiba - MG,24960,25108,148,32787,76.13,76.58,0.45
sidra_9541_PercMoradDPPOColetTot_munic_22_pol.fid-703dc0a5_191866d88cb_-10d6,3132602,Itamarati de Minas - MG,3002,3443,441,3686,81.44,93.41,11.96
sidra_9541_PercMoradDPPOColetTot_munic_22_pol.fid-703dc0a5_191866d88cb_-10d5,3132701,Itambacuri - MG,12433,15183,2750,20820,59.72,72.93,13.21
sidra_9541_PercMoradDPPOColetTot_munic_22_pol.fid-703dc0a5_191866d88cb_-10d4,2608602,Lagoa do Ouro - PE,6133,7600,1467,11905,51.52,63.84,12.32
sidra_9541_PercMoradDPPOColetTot_munic_22_pol.fid-703dc0a5_191866d88cb_-10d3,2611309,Pombos - PE,13220,19665,6445,27549,47.99,71.38,23.39
sidra_9541_PercMoradDPPOColetTot_munic_22_pol.fid-703dc0a5_191866d88cb_-10d2,3132800,Itambé do Mato Dentro - MG,965,1480,515,2137,45.16,69.26,24.1
sidra_9541_PercMoradDPPOColetTot_munic_22_pol.fid-703dc0a5_191866d88cb_-10d1,3132909,Itamogi - MG,8513,10334,1821,10734,79.31,96.27,16.96
sidra_9541_PercMoradDPPOColetTot_munic_22_pol.fid-703dc0a5_191866d88cb_-10d0,3133006,Itamonte - MG,12985,14409,1424,14758,87.99,97.64,9.65
sidra_9541_PercMoradDPPOColetTot_munic_22_pol.fid-703dc0a5_191866d88cb_-10cf,3133105,Itanhandu - MG,14641,15187,546,15208,96.27,99.86,3.59
sidra_9541_PercMoradDPPOColetTot_munic_22_pol.fid-703dc0a5_191866d88cb_-10ce,3133204,Itanhomi - MG,9071,9325,254,11120,81.57,83.86,2.28
sidra_9541_PercMoradDPPOColetTot_munic_22_pol.fid-703dc0a5_191866d88cb_-10cc,3133303,Itaobim - MG,15548,15630,82,18949,82.05,82.48,0.43
sidra_9541_PercMoradDPPOColetTot_munic_22_pol.fid-703dc0a5_191866d88cb_-10cb,3133402,Itapagipe - MG,10769,12171,1402,13460,80.01,90.42,10.42
sidra_9541_PercMoradDPPOColetTot_munic_22_pol.fid-703dc0a5_191866d88cb_-10ca,3133501,Itapecerica - MG,18160,18540,380,20943,86.71,88.53,1.81
sidra_9541_PercMoradDPPOColetTot_munic_22_pol.fid-703dc0a5_191866d88cb_-10c9,2608701,Lagoa dos Gatos - PE,8889,9905,1016,14067,63.19,70.41,7.22
sidra_9541_PercMoradDPPOColetTot_munic_22_pol.fid-703dc0a5_191866d88cb_-10c8,2608750,Lagoa Grande - PE,17240,18033,793,24040,71.71,75.01,3.3
sidra_9541_PercMoradDPPOColetTot_munic_22_pol.fid-703dc0a5_191866d88cb_-10c7,2608800,Lajedo - PE,32603,33469,866,39464,82.61,84.81,2.19
sidra_9541_PercMoradDPPOColetTot_munic_22_pol.fid-703dc0a5_191866d88cb_-10c6,2612406,Sanharó - PE,11068,15768,4700,18622,59.44,84.67,25.24
sidra_9541_PercMoradDPPOColetTot_munic_22_pol.fid-703dc0a5_191866d88cb_-10c5,2612455,Santa Cruz - PE,4059,5742,1683,13835,29.34,41.5,12.16
sidra_9541_PercMoradDPPOColetTot_munic_22_pol.fid-703dc0a5_191866d88cb_-10c4,3133600,Itapeva - MG,9060,12314,3254,12625,71.76,97.54,25.77
sidra_9541_PercMoradDPPOColetTot_munic_22_pol.fid-703dc0a5_191866d88cb_-10c3,3133709,Itatiaiuçu - MG,11242,12265,1023,12840,87.55,95.52,7.97
sidra_9541_PercMoradDPPOColetTot_munic_22_pol.fid-703dc0a5_191866d88cb_-10c2,2608909,Limoeiro - PE,47375,49230,1855,55278,85.7,89.06,3.36
sidra_9541_PercMoradDPPOColetTot_munic_22_pol.fid-703dc0a5_191866d88cb_-10c1,2609006,Macaparana - PE,12542,19230,6688,23804,52.69,80.78,28.1
sidra_9541_PercMoradDPPOColetTot_munic_22_pol.fid-703dc0a5_191866d88cb_-10c0,3133758,Itaú de Minas - MG,13974,14193,219,14376,97.2,98.73,1.52
sidra_9541_PercMoradDPPOColetTot_munic_22_pol.fid-703dc0a5_191866d88cb_-10bf,3133808,Itaúna - MG,94211,96302,2091,96888,97.24,99.4,2.16
sidra_9541_PercMoradDPPOColetTot_munic_22_pol.fid-703dc0a5_191866d88cb_-10be,3133907,Itaverava - MG,3531,3722,191,5640,62.61,65.99,3.39
sidra_9541_PercMoradDPPOColetTot_munic_22_pol.fid-703dc0a5_191866d88cb_-10bd,3134004,Itinga - MG,8674,8933,259,13717,63.24,65.12,1.89
sidra_9541_PercMoradDPPOColetTot_munic_22_pol.fid-703dc0a5_191866d88cb_-10bc,3134103,Itueta - MG,3730,3911,181,6055,61.6,64.59,2.99
sidra_9541_PercMoradDPPOColetTot_munic_22_pol.fid-703dc0a5_191866d88cb_-10bb,3134202,Ituiutaba - MG,98455,99959,1504,101934,96.59,98.06,1.48
sidra_9541_PercMoradDPPOColetTot_munic_22_pol.fid-703dc0a5_191866d88cb_-10ba,2609105,Machados - PE,6957,9319,2362,11327,61.42,82.27,20.85
sidra_9541_PercMoradDPPOColetTot_munic_22_pol.fid-703dc0a5_191866d88cb_-10b9,2609154,Manari - PE,6018,7370,1352,23751,25.34,31.03,5.69
sidra_9541_PercMoradDPPOColetTot_munic_22_pol.fid-703dc0a5_191866d88cb_-10b8,2612471,Santa Cruz da Baixa Verde - PE,4112,7278,3166,11567,35.55,62.92,27.37
sidra_9541_PercMoradDPPOColetTot_munic_22_pol.fid-703dc0a5_191866d88cb_-10b7,3134301,Itumirim - MG,5763,5998,235,6636,86.84,90.39,3.54
sidra_9541_PercMoradDPPOColetTot_munic_22_pol.fid-703dc0a5_191866d88cb_-10b6,3134400,Iturama - MG,36254,37260,1006,38129,95.08,97.72,2.64
sidra_9541_PercMoradDPPOColetTot_munic_22_pol.fid-703dc0a5_191866d88cb_-10b5,3134509,Itutinga - MG,3475,3679,204,4215,82.44,87.28,4.84
sidra_9541_PercMoradDPPOColetTot_munic_22_pol.fid-703dc0a5_191866d88cb_-10b4,3134608,Jaboticatubas - MG,12191,16761,4570,20289,60.09,82.61,22.52
sidra_9541_PercMoradDPPOColetTot_munic_22_pol.fid-703dc0a5_191866d88cb_-10b2,3134707,Jacinto - MG,8300,8393,93,10969,75.67,76.52,0.85
sidra_9541_PercMoradDPPOColetTot_munic_22_pol.fid-703dc0a5_191866d88cb_-10b1,3134806,Jacuí - MG,5176,7221,2045,7454,69.44,96.87,27.43
sidra_9541_PercMoradDPPOColetTot_munic_22_pol.fid-703dc0a5_191866d88cb_-10b0,3134905,Jacutinga - MG,22688,25159,2471,25413,89.28,99,9.72
sidra_9541_PercMoradDPPOColetTot_munic_22_pol.fid-703dc0a5_191866d88cb_-10af,3135001,Jaguaraçu - MG,2651,2952,301,3085,85.93,95.69,9.76
sidra_9541_PercMoradDPPOColetTot_munic_22_pol.fid-703dc0a5_191866d88cb_-10ae,3135050,Jaíba - MG,27982,28166,184,37576,74.47,74.96,0.49
sidra_9541_PercMoradDPPOColetTot_munic_22_pol.fid-703dc0a5_191866d88cb_-10ad,3135076,Jampruca - MG,2270,2382,112,4247,53.45,56.09,2.64
sidra_9541_PercMoradDPPOColetTot_munic_22_pol.fid-703dc0a5_191866d88cb_-10ac,3135100,Janaúba - MG,62939,63761,822,70437,89.36,90.52,1.17
sidra_9541_PercMoradDPPOColetTot_munic_22_pol.fid-703dc0a5_191866d88cb_-10ab,3135209,Januária - MG,38018,38451,433,64856,58.62,59.29,0.67
sidra_9541_PercMoradDPPOColetTot_munic_22_pol.fid-703dc0a5_191866d88cb_-10aa,3135308,Japaraíba - MG,3968,4038,70,4506,88.06,89.61,1.55
sidra_9541_PercMoradDPPOColetTot_munic_22_pol.fid-703dc0a5_191866d88cb_-10a9,2609303,Mirandiba - PE,8479,8908,429,14148,59.93,62.96,3.03
sidra_9541_PercMoradDPPOColetTot_munic_22_pol.fid-703dc0a5_191866d88cb_-10a8,2609402,Moreno - PE,40920,48352,7432,55076,74.3,87.79,13.49
sidra_9541_PercMoradDPPOColetTot_munic_22_pol.fid-703dc0a5_191866d88cb_-10a7,2706604,Paulo Jacinto - AL,5464,5718,254,6576,83.09,86.95,3.86
sidra_9541_PercMoradDPPOColetTot_munic_22_pol.fid-703dc0a5_191866d88cb_-10a6,2706703,Penedo - AL,54863,55805,942,58554,93.7,95.31,1.61
sidra_9541_PercMoradDPPOColetTot_munic_22_pol.fid-703dc0a5_191866d88cb_-10a5,2706802,Piaçabuçu - AL,14949,15175,226,15890,94.08,95.5,1.42
sidra_9541_PercMoradDPPOColetTot_munic_22_pol.fid-703dc0a5_191866d88cb_-10a4,2609808,Orocó - PE,6912,8025,1113,13601,50.82,59,8.18
sidra_9541_PercMoradDPPOColetTot_munic_22_pol.fid-703dc0a5_191866d88cb_-10a3,2609907,Ouricuri - PE,21333,30171,8838,65212,32.71,46.27,13.55
sidra_9541_PercMoradDPPOColetTot_munic_22_pol.fid-703dc0a5_191866d88cb_-10a2,2610103,Palmeirina - PE,4014,4766,752,7030,57.1,67.8,10.7
sidra_9541_PercMoradDPPOColetTot_munic_22_pol.fid-703dc0a5_191866d88cb_-10a1,2706901,Pilar - AL,32587,34924,2337,35361,92.16,98.76,6.61
sidra_9541_PercMoradDPPOColetTot_munic_22_pol.fid-703dc0a5_191866d88cb_-10a0,2610004,Palmares - PE,35771,42579,6808,53752,66.55,79.21,12.67
sidra_9541_PercMoradDPPOColetTot_munic_22_pol.fid-703dc0a5_191866d88cb_-109f,2707008,Pindoba - AL,1367,1694,327,2715,50.35,62.39,12.04
sidra_9541_PercMoradDPPOColetTot_munic_22_pol.fid-703dc0a5_191866d88cb_-109e,2707107,Piranhas - AL,16231,18040,1809,22594,71.84,79.84,8.01
sidra_9541_PercMoradDPPOColetTot_munic_22_pol.fid-703dc0a5_191866d88cb_-109d,3135357,Japonvar - MG,4742,5177,435,8118,58.41,63.77,5.36
sidra_9541_PercMoradDPPOColetTot_munic_22_pol.fid-703dc0a5_191866d88cb_-109c,3135407,Jeceaba - MG,5334,5565,231,6187,86.21,89.95,3.73
sidra_9541_PercMoradDPPOColetTot_munic_22_pol.fid-703dc0a5_191866d88cb_-109b,2610202,Panelas - PE,13857,16405,2548,22985,60.29,71.37,11.09
sidra_9541_PercMoradDPPOColetTot_munic_22_pol.fid-703dc0a5_191866d88cb_-109a,2610301,Paranatama - PE,4671,5312,641,12187,38.33,43.59,5.26
sidra_9541_PercMoradDPPOColetTot_munic_22_pol.fid-703dc0a5_191866d88cb_-1099,2610400,Parnamirim - PE,6755,7462,707,18599,36.32,40.12,3.8
sidra_9541_PercMoradDPPOColetTot_munic_22_pol.fid-703dc0a5_191866d88cb_-1098,3135456,Jenipapo de Minas - MG,3324,3334,10,6098,54.51,54.67,0.16
sidra_9541_PercMoradDPPOColetTot_munic_22_pol.fid-703dc0a5_191866d88cb_-1097,3135506,Jequeri - MG,8172,8482,310,12375,66.04,68.54,2.51
sidra_9541_PercMoradDPPOColetTot_munic_22_pol.fid-703dc0a5_191866d88cb_-1096,3135605,Jequitaí - MG,5118,5190,72,6421,79.71,80.83,1.12
sidra_9541_PercMoradDPPOColetTot_munic_22_pol.fid-703dc0a5_191866d88cb_-1095,2610509,Passira - PE,19589,21085,1496,28336,69.13,74.41,5.28
sidra_9541_PercMoradDPPOColetTot_munic_22_pol.fid-703dc0a5_191866d88cb_-1094,2610608,Paudalho - PE,33584,47538,13954,56596,59.34,84,24.66
sidra_9541_PercMoradDPPOColetTot_munic_22_pol.fid-703dc0a5_191866d88cb_-1093,2610707,Paulista - PE,290037,325240,35203,341592,84.91,95.21,10.31
sidra_9541_PercMoradDPPOColetTot_munic_22_pol.fid-703dc0a5_191866d88cb_-1092,3135704,Jequitibá - MG,4623,4739,116,5874,78.7,80.68,1.97
sidra_9541_PercMoradDPPOColetTot_munic_22_pol.fid-703dc0a5_191866d88cb_-1090,3135803,Jequitinhonha - MG,17965,18774,809,23847,75.33,78.73,3.39
sidra_9541_PercMoradDPPOColetTot_munic_22_pol.fid-703dc0a5_191866d88cb_-108f,3135902,Jesuânia - MG,3964,4743,779,5096,77.79,93.07,15.29
sidra_9541_PercMoradDPPOColetTot_munic_22_pol.fid-703dc0a5_191866d88cb_-108e,3136009,Joaíma - MG,8705,9858,1153,13851,62.85,71.17,8.32
sidra_9541_PercMoradDPPOColetTot_munic_22_pol.fid-703dc0a5_191866d88cb_-108c,3136108,Joanésia - MG,2311,2579,268,4323,53.46,59.66,6.2
sidra_9541_PercMoradDPPOColetTot_munic_22_pol.fid-703dc0a5_191866d88cb_-108b,3136207,João Monlevade - MG,77473,79433,1960,79791,97.09,99.55,2.46
sidra_9541_PercMoradDPPOColetTot_munic_22_pol.fid-703dc0a5_191866d88cb_-108a,3136306,João Pinheiro - MG,40847,42082,1235,46374,88.08,90.74,2.66
sidra_9541_PercMoradDPPOColetTot_munic_22_pol.fid-703dc0a5_191866d88cb_-1085,3136405,Joaquim Felício - MG,2277,2557,280,3826,59.51,66.83,7.32
sidra_9541_PercMoradDPPOColetTot_munic_22_pol.fid-703dc0a5_191866d88cb_-1084,3136504,Jordânia - MG,8262,8361,99,10278,80.39,81.35,0.96
sidra_9541_PercMoradDPPOColetTot_munic_22_pol.fid-703dc0a5_191866d88cb_-1083,3136520,José Gonçalves de Minas - MG,2370,2386,16,3969,59.71,60.12,0.4
sidra_9541_PercMoradDPPOColetTot_munic_22_pol.fid-703dc0a5_191866d88cb_-1082,3136553,José Raydan - MG,1639,2794,1155,4268,38.4,65.46,27.06
sidra_9541_PercMoradDPPOColetTot_munic_22_pol.fid-703dc0a5_191866d88cb_-1080,3136579,Josenópolis - MG,2046,2491,445,3621,56.5,68.79,12.29
sidra_9541_PercMoradDPPOColetTot_munic_22_pol.fid-703dc0a5_191866d88cb_-107f,3136603,Nova União - MG,4937,5262,325,5899,83.69,89.2,5.51
sidra_9541_PercMoradDPPOColetTot_munic_22_pol.fid-703dc0a5_191866d88cb_-107e,3136652,Juatuba - MG,28297,29401,1104,30517,92.73,96.34,3.62
sidra_9541_PercMoradDPPOColetTot_munic_22_pol.fid-703dc0a5_191866d88cb_-107c,3136702,Juiz de Fora - MG,511945,533942,21997,536964,95.34,99.44,4.1
sidra_9541_PercMoradDPPOColetTot_munic_22_pol.fid-703dc0a5_191866d88cb_-107b,3136801,Juramento - MG,2977,3050,73,3768,79.01,80.94,1.94
sidra_9541_PercMoradDPPOColetTot_munic_22_pol.fid-703dc0a5_191866d88cb_-107a,3136900,Juruaia - MG,6598,10589,3991,11054,59.69,95.79,36.1
sidra_9541_PercMoradDPPOColetTot_munic_22_pol.fid-703dc0a5_191866d88cb_-1079,3136959,Juvenília - MG,3506,4431,925,5759,60.88,76.94,16.06
sidra_9541_PercMoradDPPOColetTot_munic_22_pol.fid-703dc0a5_191866d88cb_-1078,3137007,Ladainha - MG,1450,5575,4125,14324,10.12,38.92,28.8
sidra_9541_PercMoradDPPOColetTot_munic_22_pol.fid-703dc0a5_191866d88cb_-1077,3137106,Lagamar - MG,4932,5263,331,6595,74.78,79.8,5.02
sidra_9541_PercMoradDPPOColetTot_munic_22_pol.fid-703dc0a5_191866d88cb_-1076,3137205,Lagoa da Prata - MG,49919,50579,660,50999,97.88,99.18,1.29
sidra_9541_PercMoradDPPOColetTot_munic_22_pol.fid-703dc0a5_191866d88cb_-1075,3137304,Lagoa dos Patos - MG,2681,2691,10,3306,81.09,81.4,0.3
sidra_9541_PercMoradDPPOColetTot_munic_22_pol.fid-703dc0a5_191866d88cb_-1074,3137403,Lagoa Dourada - MG,10147,11529,1382,12745,79.62,90.46,10.84
sidra_9541_PercMoradDPPOColetTot_munic_22_pol.fid-703dc0a5_191866d88cb_-1073,3137502,Lagoa Formosa - MG,15257,15504,247,18853,80.93,82.24,1.31
sidra_9541_PercMoradDPPOColetTot_munic_22_pol.fid-703dc0a5_191866d88cb_-1072,3137536,Lagoa Grande - MG,7098,8029,931,8932,79.47,89.89,10.42
sidra_9541_PercMoradDPPOColetTot_munic_22_pol.fid-703dc0a5_191866d88cb_-1071,3137601,Lagoa Santa - MG,69486,74469,4983,74963,92.69,99.34,6.65
sidra_9541_PercMoradDPPOColetTot_munic_22_pol.fid-703dc0a5_191866d88cb_-106f,3137700,Lajinha - MG,13922,17386,3464,20808,66.91,83.55,16.65
sidra_9541_PercMoradDPPOColetTot_munic_22_pol.fid-703dc0a5_191866d88cb_-106e,2610806,Pedra - PE,11402,12464,1062,22775,50.06,54.73,4.66
sidra_9541_PercMoradDPPOColetTot_munic_22_pol.fid-703dc0a5_191866d88cb_-106d,2610905,Pesqueira - PE,44779,48097,3318,62049,72.17,77.51,5.35
sidra_9541_PercMoradDPPOColetTot_munic_22_pol.fid-703dc0a5_191866d88cb_-106c,3137809,Lambari - MG,17505,19639,2134,20300,86.23,96.74,10.51
sidra_9541_PercMoradDPPOColetTot_munic_22_pol.fid-703dc0a5_191866d88cb_-106b,3137908,Lamim - MG,2005,2045,40,3184,62.97,64.23,1.26
sidra_9541_PercMoradDPPOColetTot_munic_22_pol.fid-703dc0a5_191866d88cb_-106a,2611002,Petrolândia - PE,27288,29875,2587,34121,79.97,87.56,7.58
sidra_9541_PercMoradDPPOColetTot_munic_22_pol.fid-703dc0a5_191866d88cb_-1069,2611101,Petrolina - PE,348874,352585,3711,385334,90.54,91.5,0.96
sidra_9541_PercMoradDPPOColetTot_munic_22_pol.fid-703dc0a5_191866d88cb_-1068,2611200,Poção - PE,7184,7912,728,10495,68.45,75.39,6.94
sidra_9541_PercMoradDPPOColetTot_munic_22_pol.fid-703dc0a5_191866d88cb_-1067,3138005,Laranjal - MG,4995,5142,147,5950,83.95,86.42,2.47
sidra_9541_PercMoradDPPOColetTot_munic_22_pol.fid-703dc0a5_191866d88cb_-1066,3138104,Lassance - MG,5651,5736,85,7107,79.51,80.71,1.2
sidra_9541_PercMoradDPPOColetTot_munic_22_pol.fid-703dc0a5_191866d88cb_-1065,3138203,Lavras - MG,96871,102472,5601,104363,92.82,98.19,5.37
sidra_9541_PercMoradDPPOColetTot_munic_22_pol.fid-703dc0a5_191866d88cb_-1064,3138302,Leandro Ferreira - MG,2638,2859,221,3173,83.14,90.1,6.97
sidra_9541_PercMoradDPPOColetTot_munic_22_pol.fid-703dc0a5_191866d88cb_-1063,3138351,Leme do Prado - MG,3310,3691,381,4341,76.25,85.03,8.78
sidra_9541_PercMoradDPPOColetTot_munic_22_pol.fid-703dc0a5_191866d88cb_-1062,3138401,Leopoldina - MG,46019,48143,2124,50967,90.29,94.46,4.17
sidra_9541_PercMoradDPPOColetTot_munic_22_pol.fid-703dc0a5_191866d88cb_-1061,3138500,Liberdade - MG,3633,3722,89,4717,77.02,78.91,1.89
sidra_9541_PercMoradDPPOColetTot_munic_22_pol.fid-703dc0a5_191866d88cb_-1060,3138609,Lima Duarte - MG,9751,16383,6632,17145,56.87,95.56,38.68
sidra_9541_PercMoradDPPOColetTot_munic_22_pol.fid-703dc0a5_191866d88cb_-105e,3138625,Limeira do Oeste - MG,7134,7870,736,8650,82.47,90.98,8.51
sidra_9541_PercMoradDPPOColetTot_munic_22_pol.fid-703dc0a5_191866d88cb_-105d,3138658,Lontra - MG,6859,6885,26,8786,78.07,78.36,0.3
sidra_9541_PercMoradDPPOColetTot_munic_22_pol.fid-703dc0a5_191866d88cb_-105c,3138674,Luisburgo - MG,1662,3161,1499,6946,23.93,45.51,21.58
sidra_9541_PercMoradDPPOColetTot_munic_22_pol.fid-703dc0a5_191866d88cb_-105b,3138682,Luislândia - MG,3090,3098,8,6207,49.78,49.91,0.13
sidra_9541_PercMoradDPPOColetTot_munic_22_pol.fid-703dc0a5_191866d88cb_-105a,3138708,Luminárias - MG,4434,4806,372,5549,79.91,86.61,6.7
sidra_9541_PercMoradDPPOColetTot_munic_22_pol.fid-703dc0a5_191866d88cb_-1059,3138807,Luz - MG,16231,16450,219,17640,92.01,93.25,1.24
sidra_9541_PercMoradDPPOColetTot_munic_22_pol.fid-703dc0a5_191866d88cb_-1058,3138906,Machacalis - MG,5094,5098,4,6484,78.56,78.62,0.06
sidra_9541_PercMoradDPPOColetTot_munic_22_pol.fid-703dc0a5_191866d88cb_-1057,3139003,Machado - MG,32902,34474,1572,37483,87.78,91.97,4.19
sidra_9541_PercMoradDPPOColetTot_munic_22_pol.fid-703dc0a5_191866d88cb_-1056,3139102,Madre de Deus de Minas - MG,4491,4755,264,5185,86.62,91.71,5.09
sidra_9541_PercMoradDPPOColetTot_munic_22_pol.fid-703dc0a5_191866d88cb_-1055,3139201,Malacacheta - MG,9417,11895,2478,17369,54.22,68.48,14.27
sidra_9541_PercMoradDPPOColetTot_munic_22_pol.fid-703dc0a5_191866d88cb_-1054,3139250,Mamonas - MG,3358,3413,55,5993,56.03,56.95,0.92
sidra_9541_PercMoradDPPOColetTot_munic_22_pol.fid-703dc0a5_191866d88cb_-1053,3139300,Manga - MG,13545,13577,32,18695,72.45,72.62,0.17
sidra_9541_PercMoradDPPOColetTot_munic_22_pol.fid-703dc0a5_191866d88cb_-1051,3139409,Manhuaçu - MG,46040,86170,40130,91469,50.33,94.21,43.87
sidra_9541_PercMoradDPPOColetTot_munic_22_pol.fid-703dc0a5_191866d88cb_-1050,3139508,Manhumirim - MG,15590,18117,2527,20418,76.35,88.73,12.38
sidra_9541_PercMoradDPPOColetTot_munic_22_pol.fid-703dc0a5_191866d88cb_-104f,3139607,Mantena - MG,22204,22488,284,26323,84.35,85.43,1.08
sidra_9541_PercMoradDPPOColetTot_munic_22_pol.fid-703dc0a5_191866d88cb_-104e,3139706,Maravilhas - MG,6249,6339,90,7326,85.3,86.53,1.23
sidra_9541_PercMoradDPPOColetTot_munic_22_pol.fid-703dc0a5_191866d88cb_-104d,3139805,Mar de Espanha - MG,11059,12087,1028,12661,87.35,95.47,8.12
sidra_9541_PercMoradDPPOColetTot_munic_22_pol.fid-703dc0a5_191866d88cb_-104b,2611408,Primavera - PE,4786,9732,4946,13825,34.62,70.39,35.78
sidra_9541_PercMoradDPPOColetTot_munic_22_pol.fid-703dc0a5_191866d88cb_-104a,2611507,Quipapá - PE,12449,13165,716,17921,69.47,73.46,4
sidra_9541_PercMoradDPPOColetTot_munic_22_pol.fid-703dc0a5_191866d88cb_-1049,2611533,Quixaba - PE,3592,3679,87,6551,54.83,56.16,1.33
sidra_9541_PercMoradDPPOColetTot_munic_22_pol.fid-703dc0a5_191866d88cb_-1048,2611606,Recife - PE,1399587,1453819,54232,1479517,94.6,98.26,3.67
sidra_9541_PercMoradDPPOColetTot_munic_22_pol.fid-703dc0a5_191866d88cb_-1047,3139904,Maria da Fé - MG,13063,13606,543,14176,92.15,95.98,3.83
sidra_9541_PercMoradDPPOColetTot_munic_22_pol.fid-703dc0a5_191866d88cb_-1046,3140001,Mariana - MG,40567,58759,18192,60862,66.65,96.54,29.89
sidra_9541_PercMoradDPPOColetTot_munic_22_pol.fid-703dc0a5_191866d88cb_-1045,3140100,Marilac - MG,3433,3465,32,4219,81.37,82.13,0.76
sidra_9541_PercMoradDPPOColetTot_munic_22_pol.fid-703dc0a5_191866d88cb_-1044,3140159,Mário Campos - MG,15663,15769,106,15886,98.6,99.26,0.67
sidra_9541_PercMoradDPPOColetTot_munic_22_pol.fid-703dc0a5_191866d88cb_-1043,3140209,Maripá de Minas - MG,3182,3298,116,3383,94.06,97.49,3.43
sidra_9541_PercMoradDPPOColetTot_munic_22_pol.fid-703dc0a5_191866d88cb_-1042,3140308,Marliéria - MG,3999,4434,435,4585,87.22,96.71,9.49
sidra_9541_PercMoradDPPOColetTot_munic_22_pol.fid-703dc0a5_191866d88cb_-1041,2611705,Riacho das Almas - PE,13576,15020,1444,20638,65.78,72.78,7
sidra_9541_PercMoradDPPOColetTot_munic_22_pol.fid-703dc0a5_191866d88cb_-1040,2611804,Ribeirão - PE,23956,27560,3604,33489,71.53,82.3,10.76
sidra_9541_PercMoradDPPOColetTot_munic_22_pol.fid-703dc0a5_191866d88cb_-103f,3140407,Marmelópolis - MG,2387,2925,538,3196,74.69,91.52,16.83
sidra_9541_PercMoradDPPOColetTot_munic_22_pol.fid-703dc0a5_191866d88cb_-103e,3140506,Martinho Campos - MG,12384,12757,373,13930,88.9,91.58,2.68
sidra_9541_PercMoradDPPOColetTot_munic_22_pol.fid-703dc0a5_191866d88cb_-103c,3140530,Martins Soares - MG,4238,6733,2495,8392,50.5,80.23,29.73
sidra_9541_PercMoradDPPOColetTot_munic_22_pol.fid-703dc0a5_191866d88cb_-103b,3140555,Mata Verde - MG,7504,7513,9,9108,82.39,82.49,0.1
sidra_9541_PercMoradDPPOColetTot_munic_22_pol.fid-703dc0a5_191866d88cb_-103a,3140605,Materlândia - MG,1325,1948,623,3962,33.44,49.17,15.72
sidra_9541_PercMoradDPPOColetTot_munic_22_pol.fid-703dc0a5_191866d88cb_-1039,3140704,Mateus Leme - MG,34288,35765,1477,37756,90.81,94.73,3.91
sidra_9541_PercMoradDPPOColetTot_munic_22_pol.fid-703dc0a5_191866d88cb_-1038,3140803,Matias Barbosa - MG,13540,13846,306,14032,96.49,98.67,2.18
sidra_9541_PercMoradDPPOColetTot_munic_22_pol.fid-703dc0a5_191866d88cb_-1037,3140852,Matias Cardoso - MG,5427,5521,94,8805,61.64,62.7,1.07
sidra_9541_PercMoradDPPOColetTot_munic_22_pol.fid-703dc0a5_191866d88cb_-1036,3140902,Matipó - MG,15305,15769,464,18482,82.81,85.32,2.51
sidra_9541_PercMoradDPPOColetTot_munic_22_pol.fid-703dc0a5_191866d88cb_-1035,3141009,Mato Verde - MG,7970,9143,1173,12027,66.27,76.02,9.75
sidra_9541_PercMoradDPPOColetTot_munic_22_pol.fid-703dc0a5_191866d88cb_-1034,3141108,Matozinhos - MG,36916,37184,268,37587,98.21,98.93,0.71
sidra_9541_PercMoradDPPOColetTot_munic_22_pol.fid-703dc0a5_191866d88cb_-1033,3141207,Matutina - MG,3403,3527,124,3811,89.29,92.55,3.25
sidra_9541_PercMoradDPPOColetTot_munic_22_pol.fid-703dc0a5_191866d88cb_-1032,3141306,Medeiros - MG,2319,2655,336,3892,59.58,68.22,8.63
sidra_9541_PercMoradDPPOColetTot_munic_22_pol.fid-703dc0a5_191866d88cb_-1031,3141405,Medina - MG,15330,15438,108,20071,76.38,76.92,0.54
sidra_9541_PercMoradDPPOColetTot_munic_22_pol.fid-703dc0a5_191866d88cb_-1030,3141504,Mendes Pimentel - MG,3613,3613,,5606,64.45,64.45,
sidra_9541_PercMoradDPPOColetTot_munic_22_pol.fid-703dc0a5_191866d88cb_-102f,3141603,Mercês - MG,7177,8539,1362,10325,69.51,82.7,13.19
sidra_9541_PercMoradDPPOColetTot_munic_22_pol.fid-703dc0a5_191866d88cb_-102d,3141702,Mesquita - MG,2168,3427,1259,5028,43.12,68.16,25.04
sidra_9541_PercMoradDPPOColetTot_munic_22_pol.fid-703dc0a5_191866d88cb_-102c,3141801,Minas Novas - MG,12513,13433,920,24351,51.39,55.16,3.78
sidra_9541_PercMoradDPPOColetTot_munic_22_pol.fid-703dc0a5_191866d88cb_-102a,3141900,Minduri - MG,2615,3490,875,3721,70.28,93.79,23.52
sidra_9541_PercMoradDPPOColetTot_munic_22_pol.fid-703dc0a5_191866d88cb_-1028,2611903,Rio Formoso - PE,7700,14704,7004,19996,38.51,73.53,35.03
sidra_9541_PercMoradDPPOColetTot_munic_22_pol.fid-703dc0a5_191866d88cb_-1027,2612000,Sairé - PE,6577,8011,1434,10880,60.45,73.63,13.18
sidra_9541_PercMoradDPPOColetTot_munic_22_pol.fid-703dc0a5_191866d88cb_-1026,3142007,Mirabela - MG,11008,11078,70,13621,80.82,81.33,0.51
sidra_9541_PercMoradDPPOColetTot_munic_22_pol.fid-703dc0a5_191866d88cb_-1025,3142106,Miradouro - MG,1910,7034,5124,8937,21.37,78.71,57.33
sidra_9541_PercMoradDPPOColetTot_munic_22_pol.fid-703dc0a5_191866d88cb_-1024,3142205,Miraí - MG,10810,12459,1649,13584,79.58,91.72,12.14
sidra_9541_PercMoradDPPOColetTot_munic_22_pol.fid-703dc0a5_191866d88cb_-1022,3142254,Miravânia - MG,2034,2050,16,3985,51.04,51.44,0.4
sidra_9541_PercMoradDPPOColetTot_munic_22_pol.fid-703dc0a5_191866d88cb_-1021,3142304,Moeda - MG,2684,4754,2070,5114,52.48,92.96,40.48
sidra_9541_PercMoradDPPOColetTot_munic_22_pol.fid-703dc0a5_191866d88cb_-1020,3142403,Moema - MG,7053,7212,159,7530,93.67,95.78,2.11
sidra_9541_PercMoradDPPOColetTot_munic_22_pol.fid-703dc0a5_191866d88cb_-101f,3142502,Monjolos - MG,1008,1474,466,2169,46.47,67.96,21.48
sidra_9541_PercMoradDPPOColetTot_munic_22_pol.fid-703dc0a5_191866d88cb_-101e,3142601,Monsenhor Paulo - MG,6580,6952,372,8311,79.17,83.65,4.48
sidra_9541_PercMoradDPPOColetTot_munic_22_pol.fid-703dc0a5_191866d88cb_-101d,3142700,Montalvânia - MG,9405,9619,214,14056,66.91,68.43,1.52
sidra_9541_PercMoradDPPOColetTot_munic_22_pol.fid-703dc0a5_191866d88cb_-101c,3142809,Monte Alegre de Minas - MG,16386,18942,2556,20079,81.61,94.34,12.73
sidra_9541_PercMoradDPPOColetTot_munic_22_pol.fid-703dc0a5_191866d88cb_-101b,3142908,Monte Azul - MG,13789,13974,185,20182,68.32,69.24,0.92
sidra_9541_PercMoradDPPOColetTot_munic_22_pol.fid-703dc0a5_191866d88cb_-1019,3143005,Monte Belo - MG,10383,11416,1033,12983,79.97,87.93,7.96
sidra_9541_PercMoradDPPOColetTot_munic_22_pol.fid-703dc0a5_191866d88cb_-1018,3143104,Monte Carmelo - MG,43997,44873,876,47423,92.78,94.62,1.85
sidra_9541_PercMoradDPPOColetTot_munic_22_pol.fid-703dc0a5_191866d88cb_-1017,3143153,Monte Formoso - MG,1639,1831,192,4381,37.41,41.79,4.38
sidra_9541_PercMoradDPPOColetTot_munic_22_pol.fid-703dc0a5_191866d88cb_-1016,3143203,Monte Santo de Minas - MG,17168,19252,2084,20614,83.28,93.39,10.11
sidra_9541_PercMoradDPPOColetTot_munic_22_pol.fid-703dc0a5_191866d88cb_-1015,3143302,Montes Claros - MG,391634,397951,6317,411984,95.06,96.59,1.53
sidra_9541_PercMoradDPPOColetTot_munic_22_pol.fid-703dc0a5_191866d88cb_-1014,3143401,Monte Sião - MG,22350,23392,1042,24000,93.13,97.47,4.34
sidra_9541_PercMoradDPPOColetTot_munic_22_pol.fid-703dc0a5_191866d88cb_-1013,2612109,Salgadinho - PE,1633,2517,884,5727,28.51,43.95,15.44
sidra_9541_PercMoradDPPOColetTot_munic_22_pol.fid-703dc0a5_191866d88cb_-1012,2612208,Salgueiro - PE,50274,54457,4183,61956,81.14,87.9,6.75
sidra_9541_PercMoradDPPOColetTot_munic_22_pol.fid-703dc0a5_191866d88cb_-1011,2612307,Saloá - PE,8427,9119,692,13782,61.14,66.17,5.02
sidra_9541_PercMoradDPPOColetTot_munic_22_pol.fid-703dc0a5_191866d88cb_-1010,3143450,Montezuma - MG,3614,3660,46,6857,52.71,53.38,0.67
sidra_9541_PercMoradDPPOColetTot_munic_22_pol.fid-703dc0a5_191866d88cb_-100f,3143500,Morada Nova de Minas - MG,7808,8078,270,9017,86.59,89.59,2.99
sidra_9541_PercMoradDPPOColetTot_munic_22_pol.fid-703dc0a5_191866d88cb_-100e,3143609,Morro da Garça - MG,1753,1792,39,2411,72.71,74.33,1.62
sidra_9541_PercMoradDPPOColetTot_munic_22_pol.fid-703dc0a5_191866d88cb_-100d,3143708,Morro do Pilar - MG,2548,2621,73,3133,81.33,83.66,2.33
sidra_9541_PercMoradDPPOColetTot_munic_22_pol.fid-703dc0a5_191866d88cb_-100c,3143807,Munhoz - MG,5030,7249,2219,7438,67.63,97.46,29.83
sidra_9541_PercMoradDPPOColetTot_munic_22_pol.fid-703dc0a5_191866d88cb_-100b,3143906,Muriaé - MG,97732,99907,2175,103312,94.6,96.7,2.11
sidra_9541_PercMoradDPPOColetTot_munic_22_pol.fid-703dc0a5_191866d88cb_-100a,3144003,Mutum - MG,12405,17397,4992,27583,44.97,63.07,18.1
sidra_9541_PercMoradDPPOColetTot_munic_22_pol.fid-703dc0a5_191866d88cb_-1009,3144102,Muzambinho - MG,17439,20653,3214,21799,80,94.74,14.74
sidra_9541_PercMoradDPPOColetTot_munic_22_pol.fid-703dc0a5_191866d88cb_-1008,3144201,Nacip Raydan - MG,1695,1714,19,2456,69.01,69.79,0.77
sidra_9541_PercMoradDPPOColetTot_munic_22_pol.fid-703dc0a5_191866d88cb_-1007,3144300,Nanuque - MG,32511,32607,96,34877,93.22,93.49,0.28
sidra_9541_PercMoradDPPOColetTot_munic_22_pol.fid-703dc0a5_191866d88cb_-1006,3144359,Naque - MG,5856,5963,107,6299,92.97,94.67,1.7
sidra_9541_PercMoradDPPOColetTot_munic_22_pol.fid-703dc0a5_191866d88cb_-1005,3144375,Natalândia - MG,2614,2677,63,3517,74.32,76.12,1.79
sidra_9541_PercMoradDPPOColetTot_munic_22_pol.fid-703dc0a5_191866d88cb_-1004,3144409,Natércia - MG,3439,4551,1112,4651,73.94,97.85,23.91
sidra_9541_PercMoradDPPOColetTot_munic_22_pol.fid-703dc0a5_191866d88cb_-1003,3144508,Nazareno - MG,6811,7968,1157,8154,83.53,97.72,14.19
sidra_9541_PercMoradDPPOColetTot_munic_22_pol.fid-703dc0a5_191866d88cb_-1001,3144607,Nepomuceno - MG,20737,22151,1414,24826,83.53,89.23,5.7
sidra_9541_PercMoradDPPOColetTot_munic_22_pol.fid-703dc0a5_191866d88cb_-1000,3144656,Ninheira - MG,5155,5975,820,10573,48.76,56.51,7.76
sidra_9541_PercMoradDPPOColetTot_munic_22_pol.fid-703dc0a5_191866d88cb_-fff,3144672,Nova Belém - MG,1417,1667,250,3151,44.97,52.9,7.93
sidra_9541_PercMoradDPPOColetTot_munic_22_pol.fid-703dc0a5_191866d88cb_-ffe,3144706,Nova Era - MG,16339,16857,518,17322,94.33,97.32,2.99
sidra_9541_PercMoradDPPOColetTot_munic_22_pol.fid-703dc0a5_191866d88cb_-ffd,3144805,Nova Lima - MG,107663,110826,3163,111269,96.76,99.6,2.84
sidra_9541_PercMoradDPPOColetTot_munic_22_pol.fid-703dc0a5_191866d88cb_-ffc,3144904,Nova Módica - MG,1876,2436,560,3661,51.24,66.54,15.3
sidra_9541_PercMoradDPPOColetTot_munic_22_pol.fid-703dc0a5_191866d88cb_-ffb,3145000,Nova Ponte - MG,13617,14325,708,14568,93.47,98.33,4.86
sidra_9541_PercMoradDPPOColetTot_munic_22_pol.fid-703dc0a5_191866d88cb_-ffa,3145059,Nova Porteirinha - MG,5363,5430,67,6702,80.02,81.02,1
sidra_9541_PercMoradDPPOColetTot_munic_22_pol.fid-703dc0a5_191866d88cb_-ff8,3145109,Nova Resende - MG,9906,10957,1051,16345,60.61,67.04,6.43
sidra_9541_PercMoradDPPOColetTot_munic_22_pol.fid-703dc0a5_191866d88cb_-ff7,3145208,Nova Serrana - MG,96522,104306,7784,105286,91.68,99.07,7.39
sidra_9541_PercMoradDPPOColetTot_munic_22_pol.fid-703dc0a5_191866d88cb_-ff6,3145307,Novo Cruzeiro - MG,9648,11479,1831,26858,35.92,42.74,6.82
sidra_9541_PercMoradDPPOColetTot_munic_22_pol.fid-703dc0a5_191866d88cb_-ff5,2612505,Santa Cruz do Capibaribe - PE,92337,95015,2678,97524,94.68,97.43,2.75
sidra_9541_PercMoradDPPOColetTot_munic_22_pol.fid-703dc0a5_191866d88cb_-ff4,2612554,Santa Filomena - PE,4147,4603,456,12106,34.26,38.02,3.77
sidra_9541_PercMoradDPPOColetTot_munic_22_pol.fid-703dc0a5_191866d88cb_-ff3,2612604,Santa Maria da Boa Vista - PE,20189,20775,586,40513,49.83,51.28,1.45
sidra_9541_PercMoradDPPOColetTot_munic_22_pol.fid-703dc0a5_191866d88cb_-ff2,2612703,Santa Maria do Cambucá - PE,3750,8606,4856,14007,26.77,61.44,34.67
sidra_9541_PercMoradDPPOColetTot_munic_22_pol.fid-703dc0a5_191866d88cb_-ff1,3145356,Novo Oriente de Minas - MG,6214,6253,39,10249,60.63,61.01,0.38
sidra_9541_PercMoradDPPOColetTot_munic_22_pol.fid-703dc0a5_191866d88cb_-ff0,3145372,Novorizonte - MG,3718,3722,4,4571,81.34,81.43,0.09
sidra_9541_PercMoradDPPOColetTot_munic_22_pol.fid-703dc0a5_191866d88cb_-fef,3145406,Olaria - MG,309,1849,1540,1945,15.89,95.06,79.18
sidra_9541_PercMoradDPPOColetTot_munic_22_pol.fid-703dc0a5_191866d88cb_-fee,3145455,Olhos-d'Água - MG,3932,3961,29,5380,73.09,73.62,0.54
sidra_9541_PercMoradDPPOColetTot_munic_22_pol.fid-703dc0a5_191866d88cb_-fec,3145505,Olímpio Noronha - MG,2491,2495,4,2554,97.53,97.69,0.16
sidra_9541_PercMoradDPPOColetTot_munic_22_pol.fid-703dc0a5_191866d88cb_-feb,3145604,Oliveira - MG,36631,37135,504,39009,93.9,95.2,1.29
sidra_9541_PercMoradDPPOColetTot_munic_22_pol.fid-703dc0a5_191866d88cb_-fea,3145703,Oliveira Fortes - MG,1231,1339,108,2027,60.73,66.06,5.33
sidra_9541_PercMoradDPPOColetTot_munic_22_pol.fid-703dc0a5_191866d88cb_-fe9,3145802,Onça de Pitangui - MG,2270,2537,267,2968,76.48,85.48,9
sidra_9541_PercMoradDPPOColetTot_munic_22_pol.fid-703dc0a5_191866d88cb_-fe8,3145851,Oratórios - MG,3220,3954,734,4913,65.54,80.48,14.94
sidra_9541_PercMoradDPPOColetTot_munic_22_pol.fid-703dc0a5_191866d88cb_-fe7,3145877,Orizânia - MG,4769,6210,1441,8437,56.52,73.6,17.08
sidra_9541_PercMoradDPPOColetTot_munic_22_pol.fid-703dc0a5_191866d88cb_-fe6,3145901,Ouro Branco - MG,29615,38258,8643,38678,76.57,98.91,22.35
sidra_9541_PercMoradDPPOColetTot_munic_22_pol.fid-703dc0a5_191866d88cb_-fe5,3146008,Ouro Fino - MG,28352,31463,3111,31988,88.63,98.36,9.73
sidra_9541_PercMoradDPPOColetTot_munic_22_pol.fid-703dc0a5_191866d88cb_-fe3,3146107,Ouro Preto - MG,44978,72079,27101,74433,60.43,96.84,36.41
sidra_9541_PercMoradDPPOColetTot_munic_22_pol.fid-703dc0a5_191866d88cb_-fe2,3146206,Ouro Verde de Minas - MG,3455,3751,296,5733,60.27,65.43,5.16
sidra_9541_PercMoradDPPOColetTot_munic_22_pol.fid-703dc0a5_191866d88cb_-fe1,3146255,Padre Carvalho - MG,4002,4010,8,5058,79.12,79.28,0.16
sidra_9541_PercMoradDPPOColetTot_munic_22_pol.fid-703dc0a5_191866d88cb_-fe0,3146305,Padre Paraíso - MG,6722,12535,5813,17279,38.9,72.54,33.64
sidra_9541_PercMoradDPPOColetTot_munic_22_pol.fid-703dc0a5_191866d88cb_-fdf,3146404,Paineiras - MG,3354,3619,265,4203,79.8,86.11,6.31
sidra_9541_PercMoradDPPOColetTot_munic_22_pol.fid-703dc0a5_191866d88cb_-fde,3146503,Pains - MG,7267,7632,365,7983,91.03,95.6,4.57
sidra_9541_PercMoradDPPOColetTot_munic_22_pol.fid-703dc0a5_191866d88cb_-fdd,3146552,Pai Pedro - MG,2029,2086,57,5550,36.56,37.59,1.03
sidra_9541_PercMoradDPPOColetTot_munic_22_pol.fid-703dc0a5_191866d88cb_-fdc,3146602,Paiva - MG,1338,1352,14,1473,90.84,91.79,0.95
sidra_9541_PercMoradDPPOColetTot_munic_22_pol.fid-703dc0a5_191866d88cb_-fdb,3146701,Palma - MG,4653,4925,272,5690,81.78,86.56,4.78
sidra_9541_PercMoradDPPOColetTot_munic_22_pol.fid-703dc0a5_191866d88cb_-fda,3146750,Palmópolis - MG,4848,4995,147,6281,77.19,79.53,2.34
sidra_9541_PercMoradDPPOColetTot_munic_22_pol.fid-703dc0a5_191866d88cb_-fd9,3146909,Papagaios - MG,12692,12768,76,13838,91.72,92.27,0.55
sidra_9541_PercMoradDPPOColetTot_munic_22_pol.fid-703dc0a5_191866d88cb_-fd7,3147006,Paracatu - MG,84568,86900,2332,93466,90.48,92.97,2.5
sidra_9541_PercMoradDPPOColetTot_munic_22_pol.fid-703dc0a5_191866d88cb_-fd5,3147105,Pará de Minas - MG,92521,95159,2638,96420,95.96,98.69,2.74
sidra_9541_PercMoradDPPOColetTot_munic_22_pol.fid-703dc0a5_191866d88cb_-fd4,3147204,Paraguaçu - MG,18156,21119,2963,21653,83.85,97.53,13.68
sidra_9541_PercMoradDPPOColetTot_munic_22_pol.fid-703dc0a5_191866d88cb_-fd3,2612802,Santa Terezinha - PE,5222,7351,2129,10233,51.03,71.84,20.81
sidra_9541_PercMoradDPPOColetTot_munic_22_pol.fid-703dc0a5_191866d88cb_-fd2,2612901,São Benedito do Sul - PE,6198,8885,2687,13105,47.29,67.8,20.5
sidra_9541_PercMoradDPPOColetTot_munic_22_pol.fid-703dc0a5_191866d88cb_-fd1,3147303,Paraisópolis - MG,18512,19884,1372,20395,90.77,97.49,6.73
sidra_9541_PercMoradDPPOColetTot_munic_22_pol.fid-703dc0a5_191866d88cb_-fd0,3147402,Paraopeba - MG,20881,21142,261,24071,86.75,87.83,1.08
sidra_9541_PercMoradDPPOColetTot_munic_22_pol.fid-703dc0a5_191866d88cb_-fcf,3147501,Passabém - MG,1124,1167,43,1593,70.56,73.26,2.7
sidra_9541_PercMoradDPPOColetTot_munic_22_pol.fid-703dc0a5_191866d88cb_-fce,3147600,Passa Quatro - MG,14884,15298,414,15463,96.26,98.93,2.68
sidra_9541_PercMoradDPPOColetTot_munic_22_pol.fid-703dc0a5_191866d88cb_-fcd,3147709,Passa Tempo - MG,7420,7511,91,8443,87.88,88.96,1.08
sidra_9541_PercMoradDPPOColetTot_munic_22_pol.fid-703dc0a5_191866d88cb_-fcc,3147808,Passa Vinte - MG,1816,1974,158,2233,81.33,88.4,7.08
sidra_9541_PercMoradDPPOColetTot_munic_22_pol.fid-703dc0a5_191866d88cb_-fcb,3147907,Passos - MG,106069,109606,3537,111654,95,98.17,3.17
sidra_9541_PercMoradDPPOColetTot_munic_22_pol.fid-703dc0a5_191866d88cb_-fca,3147956,Patis - MG,2741,2757,16,4836,56.68,57.01,0.33
sidra_9541_PercMoradDPPOColetTot_munic_22_pol.fid-703dc0a5_191866d88cb_-fc9,3148004,Patos de Minas - MG,146786,152411,5625,158650,92.52,96.07,3.55
sidra_9541_PercMoradDPPOColetTot_munic_22_pol.fid-703dc0a5_191866d88cb_-fc7,3148103,Patrocínio - MG,80244,85504,5260,89029,90.13,96.04,5.91
sidra_9541_PercMoradDPPOColetTot_munic_22_pol.fid-703dc0a5_191866d88cb_-fc6,3148202,Patrocínio do Muriaé - MG,4836,4978,142,5576,86.73,89.28,2.55
sidra_9541_PercMoradDPPOColetTot_munic_22_pol.fid-703dc0a5_191866d88cb_-fc5,3148301,Paula Cândido - MG,7298,7799,501,8632,84.55,90.35,5.8
sidra_9541_PercMoradDPPOColetTot_munic_22_pol.fid-703dc0a5_191866d88cb_-fc4,3148400,Paulistas - MG,2271,2543,272,4367,52,58.23,6.23
sidra_9541_PercMoradDPPOColetTot_munic_22_pol.fid-703dc0a5_191866d88cb_-fc2,3148509,Pavão - MG,4717,5045,328,8027,58.76,62.85,4.09
sidra_9541_PercMoradDPPOColetTot_munic_22_pol.fid-703dc0a5_191866d88cb_-fc1,3148608,Peçanha - MG,6886,9523,2637,17223,39.98,55.29,15.31
sidra_9541_PercMoradDPPOColetTot_munic_22_pol.fid-703dc0a5_191866d88cb_-fc0,3148707,Pedra Azul - MG,21775,21825,50,24223,89.89,90.1,0.21
sidra_9541_PercMoradDPPOColetTot_munic_22_pol.fid-703dc0a5_191866d88cb_-fbf,3148756,Pedra Bonita - MG,3571,4326,755,7319,48.79,59.11,10.32
sidra_9541_PercMoradDPPOColetTot_munic_22_pol.fid-703dc0a5_191866d88cb_-fbe,3148806,Pedra do Anta - MG,1086,2413,1327,3309,32.82,72.92,40.1
sidra_9541_PercMoradDPPOColetTot_munic_22_pol.fid-703dc0a5_191866d88cb_-fbd,3148905,Pedra do Indaiá - MG,2962,3423,461,4107,72.12,83.35,11.22
sidra_9541_PercMoradDPPOColetTot_munic_22_pol.fid-703dc0a5_191866d88cb_-fbc,3149002,Pedra Dourada - MG,2131,2248,117,2754,77.38,81.63,4.25
sidra_9541_PercMoradDPPOColetTot_munic_22_pol.fid-703dc0a5_191866d88cb_-fbb,3149101,Pedralva - MG,8204,10273,2069,10697,76.69,96.04,19.34
sidra_9541_PercMoradDPPOColetTot_munic_22_pol.fid-703dc0a5_191866d88cb_-fba,3149150,Pedras de Maria da Cruz - MG,6369,6452,83,10383,61.34,62.14,0.8
sidra_9541_PercMoradDPPOColetTot_munic_22_pol.fid-703dc0a5_191866d88cb_-fb8,3149200,Pedrinópolis - MG,2985,3180,195,3326,89.75,95.61,5.86
sidra_9541_PercMoradDPPOColetTot_munic_22_pol.fid-703dc0a5_191866d88cb_-fb7,3149309,Pedro Leopoldo - MG,60654,61205,551,62426,97.16,98.04,0.88
sidra_9541_PercMoradDPPOColetTot_munic_22_pol.fid-703dc0a5_191866d88cb_-fb6,2613008,São Bento do Una - PE,31571,32707,1136,49351,63.97,66.27,2.3
sidra_9541_PercMoradDPPOColetTot_munic_22_pol.fid-703dc0a5_191866d88cb_-fb5,3149408,Pedro Teixeira - MG,1515,1645,130,1810,83.7,90.88,7.18
sidra_9541_PercMoradDPPOColetTot_munic_22_pol.fid-703dc0a5_191866d88cb_-fb4,3149507,Pequeri - MG,3119,3241,122,3350,93.1,96.75,3.64
sidra_9541_PercMoradDPPOColetTot_munic_22_pol.fid-703dc0a5_191866d88cb_-fb3,3149606,Pequi - MG,3517,3639,122,4150,84.75,87.69,2.94
sidra_9541_PercMoradDPPOColetTot_munic_22_pol.fid-703dc0a5_191866d88cb_-fb2,3149705,Perdigão - MG,10938,11654,716,12245,89.33,95.17,5.85
sidra_9541_PercMoradDPPOColetTot_munic_22_pol.fid-703dc0a5_191866d88cb_-fb1,3149804,Perdizes - MG,13155,15759,2604,16909,77.8,93.2,15.4
sidra_9541_PercMoradDPPOColetTot_munic_22_pol.fid-703dc0a5_191866d88cb_-fb0,3149903,Perdões - MG,19639,20693,1054,21243,92.45,97.41,4.96
sidra_9541_PercMoradDPPOColetTot_munic_22_pol.fid-703dc0a5_191866d88cb_-faf,3149952,Periquito - MG,5514,5518,4,6548,84.21,84.27,0.06
sidra_9541_PercMoradDPPOColetTot_munic_22_pol.fid-703dc0a5_191866d88cb_-fae,3150000,Pescador - MG,2752,2871,119,3488,78.9,82.31,3.41
sidra_9541_PercMoradDPPOColetTot_munic_22_pol.fid-703dc0a5_191866d88cb_-fad,3150109,Piau - MG,2065,2603,538,2795,73.88,93.13,19.25
sidra_9541_PercMoradDPPOColetTot_munic_22_pol.fid-703dc0a5_191866d88cb_-fac,2613107,São Caitano - PE,29836,30485,649,37043,80.54,82.3,1.75
sidra_9541_PercMoradDPPOColetTot_munic_22_pol.fid-703dc0a5_191866d88cb_-fab,2613206,São João - PE,11002,14121,3119,23826,46.18,59.27,13.09
sidra_9541_PercMoradDPPOColetTot_munic_22_pol.fid-703dc0a5_191866d88cb_-faa,2613800,São Vicente Férrer - PE,9415,12782,3367,16667,56.49,76.69,20.2
sidra_9541_PercMoradDPPOColetTot_munic_22_pol.fid-703dc0a5_191866d88cb_-fa9,2613909,Serra Talhada - PE,69252,71647,2395,92119,75.18,77.78,2.6
sidra_9541_PercMoradDPPOColetTot_munic_22_pol.fid-703dc0a5_191866d88cb_-fa8,2614006,Serrita - PE,8157,8229,72,18207,44.8,45.2,0.4
sidra_9541_PercMoradDPPOColetTot_munic_22_pol.fid-703dc0a5_191866d88cb_-fa7,2614105,Sertânia - PE,18063,20897,2834,32724,55.2,63.86,8.66
sidra_9541_PercMoradDPPOColetTot_munic_22_pol.fid-703dc0a5_191866d88cb_-fa6,2614204,Sirinhaém - PE,16120,30498,14378,37570,42.91,81.18,38.27
sidra_9541_PercMoradDPPOColetTot_munic_22_pol.fid-703dc0a5_191866d88cb_-fa5,2614303,Moreilândia - PE,6336,6436,100,10531,60.17,61.11,0.95
sidra_9541_PercMoradDPPOColetTot_munic_22_pol.fid-703dc0a5_191866d88cb_-fa3,3150158,Piedade de Caratinga - MG,7304,7890,586,8520,85.73,92.61,6.88
sidra_9541_PercMoradDPPOColetTot_munic_22_pol.fid-703dc0a5_191866d88cb_-fa2,2613305,São Joaquim do Monte - PE,15786,16207,421,19992,78.96,81.07,2.11
sidra_9541_PercMoradDPPOColetTot_munic_22_pol.fid-703dc0a5_191866d88cb_-fa1,3150208,Piedade de Ponte Nova - MG,2404,3605,1201,3950,60.86,91.27,30.41
sidra_9541_PercMoradDPPOColetTot_munic_22_pol.fid-703dc0a5_191866d88cb_-fa0,3150307,Piedade do Rio Grande - MG,3578,4066,488,4604,77.72,88.31,10.6
sidra_9541_PercMoradDPPOColetTot_munic_22_pol.fid-703dc0a5_191866d88cb_-f9f,3150406,Piedade dos Gerais - MG,1893,3282,1389,4963,38.14,66.13,27.99
sidra_9541_PercMoradDPPOColetTot_munic_22_pol.fid-703dc0a5_191866d88cb_-f9e,3150505,Pimenta - MG,7676,8057,381,8558,89.69,94.15,4.45
sidra_9541_PercMoradDPPOColetTot_munic_22_pol.fid-703dc0a5_191866d88cb_-f9d,3150539,Pingo-d'Água - MG,4381,4421,40,4692,93.37,94.22,0.85
sidra_9541_PercMoradDPPOColetTot_munic_22_pol.fid-703dc0a5_191866d88cb_-f9c,3150570,Pintópolis - MG,2998,3004,6,7078,42.36,42.44,0.08
sidra_9541_PercMoradDPPOColetTot_munic_22_pol.fid-703dc0a5_191866d88cb_-f9b,3150604,Piracema - MG,4015,5571,1556,6676,60.14,83.45,23.31
sidra_9541_PercMoradDPPOColetTot_munic_22_pol.fid-703dc0a5_191866d88cb_-f9a,3150703,Pirajuba - MG,5291,5354,63,5484,96.48,97.63,1.15
sidra_9541_PercMoradDPPOColetTot_munic_22_pol.fid-703dc0a5_191866d88cb_-f99,3150802,Piranga - MG,8748,10303,1555,16954,51.6,60.77,9.17
sidra_9541_PercMoradDPPOColetTot_munic_22_pol.fid-703dc0a5_191866d88cb_-f98,2613404,São José da Coroa Grande - PE,17415,17890,475,18771,92.78,95.31,2.53
sidra_9541_PercMoradDPPOColetTot_munic_22_pol.fid-703dc0a5_191866d88cb_-f97,2614402,Solidão - PE,2345,2416,71,5196,45.13,46.5,1.37
sidra_9541_PercMoradDPPOColetTot_munic_22_pol.fid-703dc0a5_191866d88cb_-f96,3150901,Piranguçu - MG,4790,5687,897,6011,79.69,94.61,14.92
sidra_9541_PercMoradDPPOColetTot_munic_22_pol.fid-703dc0a5_191866d88cb_-f95,3151008,Piranguinho - MG,8190,8974,784,9101,89.99,98.6,8.61
sidra_9541_PercMoradDPPOColetTot_munic_22_pol.fid-703dc0a5_191866d88cb_-f94,3151107,Pirapetinga - MG,9466,10353,887,11070,85.51,93.52,8.01
sidra_9541_PercMoradDPPOColetTot_munic_22_pol.fid-703dc0a5_191866d88cb_-f93,3151206,Pirapora - MG,53337,53544,207,55163,96.69,97.07,0.38
sidra_9541_PercMoradDPPOColetTot_munic_22_pol.fid-703dc0a5_191866d88cb_-f92,3151305,Piraúba - MG,10317,10447,130,11572,89.15,90.28,1.12
sidra_9541_PercMoradDPPOColetTot_munic_22_pol.fid-703dc0a5_191866d88cb_-f91,3151404,Pitangui - MG,24350,24955,605,26535,91.77,94.05,2.28
sidra_9541_PercMoradDPPOColetTot_munic_22_pol.fid-703dc0a5_191866d88cb_-f90,3151503,Piumhi - MG,33568,34939,1371,35802,93.76,97.59,3.83
sidra_9541_PercMoradDPPOColetTot_munic_22_pol.fid-703dc0a5_191866d88cb_-f8f,3151602,Planura - MG,10874,10961,87,11119,97.8,98.58,0.78
sidra_9541_PercMoradDPPOColetTot_munic_22_pol.fid-703dc0a5_191866d88cb_-f8e,3151701,Poço Fundo - MG,11290,13135,1845,16356,69.03,80.31,11.28
sidra_9541_PercMoradDPPOColetTot_munic_22_pol.fid-703dc0a5_191866d88cb_-f8d,3151800,Poços de Caldas - MG,160237,162784,2547,163376,98.08,99.64,1.56
sidra_9541_PercMoradDPPOColetTot_munic_22_pol.fid-703dc0a5_191866d88cb_-f8c,3151909,Pocrane - MG,5461,5794,333,8334,65.53,69.52,4
sidra_9541_PercMoradDPPOColetTot_munic_22_pol.fid-703dc0a5_191866d88cb_-f8a,3152006,Pompéu - MG,27111,27876,765,30918,87.69,90.16,2.47
sidra_9541_PercMoradDPPOColetTot_munic_22_pol.fid-703dc0a5_191866d88cb_-f89,3152105,Ponte Nova - MG,37268,55202,17934,57145,65.22,96.6,31.38
sidra_9541_PercMoradDPPOColetTot_munic_22_pol.fid-703dc0a5_191866d88cb_-f88,2613503,São José do Belmonte - PE,18862,22207,3345,34812,54.18,63.79,9.61
sidra_9541_PercMoradDPPOColetTot_munic_22_pol.fid-703dc0a5_191866d88cb_-f87,2613602,São José do Egito - PE,18423,23255,4832,30958,59.51,75.12,15.61
sidra_9541_PercMoradDPPOColetTot_munic_22_pol.fid-703dc0a5_191866d88cb_-f86,2613701,São Lourenço da Mata - PE,91090,95448,4358,111034,82.04,85.96,3.92
sidra_9541_PercMoradDPPOColetTot_munic_22_pol.fid-703dc0a5_191866d88cb_-f85,3152131,Ponto Chique - MG,2649,2684,35,3742,70.79,71.73,0.94
sidra_9541_PercMoradDPPOColetTot_munic_22_pol.fid-703dc0a5_191866d88cb_-f84,3152170,Ponto dos Volantes - MG,4665,6231,1566,10873,42.9,57.31,14.4
sidra_9541_PercMoradDPPOColetTot_munic_22_pol.fid-703dc0a5_191866d88cb_-f83,3152204,Porteirinha - MG,23335,23586,251,37340,62.49,63.17,0.67
sidra_9541_PercMoradDPPOColetTot_munic_22_pol.fid-703dc0a5_191866d88cb_-f82,3152303,Porto Firme - MG,5976,7420,1444,10531,56.75,70.46,13.71
sidra_9541_PercMoradDPPOColetTot_munic_22_pol.fid-703dc0a5_191866d88cb_-f81,3152402,Poté - MG,5690,9121,3431,13608,41.81,67.03,25.21
sidra_9541_PercMoradDPPOColetTot_munic_22_pol.fid-703dc0a5_191866d88cb_-f80,2614501,Surubim - PE,49877,57022,7145,64030,77.9,89.06,11.16
sidra_9541_PercMoradDPPOColetTot_munic_22_pol.fid-703dc0a5_191866d88cb_-f7f,2614600,Tabira - PE,21707,22691,984,27638,78.54,82.1,3.56
sidra_9541_PercMoradDPPOColetTot_munic_22_pol.fid-703dc0a5_191866d88cb_-f7e,3152501,Pouso Alegre - MG,128350,147294,18944,150966,85.02,97.57,12.55
sidra_9541_PercMoradDPPOColetTot_munic_22_pol.fid-703dc0a5_191866d88cb_-f7d,3152600,Pouso Alto - MG,5598,6038,440,6537,85.64,92.37,6.73
sidra_9541_PercMoradDPPOColetTot_munic_22_pol.fid-703dc0a5_191866d88cb_-f7c,3152709,Prados - MG,8038,8329,291,9013,89.18,92.41,3.23
sidra_9541_PercMoradDPPOColetTot_munic_22_pol.fid-703dc0a5_191866d88cb_-f7a,2614709,Tacaimbó - PE,7680,8449,769,13077,58.73,64.61,5.88
sidra_9541_PercMoradDPPOColetTot_munic_22_pol.fid-703dc0a5_191866d88cb_-f79,2614808,Tacaratu - PE,8984,11420,2436,23884,37.62,47.81,10.2
sidra_9541_PercMoradDPPOColetTot_munic_22_pol.fid-703dc0a5_191866d88cb_-f78,3152808,Prata - MG,22593,24248,1655,28169,80.21,86.08,5.88
sidra_9541_PercMoradDPPOColetTot_munic_22_pol.fid-703dc0a5_191866d88cb_-f77,3152907,Pratápolis - MG,7281,8020,739,8373,86.96,95.78,8.83
sidra_9541_PercMoradDPPOColetTot_munic_22_pol.fid-703dc0a5_191866d88cb_-f76,2614857,Tamandaré - PE,17351,19402,2051,23552,73.67,82.38,8.71
sidra_9541_PercMoradDPPOColetTot_munic_22_pol.fid-703dc0a5_191866d88cb_-f75,3153004,Pratinha - MG,2084,2776,692,3557,58.59,78.04,19.45
sidra_9541_PercMoradDPPOColetTot_munic_22_pol.fid-703dc0a5_191866d88cb_-f74,3153103,Presidente Bernardes - MG,3830,3849,19,4830,79.3,79.69,0.39
sidra_9541_PercMoradDPPOColetTot_munic_22_pol.fid-703dc0a5_191866d88cb_-f73,3153202,Presidente Juscelino - MG,2193,2224,31,3465,63.29,64.18,0.89
sidra_9541_PercMoradDPPOColetTot_munic_22_pol.fid-703dc0a5_191866d88cb_-f72,3153301,Presidente Kubitschek - MG,2568,2589,21,3070,83.65,84.33,0.68
sidra_9541_PercMoradDPPOColetTot_munic_22_pol.fid-703dc0a5_191866d88cb_-f71,3153400,Presidente Olegário - MG,14412,15314,902,18603,77.47,82.32,4.85
sidra_9541_PercMoradDPPOColetTot_munic_22_pol.fid-703dc0a5_191866d88cb_-f70,3153509,Alto Jequitibá - MG,3603,7168,3565,8351,43.14,85.83,42.69
sidra_9541_PercMoradDPPOColetTot_munic_22_pol.fid-703dc0a5_191866d88cb_-f6e,3153608,Prudente de Morais - MG,11031,11276,245,11451,96.33,98.47,2.14
sidra_9541_PercMoradDPPOColetTot_munic_22_pol.fid-703dc0a5_191866d88cb_-f6d,3153707,Quartel Geral - MG,2659,2753,94,3161,84.12,87.09,2.97
sidra_9541_PercMoradDPPOColetTot_munic_22_pol.fid-703dc0a5_191866d88cb_-f6c,3153806,Queluzito - MG,1078,1288,210,1768,60.97,72.85,11.88
sidra_9541_PercMoradDPPOColetTot_munic_22_pol.fid-703dc0a5_191866d88cb_-f6b,2615003,Taquaritinga do Norte - PE,15542,21975,6433,24673,62.99,89.06,26.07
sidra_9541_PercMoradDPPOColetTot_munic_22_pol.fid-703dc0a5_191866d88cb_-f6a,2615102,Terezinha - PE,2157,3297,1140,6505,33.16,50.68,17.52
sidra_9541_PercMoradDPPOColetTot_munic_22_pol.fid-703dc0a5_191866d88cb_-f69,2615201,Terra Nova - PE,6271,6330,59,8918,70.32,70.98,0.66
sidra_9541_PercMoradDPPOColetTot_munic_22_pol.fid-703dc0a5_191866d88cb_-f68,2615300,Timbaúba - PE,38817,41034,2217,46035,84.32,89.14,4.82
sidra_9541_PercMoradDPPOColetTot_munic_22_pol.fid-703dc0a5_191866d88cb_-f67,3153905,Raposos - MG,15592,15975,383,16271,95.83,98.18,2.35
sidra_9541_PercMoradDPPOColetTot_munic_22_pol.fid-703dc0a5_191866d88cb_-f66,3154002,Raul Soares - MG,17308,18096,788,23346,74.14,77.51,3.38
sidra_9541_PercMoradDPPOColetTot_munic_22_pol.fid-703dc0a5_191866d88cb_-f65,3154101,Recreio - MG,10253,10297,44,10976,93.41,93.81,0.4
sidra_9541_PercMoradDPPOColetTot_munic_22_pol.fid-703dc0a5_191866d88cb_-f64,3154150,Reduto - MG,5975,6845,870,7847,76.14,87.23,11.09
sidra_9541_PercMoradDPPOColetTot_munic_22_pol.fid-703dc0a5_191866d88cb_-f63,3154200,Resende Costa - MG,9491,10070,579,11136,85.23,90.43,5.2
sidra_9541_PercMoradDPPOColetTot_munic_22_pol.fid-703dc0a5_191866d88cb_-f62,3154309,Resplendor - MG,13492,14186,694,17170,78.58,82.62,4.04
sidra_9541_PercMoradDPPOColetTot_munic_22_pol.fid-703dc0a5_191866d88cb_-f61,3154408,Ressaquinha - MG,3479,4095,616,4531,76.78,90.38,13.6
sidra_9541_PercMoradDPPOColetTot_munic_22_pol.fid-703dc0a5_191866d88cb_-f60,2615508,Tracunhaém - PE,12236,12684,448,13866,88.24,91.48,3.23
sidra_9541_PercMoradDPPOColetTot_munic_22_pol.fid-703dc0a5_191866d88cb_-f5f,2615607,Trindade - PE,19423,21438,2015,30288,64.13,70.78,6.65
sidra_9541_PercMoradDPPOColetTot_munic_22_pol.fid-703dc0a5_191866d88cb_-f5e,3154457,Riachinho - MG,4343,4376,33,6857,63.34,63.82,0.48
sidra_9541_PercMoradDPPOColetTot_munic_22_pol.fid-703dc0a5_191866d88cb_-f5d,3154507,Riacho dos Machados - MG,4962,5060,98,8754,56.68,57.8,1.12
sidra_9541_PercMoradDPPOColetTot_munic_22_pol.fid-703dc0a5_191866d88cb_-f5b,3154606,Ribeirão das Neves - MG,298283,316461,18178,322653,92.45,98.08,5.63
sidra_9541_PercMoradDPPOColetTot_munic_22_pol.fid-703dc0a5_191866d88cb_-f5a,3154705,Ribeirão Vermelho - MG,3970,4036,66,4080,97.3,98.92,1.62
sidra_9541_PercMoradDPPOColetTot_munic_22_pol.fid-703dc0a5_191866d88cb_-f59,3154804,Rio Acima - MG,5817,10048,4231,10231,56.86,98.21,41.35
sidra_9541_PercMoradDPPOColetTot_munic_22_pol.fid-703dc0a5_191866d88cb_-f58,3154903,Rio Casca - MG,7505,11525,4020,12740,58.91,90.46,31.55
sidra_9541_PercMoradDPPOColetTot_munic_22_pol.fid-703dc0a5_191866d88cb_-f57,3155009,Rio Doce - MG,2187,2415,228,2484,88.04,97.22,9.18
sidra_9541_PercMoradDPPOColetTot_munic_22_pol.fid-703dc0a5_191866d88cb_-f56,3155108,Rio do Prado - MG,2175,3350,1175,4636,46.92,72.26,25.35
sidra_9541_PercMoradDPPOColetTot_munic_22_pol.fid-703dc0a5_191866d88cb_-f55,3155207,Rio Espera - MG,145,4045,3900,5388,2.69,75.07,72.38
sidra_9541_PercMoradDPPOColetTot_munic_22_pol.fid-703dc0a5_191866d88cb_-f54,3155306,Rio Manso - MG,4546,5222,676,5565,81.69,93.84,12.15
sidra_9541_PercMoradDPPOColetTot_munic_22_pol.fid-703dc0a5_191866d88cb_-f53,3155405,Rio Novo - MG,7062,8033,971,8361,84.46,96.08,11.61
sidra_9541_PercMoradDPPOColetTot_munic_22_pol.fid-703dc0a5_191866d88cb_-f51,3155504,Rio Paranaíba - MG,12159,12405,246,14449,84.15,85.85,1.7
sidra_9541_PercMoradDPPOColetTot_munic_22_pol.fid-703dc0a5_191866d88cb_-f50,3155603,Rio Pardo de Minas - MG,12778,12915,137,28170,45.36,45.85,0.49
sidra_9541_PercMoradDPPOColetTot_munic_22_pol.fid-703dc0a5_191866d88cb_-f4f,3155702,Rio Piracicaba - MG,12967,13707,740,14556,89.08,94.17,5.08
sidra_9541_PercMoradDPPOColetTot_munic_22_pol.fid-703dc0a5_191866d88cb_-f4e,3155801,Rio Pomba - MG,14716,16294,1578,17274,85.19,94.33,9.14
sidra_9541_PercMoradDPPOColetTot_munic_22_pol.fid-703dc0a5_191866d88cb_-f4c,3155900,Rio Preto - MG,2054,4894,2840,5105,40.24,95.87,55.63
sidra_9541_PercMoradDPPOColetTot_munic_22_pol.fid-703dc0a5_191866d88cb_-f4b,3156007,Rio Vermelho - MG,5341,5864,523,12597,42.4,46.55,4.15
sidra_9541_PercMoradDPPOColetTot_munic_22_pol.fid-703dc0a5_191866d88cb_-f4a,3156106,Ritápolis - MG,4448,4473,25,4994,89.07,89.57,0.5
sidra_9541_PercMoradDPPOColetTot_munic_22_pol.fid-703dc0a5_191866d88cb_-f49,3156205,Rochedo de Minas - MG,1272,2207,935,2290,55.55,96.38,40.83
sidra_9541_PercMoradDPPOColetTot_munic_22_pol.fid-703dc0a5_191866d88cb_-f48,3156304,Rodeiro - MG,7949,8140,191,8622,92.19,94.41,2.22
sidra_9541_PercMoradDPPOColetTot_munic_22_pol.fid-703dc0a5_191866d88cb_-f47,3156403,Romaria - MG,2584,3003,419,3385,76.34,88.71,12.38
sidra_9541_PercMoradDPPOColetTot_munic_22_pol.fid-703dc0a5_191866d88cb_-f46,3156452,Rosário da Limeira - MG,3368,4027,659,4713,71.46,85.44,13.98
sidra_9541_PercMoradDPPOColetTot_munic_22_pol.fid-703dc0a5_191866d88cb_-f45,3156502,Rubelita - MG,3083,3133,50,5678,54.3,55.18,0.88
sidra_9541_PercMoradDPPOColetTot_munic_22_pol.fid-703dc0a5_191866d88cb_-f44,3156601,Rubim - MG,8244,8314,70,10261,80.34,81.03,0.68
sidra_9541_PercMoradDPPOColetTot_munic_22_pol.fid-703dc0a5_191866d88cb_-f42,3156700,Sabará - MG,117531,125297,7766,129262,90.92,96.93,6.01
sidra_9541_PercMoradDPPOColetTot_munic_22_pol.fid-703dc0a5_191866d88cb_-f41,3156809,Sabinópolis - MG,7485,10037,2552,14226,52.61,70.55,17.94
sidra_9541_PercMoradDPPOColetTot_munic_22_pol.fid-703dc0a5_191866d88cb_-f40,3156908,Sacramento - MG,21513,24478,2965,26438,81.37,92.59,11.21
sidra_9541_PercMoradDPPOColetTot_munic_22_pol.fid-703dc0a5_191866d88cb_-f3f,3157005,Salinas - MG,33472,33668,196,40078,83.52,84.01,0.49
sidra_9541_PercMoradDPPOColetTot_munic_22_pol.fid-703dc0a5_191866d88cb_-f3e,3157104,Salto da Divisa - MG,3984,5123,1139,6105,65.26,83.91,18.66
sidra_9541_PercMoradDPPOColetTot_munic_22_pol.fid-703dc0a5_191866d88cb_-f3d,2615706,Triunfo - PE,7832,9142,1310,14669,53.39,62.32,8.93
sidra_9541_PercMoradDPPOColetTot_munic_22_pol.fid-703dc0a5_191866d88cb_-f3c,2615805,Tupanatinga - PE,6804,11771,4967,26915,25.28,43.73,18.45
sidra_9541_PercMoradDPPOColetTot_munic_22_pol.fid-703dc0a5_191866d88cb_-f3b,2615904,Tuparetama - PE,6214,6611,397,7978,77.89,82.87,4.98
sidra_9541_PercMoradDPPOColetTot_munic_22_pol.fid-703dc0a5_191866d88cb_-f3a,2616001,Venturosa - PE,11167,11627,460,17228,64.82,67.49,2.67
sidra_9541_PercMoradDPPOColetTot_munic_22_pol.fid-703dc0a5_191866d88cb_-f39,3157203,Santa Bárbara - MG,20667,29661,8994,30359,68.08,97.7,29.63
sidra_9541_PercMoradDPPOColetTot_munic_22_pol.fid-703dc0a5_191866d88cb_-f37,3157252,Santa Bárbara do Leste - MG,4568,7198,2630,8440,54.12,85.28,31.16
sidra_9541_PercMoradDPPOColetTot_munic_22_pol.fid-703dc0a5_191866d88cb_-f36,3157278,Santa Bárbara do Monte Verde - MG,1898,2655,757,3091,61.4,85.89,24.49
sidra_9541_PercMoradDPPOColetTot_munic_22_pol.fid-703dc0a5_191866d88cb_-f35,3157302,Santa Bárbara do Tugúrio - MG,1751,2814,1063,4208,41.61,66.87,25.26
sidra_9541_PercMoradDPPOColetTot_munic_22_pol.fid-703dc0a5_191866d88cb_-f34,2616100,Verdejante - PE,5862,5906,44,9164,63.97,64.45,0.48
sidra_9541_PercMoradDPPOColetTot_munic_22_pol.fid-703dc0a5_191866d88cb_-f33,2616183,Vertente do Lério - PE,1675,4320,2645,7550,22.19,57.22,35.03
sidra_9541_PercMoradDPPOColetTot_munic_22_pol.fid-703dc0a5_191866d88cb_-f32,3159100,Santana dos Montes - MG,2459,2611,152,3463,71.01,75.4,4.39
sidra_9541_PercMoradDPPOColetTot_munic_22_pol.fid-703dc0a5_191866d88cb_-f31,3159209,Santa Rita de Caldas - MG,5917,7260,1343,8418,70.29,86.24,15.95
sidra_9541_PercMoradDPPOColetTot_munic_22_pol.fid-703dc0a5_191866d88cb_-f2f,3159308,Santa Rita de Jacutinga - MG,3933,4144,211,4738,83.01,87.46,4.45
sidra_9541_PercMoradDPPOColetTot_munic_22_pol.fid-703dc0a5_191866d88cb_-f2e,3159357,Santa Rita de Minas - MG,4567,6157,1590,6751,67.65,91.2,23.55
sidra_9541_PercMoradDPPOColetTot_munic_22_pol.fid-703dc0a5_191866d88cb_-f2d,2616209,Vertentes - PE,18147,18622,475,21914,82.81,84.98,2.17
sidra_9541_PercMoradDPPOColetTot_munic_22_pol.fid-703dc0a5_191866d88cb_-f2c,2616308,Vicência - PE,19008,20299,1291,26350,72.14,77.04,4.9
sidra_9541_PercMoradDPPOColetTot_munic_22_pol.fid-703dc0a5_191866d88cb_-f2b,3159407,Santa Rita de Ibitipoca - MG,2544,2656,112,3297,77.16,80.56,3.4
sidra_9541_PercMoradDPPOColetTot_munic_22_pol.fid-703dc0a5_191866d88cb_-f2a,3159506,Santa Rita do Itueto - MG,3667,4536,869,5826,62.94,77.86,14.92
sidra_9541_PercMoradDPPOColetTot_munic_22_pol.fid-703dc0a5_191866d88cb_-f29,3159605,Santa Rita do Sapucaí - MG,37969,39171,1202,40427,93.92,96.89,2.97
sidra_9541_PercMoradDPPOColetTot_munic_22_pol.fid-703dc0a5_191866d88cb_-f27,3159704,Santa Rosa da Serra - MG,3098,3161,63,3373,91.85,93.71,1.87
sidra_9541_PercMoradDPPOColetTot_munic_22_pol.fid-703dc0a5_191866d88cb_-f26,3159803,Santa Vitória - MG,18369,19214,845,20861,88.05,92.1,4.05
sidra_9541_PercMoradDPPOColetTot_munic_22_pol.fid-703dc0a5_191866d88cb_-f25,3159902,Santo Antônio do Amparo - MG,15179,16740,1561,17224,88.13,97.19,9.06
sidra_9541_PercMoradDPPOColetTot_munic_22_pol.fid-703dc0a5_191866d88cb_-f24,3160009,Santo Antônio do Aventureiro - MG,3297,3468,171,3768,87.5,92.04,4.54
sidra_9541_PercMoradDPPOColetTot_munic_22_pol.fid-703dc0a5_191866d88cb_-f23,3160108,Santo Antônio do Grama - MG,3684,3743,59,4224,87.22,88.61,1.4
sidra_9541_PercMoradDPPOColetTot_munic_22_pol.fid-703dc0a5_191866d88cb_-f22,3160207,Santo Antônio do Itambé - MG,873,1292,419,3910,22.33,33.04,10.72
sidra_9541_PercMoradDPPOColetTot_munic_22_pol.fid-703dc0a5_191866d88cb_-f21,3160306,Santo Antônio do Jacinto - MG,5351,6593,1242,10323,51.84,63.87,12.03
sidra_9541_PercMoradDPPOColetTot_munic_22_pol.fid-703dc0a5_191866d88cb_-f20,3160405,Santo Antônio do Monte - MG,24830,25457,627,27233,91.18,93.48,2.3
sidra_9541_PercMoradDPPOColetTot_munic_22_pol.fid-703dc0a5_191866d88cb_-f1f,3160454,Santo Antônio do Retiro - MG,3647,3664,17,6629,55.02,55.27,0.26
sidra_9541_PercMoradDPPOColetTot_munic_22_pol.fid-703dc0a5_191866d88cb_-f1e,3160504,Santo Antônio do Rio Abaixo - MG,927,1134,207,1808,51.27,62.72,11.45
sidra_9541_PercMoradDPPOColetTot_munic_22_pol.fid-703dc0a5_191866d88cb_-f1d,3160603,Santo Hipólito - MG,1994,2005,11,2703,73.77,74.18,0.41
sidra_9541_PercMoradDPPOColetTot_munic_22_pol.fid-703dc0a5_191866d88cb_-f1c,3160702,Santos Dumont - MG,39054,40785,1731,42225,92.49,96.59,4.1
sidra_9541_PercMoradDPPOColetTot_munic_22_pol.fid-703dc0a5_191866d88cb_-f1b,2616407,Vitória de Santo Antão - PE,105283,117150,11867,133715,78.74,87.61,8.87
sidra_9541_PercMoradDPPOColetTot_munic_22_pol.fid-703dc0a5_191866d88cb_-f1a,3160801,São Bento Abade - MG,4464,4523,59,4703,94.92,96.17,1.25
sidra_9541_PercMoradDPPOColetTot_munic_22_pol.fid-703dc0a5_191866d88cb_-f19,3160900,São Brás do Suaçuí - MG,3695,3927,232,3980,92.84,98.67,5.83
sidra_9541_PercMoradDPPOColetTot_munic_22_pol.fid-703dc0a5_191866d88cb_-f18,3160959,São Domingos das Dores - MG,5082,5427,345,5619,90.44,96.58,6.14
sidra_9541_PercMoradDPPOColetTot_munic_22_pol.fid-703dc0a5_191866d88cb_-f17,3161007,São Domingos do Prata - MG,13900,15337,1437,17283,80.43,88.74,8.31
sidra_9541_PercMoradDPPOColetTot_munic_22_pol.fid-703dc0a5_191866d88cb_-f16,3161056,São Félix de Minas - MG,2335,2435,100,3200,72.97,76.09,3.13
sidra_9541_PercMoradDPPOColetTot_munic_22_pol.fid-703dc0a5_191866d88cb_-f15,3161106,São Francisco - MG,34884,35270,386,52580,66.34,67.08,0.73
sidra_9541_PercMoradDPPOColetTot_munic_22_pol.fid-703dc0a5_191866d88cb_-f14,2700607,Barra de São Miguel - AL,7007,7734,727,7907,88.62,97.81,9.19
sidra_9541_PercMoradDPPOColetTot_munic_22_pol.fid-703dc0a5_191866d88cb_-f13,2701001,Boca da Mata - AL,19475,19845,370,21162,92.03,93.78,1.75
sidra_9541_PercMoradDPPOColetTot_munic_22_pol.fid-703dc0a5_191866d88cb_-f12,2701100,Branquinha - AL,5183,6208,1025,9376,55.28,66.21,10.93
sidra_9541_PercMoradDPPOColetTot_munic_22_pol.fid-703dc0a5_191866d88cb_-f11,2701209,Cacimbinhas - AL,6136,6498,362,10473,58.59,62.05,3.46
sidra_9541_PercMoradDPPOColetTot_munic_22_pol.fid-703dc0a5_191866d88cb_-f10,2701308,Cajueiro - AL,12766,15101,2335,16020,79.69,94.26,14.58
sidra_9541_PercMoradDPPOColetTot_munic_22_pol.fid-703dc0a5_191866d88cb_-f0f,3161205,São Francisco de Paula - MG,5245,5677,432,6187,84.77,91.76,6.98
sidra_9541_PercMoradDPPOColetTot_munic_22_pol.fid-703dc0a5_191866d88cb_-f0e,3161304,São Francisco de Sales - MG,4565,4834,269,5730,79.67,84.36,4.69
sidra_9541_PercMoradDPPOColetTot_munic_22_pol.fid-703dc0a5_191866d88cb_-f0d,3161403,São Francisco do Glória - MG,3060,3858,798,4797,63.79,80.43,16.64
sidra_9541_PercMoradDPPOColetTot_munic_22_pol.fid-703dc0a5_191866d88cb_-f0b,2701357,Campestre - AL,4275,6155,1880,6661,64.18,92.4,28.22
sidra_9541_PercMoradDPPOColetTot_munic_22_pol.fid-703dc0a5_191866d88cb_-f0a,2701407,Campo Alegre - AL,30650,31733,1083,32010,95.75,99.13,3.38
sidra_9541_PercMoradDPPOColetTot_munic_22_pol.fid-703dc0a5_191866d88cb_-f09,2701506,Campo Grande - AL,4430,4437,7,8140,54.42,54.51,0.09
sidra_9541_PercMoradDPPOColetTot_munic_22_pol.fid-703dc0a5_191866d88cb_-f08,2701605,Canapi - AL,7029,7514,485,15545,45.22,48.34,3.12
sidra_9541_PercMoradDPPOColetTot_munic_22_pol.fid-703dc0a5_191866d88cb_-f07,3161502,São Geraldo - MG,6530,9308,2778,10256,63.67,90.76,27.09
sidra_9541_PercMoradDPPOColetTot_munic_22_pol.fid-703dc0a5_191866d88cb_-f06,3161601,São Geraldo da Piedade - MG,2216,2412,196,3294,67.27,73.22,5.95
sidra_9541_PercMoradDPPOColetTot_munic_22_pol.fid-703dc0a5_191866d88cb_-f05,3161650,São Geraldo do Baixio - MG,2201,2321,120,3140,70.1,73.92,3.82
sidra_9541_PercMoradDPPOColetTot_munic_22_pol.fid-703dc0a5_191866d88cb_-f04,3161700,São Gonçalo do Abaeté - MG,6617,6701,84,7340,90.15,91.29,1.14
sidra_9541_PercMoradDPPOColetTot_munic_22_pol.fid-703dc0a5_191866d88cb_-f03,3161809,São Gonçalo do Pará - MG,10751,11353,602,11724,91.7,96.84,5.13
sidra_9541_PercMoradDPPOColetTot_munic_22_pol.fid-703dc0a5_191866d88cb_-f01,3161908,São Gonçalo do Rio Abaixo - MG,10226,11315,1089,11711,87.32,96.62,9.3
sidra_9541_PercMoradDPPOColetTot_munic_22_pol.fid-703dc0a5_191866d88cb_-f00,3162005,São Gonçalo do Sapucaí - MG,20808,22905,2097,23914,87.01,95.78,8.77
sidra_9541_PercMoradDPPOColetTot_munic_22_pol.fid-703dc0a5_191866d88cb_-eff,3162104,São Gotardo - MG,38908,39532,624,40751,95.48,97.01,1.53
sidra_9541_PercMoradDPPOColetTot_munic_22_pol.fid-703dc0a5_191866d88cb_-efe,3162203,São João Batista do Glória - MG,6444,7552,1108,7614,84.63,99.19,14.55
sidra_9541_PercMoradDPPOColetTot_munic_22_pol.fid-703dc0a5_191866d88cb_-efd,3162252,São João da Lagoa - MG,2903,2952,49,4811,60.34,61.36,1.02
sidra_9541_PercMoradDPPOColetTot_munic_22_pol.fid-703dc0a5_191866d88cb_-efc,3162302,São João da Mata - MG,732,2561,1829,2910,25.15,88.01,62.85
sidra_9541_PercMoradDPPOColetTot_munic_22_pol.fid-703dc0a5_191866d88cb_-efb,3162401,São João da Ponte - MG,9057,9121,64,23820,38.02,38.29,0.27
sidra_9541_PercMoradDPPOColetTot_munic_22_pol.fid-703dc0a5_191866d88cb_-ef9,3162450,São João das Missões - MG,2616,2831,215,13024,20.09,21.74,1.65
sidra_9541_PercMoradDPPOColetTot_munic_22_pol.fid-703dc0a5_191866d88cb_-ef8,3162500,São João del Rei - MG,85059,87266,2207,89437,95.1,97.57,2.47
sidra_9541_PercMoradDPPOColetTot_munic_22_pol.fid-703dc0a5_191866d88cb_-ef6,3162559,São João do Manhuaçu - MG,8067,9195,1128,11239,71.78,81.81,10.04
sidra_9541_PercMoradDPPOColetTot_munic_22_pol.fid-703dc0a5_191866d88cb_-ef5,3162575,São João do Manteninha - MG,4887,4914,27,5280,92.56,93.07,0.51
sidra_9541_PercMoradDPPOColetTot_munic_22_pol.fid-703dc0a5_191866d88cb_-ef4,3162609,São João do Oriente - MG,5997,6227,230,7062,84.92,88.18,3.26
sidra_9541_PercMoradDPPOColetTot_munic_22_pol.fid-703dc0a5_191866d88cb_-ef3,3162658,São João do Pacuí - MG,2169,2253,84,3971,54.62,56.74,2.12
sidra_9541_PercMoradDPPOColetTot_munic_22_pol.fid-703dc0a5_191866d88cb_-ef2,3162708,São João do Paraíso - MG,15128,15423,295,23902,63.29,64.53,1.23
sidra_9541_PercMoradDPPOColetTot_munic_22_pol.fid-703dc0a5_191866d88cb_-ef0,2701704,Capela - AL,12748,12888,140,14896,85.58,86.52,0.94
sidra_9541_PercMoradDPPOColetTot_munic_22_pol.fid-703dc0a5_191866d88cb_-eef,2707701,Rio Largo - AL,84187,89282,5095,93887,89.67,95.1,5.43
sidra_9541_PercMoradDPPOColetTot_munic_22_pol.fid-703dc0a5_191866d88cb_-eee,2701803,Carneiros - AL,4816,5476,660,8916,54.02,61.42,7.4
sidra_9541_PercMoradDPPOColetTot_munic_22_pol.fid-703dc0a5_191866d88cb_-eed,2702108,Colônia Leopoldina - AL,10781,13552,2771,15802,68.23,85.76,17.54
sidra_9541_PercMoradDPPOColetTot_munic_22_pol.fid-703dc0a5_191866d88cb_-eec,2702207,Coqueiro Seco - AL,5445,5459,14,5571,97.74,97.99,0.25
sidra_9541_PercMoradDPPOColetTot_munic_22_pol.fid-703dc0a5_191866d88cb_-eeb,2702306,Coruripe - AL,45181,47536,2355,50286,89.85,94.53,4.68
sidra_9541_PercMoradDPPOColetTot_munic_22_pol.fid-703dc0a5_191866d88cb_-eea,2702355,Craíbas - AL,16407,16542,135,25329,64.78,65.31,0.53
sidra_9541_PercMoradDPPOColetTot_munic_22_pol.fid-703dc0a5_191866d88cb_-ee9,2702405,Delmiro Gouveia - AL,46873,48086,1213,51193,91.56,93.93,2.37
sidra_9541_PercMoradDPPOColetTot_munic_22_pol.fid-703dc0a5_191866d88cb_-ee8,3162807,São João Evangelista - MG,10431,11520,1089,15177,68.73,75.9,7.18
sidra_9541_PercMoradDPPOColetTot_munic_22_pol.fid-703dc0a5_191866d88cb_-ee7,3162906,São João Nepomuceno - MG,23297,25069,1772,25430,91.61,98.58,6.97
sidra_9541_PercMoradDPPOColetTot_munic_22_pol.fid-703dc0a5_191866d88cb_-ee6,3162922,São Joaquim de Bicas - MG,29281,29599,318,31236,93.74,94.76,1.02
sidra_9541_PercMoradDPPOColetTot_munic_22_pol.fid-703dc0a5_191866d88cb_-ee5,2701902,Chã Preta - AL,4425,4444,19,5877,75.29,75.62,0.32
sidra_9541_PercMoradDPPOColetTot_munic_22_pol.fid-703dc0a5_191866d88cb_-ee4,2702009,Coité do Nóia - AL,4937,4960,23,10802,45.7,45.92,0.21
sidra_9541_PercMoradDPPOColetTot_munic_22_pol.fid-703dc0a5_191866d88cb_-ee3,2702504,Dois Riachos - AL,5387,5689,302,9805,54.94,58.02,3.08
sidra_9541_PercMoradDPPOColetTot_munic_22_pol.fid-703dc0a5_191866d88cb_-ee2,3162948,São José da Barra - MG,6025,7489,1464,7780,77.44,96.26,18.82
sidra_9541_PercMoradDPPOColetTot_munic_22_pol.fid-703dc0a5_191866d88cb_-ee1,3162955,São José da Lapa - MG,25633,25849,216,26042,98.43,99.26,0.83
sidra_9541_PercMoradDPPOColetTot_munic_22_pol.fid-703dc0a5_191866d88cb_-ee0,2702553,Estrela de Alagoas - AL,5178,5881,703,15426,33.57,38.12,4.56
sidra_9541_PercMoradDPPOColetTot_munic_22_pol.fid-703dc0a5_191866d88cb_-edf,2702603,Feira Grande - AL,12439,13229,790,22710,54.77,58.25,3.48
sidra_9541_PercMoradDPPOColetTot_munic_22_pol.fid-703dc0a5_191866d88cb_-edd,2702702,Feliz Deserto - AL,2517,3786,1269,3962,63.53,95.56,32.03
sidra_9541_PercMoradDPPOColetTot_munic_22_pol.fid-703dc0a5_191866d88cb_-edc,2702801,Flexeiras - AL,7022,7199,177,9616,73.02,74.86,1.84
sidra_9541_PercMoradDPPOColetTot_munic_22_pol.fid-703dc0a5_191866d88cb_-edb,2702900,Girau do Ponciano - AL,20141,20761,620,35310,57.04,58.8,1.76
sidra_9541_PercMoradDPPOColetTot_munic_22_pol.fid-703dc0a5_191866d88cb_-eda,2704104,Lagoa da Canoa - AL,12089,15026,2937,18428,65.6,81.54,15.94
sidra_9541_PercMoradDPPOColetTot_munic_22_pol.fid-703dc0a5_191866d88cb_-ed9,2704203,Limoeiro de Anadia - AL,16809,19990,3181,24717,68.01,80.88,12.87
sidra_9541_PercMoradDPPOColetTot_munic_22_pol.fid-703dc0a5_191866d88cb_-ed8,2704302,Maceió - AL,830990,930921,99931,953326,87.17,97.65,10.48
sidra_9541_PercMoradDPPOColetTot_munic_22_pol.fid-703dc0a5_191866d88cb_-ed7,2704401,Major Isidoro - AL,11116,11231,115,17684,62.86,63.51,0.65
sidra_9541_PercMoradDPPOColetTot_munic_22_pol.fid-703dc0a5_191866d88cb_-ed6,2704500,Maragogi - AL,15472,26008,10536,31977,48.38,81.33,32.95
sidra_9541_PercMoradDPPOColetTot_munic_22_pol.fid-703dc0a5_191866d88cb_-ed5,3163003,São José da Safira - MG,3087,3087,,3806,81.11,81.11,
sidra_9541_PercMoradDPPOColetTot_munic_22_pol.fid-703dc0a5_191866d88cb_-ed4,3163102,São José da Varginha - MG,3417,4269,852,4531,75.41,94.22,18.8
sidra_9541_PercMoradDPPOColetTot_munic_22_pol.fid-703dc0a5_191866d88cb_-ed3,3163201,São José do Alegre - MG,3607,3908,301,4128,87.38,94.67,7.29
sidra_9541_PercMoradDPPOColetTot_munic_22_pol.fid-703dc0a5_191866d88cb_-ed2,3163300,São José do Divino - MG,1974,2568,594,3464,56.99,74.13,17.15
sidra_9541_PercMoradDPPOColetTot_munic_22_pol.fid-703dc0a5_191866d88cb_-ed0,3163409,São José do Goiabal - MG,4287,4610,323,5388,79.57,85.56,5.99
sidra_9541_PercMoradDPPOColetTot_munic_22_pol.fid-703dc0a5_191866d88cb_-ecf,3163508,São José do Jacuri - MG,2207,2566,359,6194,35.63,41.43,5.8
sidra_9541_PercMoradDPPOColetTot_munic_22_pol.fid-703dc0a5_191866d88cb_-ece,2703007,Ibateguara - AL,8612,11716,3104,13697,62.88,85.54,22.66
sidra_9541_PercMoradDPPOColetTot_munic_22_pol.fid-703dc0a5_191866d88cb_-ecd,2703106,Igaci - AL,12534,12689,155,23986,52.26,52.9,0.65
sidra_9541_PercMoradDPPOColetTot_munic_22_pol.fid-703dc0a5_191866d88cb_-ecc,3163607,São José do Mantimento - MG,2062,2084,22,2737,75.34,76.14,0.8
sidra_9541_PercMoradDPPOColetTot_munic_22_pol.fid-703dc0a5_191866d88cb_-ecb,3163706,São Lourenço - MG,39718,44200,4482,44337,89.58,99.69,10.11
sidra_9541_PercMoradDPPOColetTot_munic_22_pol.fid-703dc0a5_191866d88cb_-eca,3163805,São Miguel do Anta - MG,4734,5591,857,6330,74.79,88.33,13.54
sidra_9541_PercMoradDPPOColetTot_munic_22_pol.fid-703dc0a5_191866d88cb_-ec9,3163904,São Pedro da União - MG,3345,4415,1070,4855,68.9,90.94,22.04
sidra_9541_PercMoradDPPOColetTot_munic_22_pol.fid-703dc0a5_191866d88cb_-ec8,3164001,São Pedro dos Ferros - MG,5996,6404,408,7134,84.05,89.77,5.72
sidra_9541_PercMoradDPPOColetTot_munic_22_pol.fid-703dc0a5_191866d88cb_-ec7,3164100,São Pedro do Suaçuí - MG,172,3057,2885,5084,3.38,60.13,56.75
sidra_9541_PercMoradDPPOColetTot_munic_22_pol.fid-703dc0a5_191866d88cb_-ec6,3164209,São Romão - MG,7105,7141,36,10292,69.03,69.38,0.35
sidra_9541_PercMoradDPPOColetTot_munic_22_pol.fid-703dc0a5_191866d88cb_-ec5,3164308,São Roque de Minas - MG,4764,5329,565,7068,67.4,75.4,7.99
sidra_9541_PercMoradDPPOColetTot_munic_22_pol.fid-703dc0a5_191866d88cb_-ec4,3164407,São Sebastião da Bela Vista - MG,5099,6196,1097,6339,80.44,97.74,17.31
sidra_9541_PercMoradDPPOColetTot_munic_22_pol.fid-703dc0a5_191866d88cb_-ec3,3164431,São Sebastião da Vargem Alegre - MG,1099,2309,1210,3112,35.31,74.2,38.88
sidra_9541_PercMoradDPPOColetTot_munic_22_pol.fid-703dc0a5_191866d88cb_-ec1,3164472,São Sebastião do Anta - MG,5020,5484,464,6180,81.23,88.74,7.51
sidra_9541_PercMoradDPPOColetTot_munic_22_pol.fid-703dc0a5_191866d88cb_-ec0,3164506,São Sebastião do Maranhão - MG,3806,3864,58,10047,37.88,38.46,0.58
sidra_9541_PercMoradDPPOColetTot_munic_22_pol.fid-703dc0a5_191866d88cb_-ebf,3164605,São Sebastião do Oeste - MG,7367,8121,754,8790,83.81,92.39,8.58
sidra_9541_PercMoradDPPOColetTot_munic_22_pol.fid-703dc0a5_191866d88cb_-ebe,3164704,São Sebastião do Paraíso - MG,66709,69657,2948,71332,93.52,97.65,4.13
sidra_9541_PercMoradDPPOColetTot_munic_22_pol.fid-703dc0a5_191866d88cb_-ebd,3164803,São Sebastião do Rio Preto - MG,827,836,9,1259,65.69,66.4,0.71
sidra_9541_PercMoradDPPOColetTot_munic_22_pol.fid-703dc0a5_191866d88cb_-ebc,3164902,São Sebastião do Rio Verde - MG,1706,1752,46,2274,75.02,77.04,2.02
sidra_9541_PercMoradDPPOColetTot_munic_22_pol.fid-703dc0a5_191866d88cb_-ebb,3165008,São Tiago - MG,9944,10291,347,11169,89.03,92.14,3.11
sidra_9541_PercMoradDPPOColetTot_munic_22_pol.fid-703dc0a5_191866d88cb_-eba,3165107,São Tomás de Aquino - MG,5354,6299,945,6733,79.52,93.55,14.04
sidra_9541_PercMoradDPPOColetTot_munic_22_pol.fid-703dc0a5_191866d88cb_-eb9,3165206,São Tomé das Letras - MG,4400,5602,1202,6804,64.67,82.33,17.67
sidra_9541_PercMoradDPPOColetTot_munic_22_pol.fid-703dc0a5_191866d88cb_-eb8,3165305,São Vicente de Minas - MG,6050,6108,58,6727,89.94,90.8,0.86
sidra_9541_PercMoradDPPOColetTot_munic_22_pol.fid-703dc0a5_191866d88cb_-eb7,3165404,Sapucaí-Mirim - MG,4733,6261,1528,6304,75.08,99.32,24.24
sidra_9541_PercMoradDPPOColetTot_munic_22_pol.fid-703dc0a5_191866d88cb_-eb6,3165503,Sardoá - MG,2633,2737,104,5091,51.72,53.76,2.04
sidra_9541_PercMoradDPPOColetTot_munic_22_pol.fid-703dc0a5_191866d88cb_-eb5,3165537,Sarzedo - MG,36514,36677,163,36795,99.24,99.68,0.44
sidra_9541_PercMoradDPPOColetTot_munic_22_pol.fid-703dc0a5_191866d88cb_-eb4,3165552,Setubinha - MG,3221,3349,128,9915,32.49,33.78,1.29
sidra_9541_PercMoradDPPOColetTot_munic_22_pol.fid-703dc0a5_191866d88cb_-eb3,2703205,Igreja Nova - AL,15910,19225,3315,21371,74.45,89.96,15.51
sidra_9541_PercMoradDPPOColetTot_munic_22_pol.fid-703dc0a5_191866d88cb_-eb2,2704609,Maravilha - AL,5737,6615,878,9533,60.18,69.39,9.21
sidra_9541_PercMoradDPPOColetTot_munic_22_pol.fid-703dc0a5_191866d88cb_-eb1,2704708,Marechal Deodoro - AL,54084,57570,3486,60268,89.74,95.52,5.78
sidra_9541_PercMoradDPPOColetTot_munic_22_pol.fid-703dc0a5_191866d88cb_-eb0,2704807,Maribondo - AL,11615,11729,114,13669,84.97,85.81,0.83
sidra_9541_PercMoradDPPOColetTot_munic_22_pol.fid-703dc0a5_191866d88cb_-eaf,3165560,Sem-Peixe - MG,1296,1616,320,2433,53.27,66.42,13.15
sidra_9541_PercMoradDPPOColetTot_munic_22_pol.fid-703dc0a5_191866d88cb_-eae,3165578,Senador Amaral - MG,4790,5881,1091,6194,77.33,94.95,17.61
sidra_9541_PercMoradDPPOColetTot_munic_22_pol.fid-703dc0a5_191866d88cb_-ead,3165602,Senador Cortes - MG,1820,2075,255,2239,81.29,92.68,11.39
sidra_9541_PercMoradDPPOColetTot_munic_22_pol.fid-703dc0a5_191866d88cb_-eac,3165701,Senador Firmino - MG,579,6660,6081,7670,7.55,86.83,79.28
sidra_9541_PercMoradDPPOColetTot_munic_22_pol.fid-703dc0a5_191866d88cb_-eaa,3165800,Senador José Bento - MG,1972,1976,4,2068,95.36,95.55,0.19
sidra_9541_PercMoradDPPOColetTot_munic_22_pol.fid-703dc0a5_191866d88cb_-ea9,3165909,Senador Modestino Gonçalves - MG,1740,1950,210,3996,43.54,48.8,5.26
sidra_9541_PercMoradDPPOColetTot_munic_22_pol.fid-703dc0a5_191866d88cb_-ea8,3166006,Senhora de Oliveira - MG,5135,5203,68,5468,93.91,95.15,1.24
sidra_9541_PercMoradDPPOColetTot_munic_22_pol.fid-703dc0a5_191866d88cb_-ea7,3166105,Senhora do Porto - MG,1638,1760,122,3062,53.49,57.48,3.98
sidra_9541_PercMoradDPPOColetTot_munic_22_pol.fid-703dc0a5_191866d88cb_-ea6,2703304,Inhapi - AL,7293,7746,453,15166,48.09,51.07,2.99
sidra_9541_PercMoradDPPOColetTot_munic_22_pol.fid-703dc0a5_191866d88cb_-ea5,3166204,Senhora dos Remédios - MG,2811,7642,4831,10377,27.09,73.64,46.55
sidra_9541_PercMoradDPPOColetTot_munic_22_pol.fid-703dc0a5_191866d88cb_-ea4,3166303,Sericita - MG,4545,5197,652,7344,61.89,70.77,8.88
sidra_9541_PercMoradDPPOColetTot_munic_22_pol.fid-703dc0a5_191866d88cb_-ea3,3166402,Seritinga - MG,1614,1666,52,1818,88.78,91.64,2.86
sidra_9541_PercMoradDPPOColetTot_munic_22_pol.fid-703dc0a5_191866d88cb_-ea2,3166501,Serra Azul de Minas - MG,1790,1942,152,3792,47.2,51.21,4.01
sidra_9541_PercMoradDPPOColetTot_munic_22_pol.fid-703dc0a5_191866d88cb_-ea1,3166600,Serra da Saudade - MG,546,646,100,829,65.86,77.93,12.06
sidra_9541_PercMoradDPPOColetTot_munic_22_pol.fid-703dc0a5_191866d88cb_-ea0,3166709,Serra dos Aimorés - MG,5679,6348,669,6931,81.94,91.59,9.65
sidra_9541_PercMoradDPPOColetTot_munic_22_pol.fid-703dc0a5_191866d88cb_-e9f,3166808,Serra do Salitre - MG,9352,10584,1232,11770,79.46,89.92,10.47
sidra_9541_PercMoradDPPOColetTot_munic_22_pol.fid-703dc0a5_191866d88cb_-e9e,3166907,Serrania - MG,7136,7192,56,7593,93.98,94.72,0.74
sidra_9541_PercMoradDPPOColetTot_munic_22_pol.fid-703dc0a5_191866d88cb_-e9d,3166956,Serranópolis de Minas - MG,2284,2304,20,4398,51.93,52.39,0.45
sidra_9541_PercMoradDPPOColetTot_munic_22_pol.fid-703dc0a5_191866d88cb_-e9c,3167004,Serranos - MG,1698,1849,151,1979,85.8,93.43,7.63
sidra_9541_PercMoradDPPOColetTot_munic_22_pol.fid-703dc0a5_191866d88cb_-e9b,3167103,Serro - MG,13617,14831,1214,21754,62.6,68.18,5.58
sidra_9541_PercMoradDPPOColetTot_munic_22_pol.fid-703dc0a5_191866d88cb_-e99,3167202,Sete Lagoas - MG,221344,224054,2710,226521,97.71,98.91,1.2
sidra_9541_PercMoradDPPOColetTot_munic_22_pol.fid-703dc0a5_191866d88cb_-e98,3167301,Silveirânia - MG,1788,1899,111,2307,77.5,82.31,4.81
sidra_9541_PercMoradDPPOColetTot_munic_22_pol.fid-703dc0a5_191866d88cb_-e97,3167400,Silvianópolis - MG,3909,4752,843,6135,63.72,77.46,13.74
sidra_9541_PercMoradDPPOColetTot_munic_22_pol.fid-703dc0a5_191866d88cb_-e96,3167509,Simão Pereira - MG,2472,2703,231,2947,83.88,91.72,7.84
sidra_9541_PercMoradDPPOColetTot_munic_22_pol.fid-703dc0a5_191866d88cb_-e95,3167608,Simonésia - MG,10757,15139,4382,19663,54.71,76.99,22.29
sidra_9541_PercMoradDPPOColetTot_munic_22_pol.fid-703dc0a5_191866d88cb_-e94,3167707,Sobrália - MG,3872,3991,119,5137,75.37,77.69,2.32
sidra_9541_PercMoradDPPOColetTot_munic_22_pol.fid-703dc0a5_191866d88cb_-e93,3167806,Soledade de Minas - MG,4647,5312,665,5608,82.86,94.72,11.86
sidra_9541_PercMoradDPPOColetTot_munic_22_pol.fid-703dc0a5_191866d88cb_-e92,2703403,Jacaré dos Homens - AL,3386,4568,1182,5081,66.64,89.9,23.26
sidra_9541_PercMoradDPPOColetTot_munic_22_pol.fid-703dc0a5_191866d88cb_-e91,2704906,Mar Vermelho - AL,2396,2496,100,3155,75.94,79.11,3.17
sidra_9541_PercMoradDPPOColetTot_munic_22_pol.fid-703dc0a5_191866d88cb_-e90,2705002,Mata Grande - AL,7165,7704,539,21840,32.81,35.27,2.47
sidra_9541_PercMoradDPPOColetTot_munic_22_pol.fid-703dc0a5_191866d88cb_-e8f,2705101,Matriz de Camaragibe - AL,19999,21480,1481,23771,84.13,90.36,6.23
sidra_9541_PercMoradDPPOColetTot_munic_22_pol.fid-703dc0a5_191866d88cb_-e8e,2705200,Messias - AL,12063,14145,2082,15340,78.64,92.21,13.57
sidra_9541_PercMoradDPPOColetTot_munic_22_pol.fid-703dc0a5_191866d88cb_-e8d,3167905,Tabuleiro - MG,3455,3565,110,4014,86.07,88.81,2.74
sidra_9541_PercMoradDPPOColetTot_munic_22_pol.fid-703dc0a5_191866d88cb_-e8c,2703502,Jacuípe - AL,3868,4135,267,5322,72.68,77.7,5.02
sidra_9541_PercMoradDPPOColetTot_munic_22_pol.fid-703dc0a5_191866d88cb_-e8b,2703601,Japaratinga - AL,5325,7669,2344,9183,57.99,83.51,25.53
sidra_9541_PercMoradDPPOColetTot_munic_22_pol.fid-703dc0a5_191866d88cb_-e8a,2703700,Jaramataia - AL,3119,4123,1004,4983,62.59,82.74,20.15
sidra_9541_PercMoradDPPOColetTot_munic_22_pol.fid-703dc0a5_191866d88cb_-e89,2703759,Jequiá da Praia - AL,8002,8945,943,9453,84.65,94.63,9.98
sidra_9541_PercMoradDPPOColetTot_munic_22_pol.fid-703dc0a5_191866d88cb_-e88,2703809,Joaquim Gomes - AL,10226,11372,1146,17120,59.73,66.43,6.69
sidra_9541_PercMoradDPPOColetTot_munic_22_pol.fid-703dc0a5_191866d88cb_-e87,2703908,Jundiá - AL,2205,3130,925,4088,53.94,76.57,22.63
sidra_9541_PercMoradDPPOColetTot_munic_22_pol.fid-703dc0a5_191866d88cb_-e86,2704005,Junqueiro - AL,20742,22000,1258,23868,86.9,92.17,5.27
sidra_9541_PercMoradDPPOColetTot_munic_22_pol.fid-703dc0a5_191866d88cb_-e85,3168002,Taiobeiras - MG,30534,31023,489,32892,92.83,94.32,1.49
sidra_9541_PercMoradDPPOColetTot_munic_22_pol.fid-703dc0a5_191866d88cb_-e84,3168051,Taparuba - MG,2531,2903,372,3387,74.73,85.71,10.98
sidra_9541_PercMoradDPPOColetTot_munic_22_pol.fid-703dc0a5_191866d88cb_-e82,3168101,Tapira - MG,2484,3396,912,4117,60.34,82.49,22.15
sidra_9541_PercMoradDPPOColetTot_munic_22_pol.fid-703dc0a5_191866d88cb_-e81,3168200,Tapiraí - MG,974,1297,323,1689,57.67,76.79,19.12
sidra_9541_PercMoradDPPOColetTot_munic_22_pol.fid-703dc0a5_191866d88cb_-e80,3168309,Taquaraçu de Minas - MG,2540,2936,396,4218,60.22,69.61,9.39
sidra_9541_PercMoradDPPOColetTot_munic_22_pol.fid-703dc0a5_191866d88cb_-e7f,3168408,Tarumirim - MG,10715,11458,743,14622,73.28,78.36,5.08
sidra_9541_PercMoradDPPOColetTot_munic_22_pol.fid-703dc0a5_191866d88cb_-e7e,3168507,Teixeiras - MG,8288,9810,1522,12206,67.9,80.37,12.47
sidra_9541_PercMoradDPPOColetTot_munic_22_pol.fid-703dc0a5_191866d88cb_-e7d,3168606,Teófilo Otoni - MG,102272,119740,17468,136188,75.1,87.92,12.83
sidra_9541_PercMoradDPPOColetTot_munic_22_pol.fid-703dc0a5_191866d88cb_-e7b,3168705,Timóteo - MG,79569,80894,1325,81410,97.74,99.37,1.63
sidra_9541_PercMoradDPPOColetTot_munic_22_pol.fid-703dc0a5_191866d88cb_-e7a,3168804,Tiradentes - MG,6638,7509,871,7653,86.74,98.12,11.38
sidra_9541_PercMoradDPPOColetTot_munic_22_pol.fid-703dc0a5_191866d88cb_-e79,3168903,Tiros - MG,6063,6667,604,7849,77.25,84.94,7.7
sidra_9541_PercMoradDPPOColetTot_munic_22_pol.fid-703dc0a5_191866d88cb_-e78,3169000,Tocantins - MG,13724,14220,496,16106,85.21,88.29,3.08
sidra_9541_PercMoradDPPOColetTot_munic_22_pol.fid-703dc0a5_191866d88cb_-e77,3169059,Tocos do Moji - MG,3291,3718,427,3824,86.06,97.23,11.17
sidra_9541_PercMoradDPPOColetTot_munic_22_pol.fid-703dc0a5_191866d88cb_-e76,2705606,Novo Lino - AL,4570,6298,1728,10015,45.63,62.89,17.25
sidra_9541_PercMoradDPPOColetTot_munic_22_pol.fid-703dc0a5_191866d88cb_-e75,3169109,Toledo - MG,6164,6868,704,7159,86.1,95.94,9.83
sidra_9541_PercMoradDPPOColetTot_munic_22_pol.fid-703dc0a5_191866d88cb_-e74,3169208,Tombos - MG,7843,8050,207,8567,91.55,93.97,2.42
sidra_9541_PercMoradDPPOColetTot_munic_22_pol.fid-703dc0a5_191866d88cb_-e73,3169307,Três Corações - MG,68120,71575,3455,74333,91.64,96.29,4.65
sidra_9541_PercMoradDPPOColetTot_munic_22_pol.fid-703dc0a5_191866d88cb_-e72,3169356,Três Marias - MG,26716,27250,534,28770,92.86,94.72,1.86
sidra_9541_PercMoradDPPOColetTot_munic_22_pol.fid-703dc0a5_191866d88cb_-e70,3169406,Três Pontas - MG,49542,51649,2107,55019,90.05,93.87,3.83
sidra_9541_PercMoradDPPOColetTot_munic_22_pol.fid-703dc0a5_191866d88cb_-e6f,2706000,Olivença - AL,4972,5463,491,10812,45.99,50.53,4.54
sidra_9541_PercMoradDPPOColetTot_munic_22_pol.fid-703dc0a5_191866d88cb_-e6e,3169505,Tumiritinga - MG,4693,4769,76,5885,79.75,81.04,1.29
sidra_9541_PercMoradDPPOColetTot_munic_22_pol.fid-703dc0a5_191866d88cb_-e6d,3169604,Tupaciguara - MG,23374,24426,1052,25245,92.59,96.76,4.17
sidra_9541_PercMoradDPPOColetTot_munic_22_pol.fid-703dc0a5_191866d88cb_-e6c,3169703,Turmalina - MG,15978,17317,1339,19918,80.22,86.94,6.72
sidra_9541_PercMoradDPPOColetTot_munic_22_pol.fid-703dc0a5_191866d88cb_-e6b,3169802,Turvolândia - MG,3463,4176,713,4888,70.85,85.43,14.59
sidra_9541_PercMoradDPPOColetTot_munic_22_pol.fid-703dc0a5_191866d88cb_-e69,3169901,Ubá - MG,75979,101207,25228,102943,73.81,98.31,24.51
sidra_9541_PercMoradDPPOColetTot_munic_22_pol.fid-703dc0a5_191866d88cb_-e65,3170008,Ubaí - MG,4671,7039,2368,11694,39.94,60.19,20.25
sidra_9541_PercMoradDPPOColetTot_munic_22_pol.fid-703dc0a5_191866d88cb_-e64,3170057,Ubaporanga - MG,7701,9350,1649,12999,59.24,71.93,12.69
sidra_9541_PercMoradDPPOColetTot_munic_22_pol.fid-703dc0a5_191866d88cb_-e63,3170107,Uberaba - MG,322462,331547,9085,335581,96.09,98.8,2.71
sidra_9541_PercMoradDPPOColetTot_munic_22_pol.fid-703dc0a5_191866d88cb_-e62,3170206,Uberlândia - MG,644005,707983,63978,711082,90.57,99.56,9
sidra_9541_PercMoradDPPOColetTot_munic_22_pol.fid-703dc0a5_191866d88cb_-e60,3170305,Umburatiba - MG,2188,2213,25,2681,81.61,82.54,0.93
sidra_9541_PercMoradDPPOColetTot_munic_22_pol.fid-703dc0a5_191866d88cb_-e5f,3170404,Unaí - MG,72112,74386,2274,85538,84.3,86.96,2.66
sidra_9541_PercMoradDPPOColetTot_munic_22_pol.fid-703dc0a5_191866d88cb_-e5e,3170438,União de Minas - MG,2478,2746,268,3822,64.84,71.85,7.01
sidra_9541_PercMoradDPPOColetTot_munic_22_pol.fid-703dc0a5_191866d88cb_-e5d,3170479,Uruana de Minas - MG,2397,2505,108,3281,73.06,76.35,3.29
sidra_9541_PercMoradDPPOColetTot_munic_22_pol.fid-703dc0a5_191866d88cb_-e5c,3170503,Urucânia - MG,8306,9600,1294,10573,78.56,90.8,12.24
sidra_9541_PercMoradDPPOColetTot_munic_22_pol.fid-703dc0a5_191866d88cb_-e5b,3170529,Urucuia - MG,9034,9043,9,17464,51.73,51.78,0.05
sidra_9541_PercMoradDPPOColetTot_munic_22_pol.fid-703dc0a5_191866d88cb_-e5a,3170578,Vargem Alegre - MG,4999,5132,133,5777,86.53,88.84,2.3
sidra_9541_PercMoradDPPOColetTot_munic_22_pol.fid-703dc0a5_191866d88cb_-e59,3170602,Vargem Bonita - MG,1594,1880,286,2157,73.9,87.16,13.26
sidra_9541_PercMoradDPPOColetTot_munic_22_pol.fid-703dc0a5_191866d88cb_-e58,3170651,Vargem Grande do Rio Pardo - MG,2621,3034,413,4631,56.6,65.52,8.92
sidra_9541_PercMoradDPPOColetTot_munic_22_pol.fid-703dc0a5_191866d88cb_-e56,3170701,Varginha - MG,130426,134914,4488,136058,95.86,99.16,3.3
sidra_9541_PercMoradDPPOColetTot_munic_22_pol.fid-703dc0a5_191866d88cb_-e55,3170750,Varjão de Minas - MG,5590,6383,793,6956,80.36,91.76,11.4
sidra_9541_PercMoradDPPOColetTot_munic_22_pol.fid-703dc0a5_191866d88cb_-e54,3170800,Várzea da Palma - MG,29423,30746,1323,33480,87.88,91.83,3.95
sidra_9541_PercMoradDPPOColetTot_munic_22_pol.fid-703dc0a5_191866d88cb_-e53,3170909,Varzelândia - MG,10339,10506,167,18832,54.9,55.79,0.89
sidra_9541_PercMoradDPPOColetTot_munic_22_pol.fid-703dc0a5_191866d88cb_-e52,3171006,Vazante - MG,17389,18585,1196,19913,87.32,93.33,6.01
sidra_9541_PercMoradDPPOColetTot_munic_22_pol.fid-703dc0a5_191866d88cb_-e50,2706109,Ouro Branco - AL,7338,7395,57,11446,64.11,64.61,0.5
sidra_9541_PercMoradDPPOColetTot_munic_22_pol.fid-703dc0a5_191866d88cb_-e4f,2706208,Palestina - AL,1973,3919,1946,4309,45.79,90.95,45.16
sidra_9541_PercMoradDPPOColetTot_munic_22_pol.fid-703dc0a5_191866d88cb_-e4e,2706307,Palmeira dos Índios - AL,49963,51806,1843,71448,69.93,72.51,2.58
sidra_9541_PercMoradDPPOColetTot_munic_22_pol.fid-703dc0a5_191866d88cb_-e4d,2706406,Pão de Açúcar - AL,14973,16932,1959,23806,62.9,71.12,8.23
sidra_9541_PercMoradDPPOColetTot_munic_22_pol.fid-703dc0a5_191866d88cb_-e4c,2706422,Pariconha - AL,8713,9632,919,10572,82.42,91.11,8.69
sidra_9541_PercMoradDPPOColetTot_munic_22_pol.fid-703dc0a5_191866d88cb_-e4b,2706448,Paripueira - AL,11745,13027,1282,13819,84.99,94.27,9.28
sidra_9541_PercMoradDPPOColetTot_munic_22_pol.fid-703dc0a5_191866d88cb_-e4a,2706505,Passo de Camaragibe - AL,9055,11710,2655,13791,65.66,84.91,19.25
sidra_9541_PercMoradDPPOColetTot_munic_22_pol.fid-703dc0a5_191866d88cb_-e49,3171030,Verdelândia - MG,4894,4909,15,7646,64.01,64.2,0.2
sidra_9541_PercMoradDPPOColetTot_munic_22_pol.fid-703dc0a5_191866d88cb_-e48,3171071,Veredinha - MG,4146,4211,65,5179,80.05,81.31,1.26
sidra_9541_PercMoradDPPOColetTot_munic_22_pol.fid-703dc0a5_191866d88cb_-e47,3171105,Veríssimo - MG,2204,2621,417,3375,65.3,77.66,12.36
sidra_9541_PercMoradDPPOColetTot_munic_22_pol.fid-703dc0a5_191866d88cb_-e46,3171154,Vermelho Novo - MG,2207,2657,450,4895,45.09,54.28,9.19
sidra_9541_PercMoradDPPOColetTot_munic_22_pol.fid-703dc0a5_191866d88cb_-e45,3171204,Vespasiano - MG,121975,127963,5988,128987,94.56,99.21,4.64
sidra_9541_PercMoradDPPOColetTot_munic_22_pol.fid-703dc0a5_191866d88cb_-e44,3171303,Viçosa - MG,65824,73527,7703,76117,86.48,96.6,10.12
sidra_9541_PercMoradDPPOColetTot_munic_22_pol.fid-703dc0a5_191866d88cb_-e43,3171402,Vieiras - MG,2536,3150,614,3689,68.74,85.39,16.64
sidra_9541_PercMoradDPPOColetTot_munic_22_pol.fid-703dc0a5_191866d88cb_-e42,3171501,Mathias Lobato - MG,2629,2677,48,3031,86.74,88.32,1.58
sidra_9541_PercMoradDPPOColetTot_munic_22_pol.fid-703dc0a5_191866d88cb_-e41,3171600,Virgem da Lapa - MG,7162,7409,247,11760,60.9,63,2.1
sidra_9541_PercMoradDPPOColetTot_munic_22_pol.fid-703dc0a5_191866d88cb_-e40,3171709,Virgínia - MG,5557,5816,259,8852,62.78,65.7,2.93
sidra_9541_PercMoradDPPOColetTot_munic_22_pol.fid-703dc0a5_191866d88cb_-e3f,3171808,Virginópolis - MG,7199,8448,1249,10292,69.95,82.08,12.14
sidra_9541_PercMoradDPPOColetTot_munic_22_pol.fid-703dc0a5_191866d88cb_-e3e,3171907,Virgolândia - MG,3063,3356,293,4532,67.59,74.05,6.47
sidra_9541_PercMoradDPPOColetTot_munic_22_pol.fid-703dc0a5_191866d88cb_-e3d,3172004,Visconde do Rio Branco - MG,27951,37703,9752,39101,71.48,96.42,24.94
sidra_9541_PercMoradDPPOColetTot_munic_22_pol.fid-703dc0a5_191866d88cb_-e3c,3172103,Volta Grande - MG,3999,4134,135,4440,90.07,93.11,3.04
sidra_9541_PercMoradDPPOColetTot_munic_22_pol.fid-703dc0a5_191866d88cb_-e3b,3172202,Wenceslau Braz - MG,2137,2298,161,2342,91.25,98.12,6.87
sidra_9541_PercMoradDPPOColetTot_munic_22_pol.fid-703dc0a5_191866d88cb_-e3a,2707206,Poço das Trincheiras - AL,6018,6627,609,12480,48.22,53.1,4.88
sidra_9541_PercMoradDPPOColetTot_munic_22_pol.fid-703dc0a5_191866d88cb_-e39,2707305,Porto Calvo - AL,19393,21483,2090,24059,80.61,89.29,8.69
sidra_9541_PercMoradDPPOColetTot_munic_22_pol.fid-703dc0a5_191866d88cb_-e38,2707404,Porto de Pedras - AL,5007,7093,2086,9227,54.26,76.87,22.61
sidra_9541_PercMoradDPPOColetTot_munic_22_pol.fid-703dc0a5_191866d88cb_-e37,2707503,Porto Real do Colégio - AL,13297,13888,591,20049,66.32,69.27,2.95
sidra_9541_PercMoradDPPOColetTot_munic_22_pol.fid-703dc0a5_191866d88cb_-e36,2708006,Santana do Ipanema - AL,28949,32138,3189,46093,62.81,69.72,6.92
sidra_9541_PercMoradDPPOColetTot_munic_22_pol.fid-703dc0a5_191866d88cb_-e35,2708105,Santana do Mundaú - AL,7067,7102,35,11320,62.43,62.74,0.31
sidra_9541_PercMoradDPPOColetTot_munic_22_pol.fid-703dc0a5_191866d88cb_-e34,3200102,Afonso Cláudio - ES,15584,21265,5681,30604,50.92,69.48,18.56
sidra_9541_PercMoradDPPOColetTot_munic_22_pol.fid-703dc0a5_191866d88cb_-e33,3200136,Águia Branca - ES,1119,5007,3888,9708,11.53,51.58,40.05
sidra_9541_PercMoradDPPOColetTot_munic_22_pol.fid-703dc0a5_191866d88cb_-e32,3200169,Água Doce do Norte - ES,5495,8585,3090,12032,45.67,71.35,25.68
sidra_9541_PercMoradDPPOColetTot_munic_22_pol.fid-703dc0a5_191866d88cb_-e31,3200201,Alegre - ES,15916,25634,9718,29128,54.64,88,33.36
sidra_9541_PercMoradDPPOColetTot_munic_22_pol.fid-703dc0a5_191866d88cb_-e30,3200300,Alfredo Chaves - ES,10319,13292,2973,13810,74.72,96.25,21.53
sidra_9541_PercMoradDPPOColetTot_munic_22_pol.fid-703dc0a5_191866d88cb_-e2f,3200359,Alto Rio Novo - ES,4821,5153,332,7428,64.9,69.37,4.47
sidra_9541_PercMoradDPPOColetTot_munic_22_pol.fid-703dc0a5_191866d88cb_-e2e,2707602,Quebrangulo - AL,6563,7981,1418,11056,59.36,72.19,12.83
sidra_9541_PercMoradDPPOColetTot_munic_22_pol.fid-703dc0a5_191866d88cb_-e2d,3200409,Anchieta - ES,16684,29477,12793,29943,55.72,98.44,42.72
sidra_9541_PercMoradDPPOColetTot_munic_22_pol.fid-703dc0a5_191866d88cb_-e2c,3200508,Apiacá - ES,4436,5571,1135,7223,61.41,77.13,15.71
sidra_9541_PercMoradDPPOColetTot_munic_22_pol.fid-703dc0a5_191866d88cb_-e2b,3200607,Aracruz - ES,86520,89813,3293,94445,91.61,95.1,3.49
sidra_9541_PercMoradDPPOColetTot_munic_22_pol.fid-703dc0a5_191866d88cb_-e2a,3200706,Atílio Vivácqua - ES,7505,9946,2441,10522,71.33,94.53,23.2
sidra_9541_PercMoradDPPOColetTot_munic_22_pol.fid-703dc0a5_191866d88cb_-e29,3200805,Baixo Guandu - ES,26627,27170,543,30608,86.99,88.77,1.77
sidra_9541_PercMoradDPPOColetTot_munic_22_pol.fid-703dc0a5_191866d88cb_-e28,3200904,Barra de São Francisco - ES,18558,33239,14681,42227,43.95,78.72,34.77
sidra_9541_PercMoradDPPOColetTot_munic_22_pol.fid-703dc0a5_191866d88cb_-e27,3201001,Boa Esperança - ES,9793,10624,831,13568,72.18,78.3,6.12
sidra_9541_PercMoradDPPOColetTot_munic_22_pol.fid-703dc0a5_191866d88cb_-e26,3201100,Bom Jesus do Norte - ES,9269,9730,461,10208,90.8,95.32,4.52
sidra_9541_PercMoradDPPOColetTot_munic_22_pol.fid-703dc0a5_191866d88cb_-e24,3201159,Brejetuba - ES,5947,10232,4285,12977,45.83,78.85,33.02
sidra_9541_PercMoradDPPOColetTot_munic_22_pol.fid-703dc0a5_191866d88cb_-e23,3201209,Cachoeiro de Itapemirim - ES,168554,180627,12073,184464,91.38,97.92,6.54
sidra_9541_PercMoradDPPOColetTot_munic_22_pol.fid-703dc0a5_191866d88cb_-e22,3201308,Cariacica - ES,324240,345665,21425,351964,92.12,98.21,6.09
sidra_9541_PercMoradDPPOColetTot_munic_22_pol.fid-703dc0a5_191866d88cb_-e21,3201407,Castelo - ES,14693,30755,16062,36880,39.84,83.39,43.55
sidra_9541_PercMoradDPPOColetTot_munic_22_pol.fid-703dc0a5_191866d88cb_-e20,3201506,Colatina - ES,98814,111211,12397,118844,83.15,93.58,10.43
sidra_9541_PercMoradDPPOColetTot_munic_22_pol.fid-703dc0a5_191866d88cb_-e1f,3201605,Conceição da Barra - ES,23260,23724,464,27120,85.77,87.48,1.71
sidra_9541_PercMoradDPPOColetTot_munic_22_pol.fid-703dc0a5_191866d88cb_-e1e,3201704,Conceição do Castelo - ES,8155,10662,2507,11932,68.35,89.36,21.01
sidra_9541_PercMoradDPPOColetTot_munic_22_pol.fid-703dc0a5_191866d88cb_-e1c,3201803,Divino de São Lourenço - ES,950,3698,2748,5076,18.72,72.85,54.14
sidra_9541_PercMoradDPPOColetTot_munic_22_pol.fid-703dc0a5_191866d88cb_-e1b,3201902,Domingos Martins - ES,19271,27687,8416,35409,54.42,78.19,23.77
sidra_9541_PercMoradDPPOColetTot_munic_22_pol.fid-703dc0a5_191866d88cb_-e1a,2707800,Roteiro - AL,5835,6233,398,6468,90.21,96.37,6.15
sidra_9541_PercMoradDPPOColetTot_munic_22_pol.fid-703dc0a5_191866d88cb_-e19,3202009,Dores do Rio Preto - ES,1403,6196,4793,6590,21.29,94.02,72.73
sidra_9541_PercMoradDPPOColetTot_munic_22_pol.fid-703dc0a5_191866d88cb_-e18,3202108,Ecoporanga - ES,12572,15141,2569,21912,57.37,69.1,11.72
sidra_9541_PercMoradDPPOColetTot_munic_22_pol.fid-703dc0a5_191866d88cb_-e17,3202207,Fundão - ES,15157,16421,1264,17951,84.44,91.48,7.04
sidra_9541_PercMoradDPPOColetTot_munic_22_pol.fid-703dc0a5_191866d88cb_-e16,3202256,Governador Lindenberg - ES,5710,7217,1507,11009,51.87,65.56,13.69
sidra_9541_PercMoradDPPOColetTot_munic_22_pol.fid-703dc0a5_191866d88cb_-e15,3202306,Guaçuí - ES,4045,26321,22276,29264,13.82,89.94,76.12
sidra_9541_PercMoradDPPOColetTot_munic_22_pol.fid-703dc0a5_191866d88cb_-e14,3202405,Guarapari - ES,114179,120869,6690,123647,92.34,97.75,5.41
sidra_9541_PercMoradDPPOColetTot_munic_22_pol.fid-703dc0a5_191866d88cb_-e13,3202454,Ibatiba - ES,16654,21974,5320,25369,65.65,86.62,20.97
sidra_9541_PercMoradDPPOColetTot_munic_22_pol.fid-703dc0a5_191866d88cb_-e12,3202504,Ibiraçu - ES,10685,11013,328,11721,91.16,93.96,2.8
sidra_9541_PercMoradDPPOColetTot_munic_22_pol.fid-703dc0a5_191866d88cb_-e11,3202553,Ibitirama - ES,1780,7054,5274,9512,18.71,74.16,55.45
sidra_9541_PercMoradDPPOColetTot_munic_22_pol.fid-703dc0a5_191866d88cb_-e10,3202603,Iconha - ES,8521,11951,3430,12316,69.19,97.04,27.85
sidra_9541_PercMoradDPPOColetTot_munic_22_pol.fid-703dc0a5_191866d88cb_-e0f,3202652,Irupi - ES,664,8848,8184,13652,4.86,64.81,59.95
sidra_9541_PercMoradDPPOColetTot_munic_22_pol.fid-703dc0a5_191866d88cb_-e0e,3202702,Itaguaçu - ES,11113,11588,475,13581,81.83,85.33,3.5
sidra_9541_PercMoradDPPOColetTot_munic_22_pol.fid-703dc0a5_191866d88cb_-e0d,3202801,Itapemirim - ES,29020,38724,9704,39786,72.94,97.33,24.39
sidra_9541_PercMoradDPPOColetTot_munic_22_pol.fid-703dc0a5_191866d88cb_-e0c,3202900,Itarana - ES,8174,8748,574,10586,77.22,82.64,5.42
sidra_9541_PercMoradDPPOColetTot_munic_22_pol.fid-703dc0a5_191866d88cb_-e0b,3203007,Iúna - ES,16891,23118,6227,28562,59.14,80.94,21.8
sidra_9541_PercMoradDPPOColetTot_munic_22_pol.fid-703dc0a5_191866d88cb_-e0a,3203056,Jaguaré - ES,24307,25250,943,28913,84.07,87.33,3.26
sidra_9541_PercMoradDPPOColetTot_munic_22_pol.fid-703dc0a5_191866d88cb_-e08,3203106,Jerônimo Monteiro - ES,8457,10250,1793,11548,73.23,88.76,15.53
sidra_9541_PercMoradDPPOColetTot_munic_22_pol.fid-703dc0a5_191866d88cb_-e07,3203130,João Neiva - ES,13028,13116,88,14065,92.63,93.25,0.63
sidra_9541_PercMoradDPPOColetTot_munic_22_pol.fid-703dc0a5_191866d88cb_-e06,3203163,Laranja da Terra - ES,5045,7523,2478,11092,45.48,67.82,22.34
sidra_9541_PercMoradDPPOColetTot_munic_22_pol.fid-703dc0a5_191866d88cb_-e05,2707909,Santa Luzia do Norte - AL,5485,6687,1202,6918,79.29,96.66,17.37
sidra_9541_PercMoradDPPOColetTot_munic_22_pol.fid-703dc0a5_191866d88cb_-e04,3203205,Linhares - ES,143336,155044,11708,164859,86.94,94.05,7.1
sidra_9541_PercMoradDPPOColetTot_munic_22_pol.fid-703dc0a5_191866d88cb_-e03,2708204,São Brás - AL,5992,6396,404,6555,91.41,97.57,6.16
sidra_9541_PercMoradDPPOColetTot_munic_22_pol.fid-703dc0a5_191866d88cb_-e02,2708303,São José da Laje - AL,15757,16141,384,20805,75.74,77.58,1.85
sidra_9541_PercMoradDPPOColetTot_munic_22_pol.fid-703dc0a5_191866d88cb_-e01,2708402,São José da Tapera - AL,12421,17579,5158,30590,40.6,57.47,16.86
sidra_9541_PercMoradDPPOColetTot_munic_22_pol.fid-703dc0a5_191866d88cb_-e00,2708501,São Luís do Quitunde - AL,17285,21164,3879,30863,56.01,68.57,12.57
sidra_9541_PercMoradDPPOColetTot_munic_22_pol.fid-703dc0a5_191866d88cb_-dff,2708600,São Miguel dos Campos - AL,44400,50823,6423,51783,85.74,98.15,12.4
sidra_9541_PercMoradDPPOColetTot_munic_22_pol.fid-703dc0a5_191866d88cb_-dfe,3301207,Carmo - RJ,15790,16816,1026,17045,92.64,98.66,6.02
sidra_9541_PercMoradDPPOColetTot_munic_22_pol.fid-703dc0a5_191866d88cb_-dfd,3301306,Casimiro de Abreu - RJ,34182,45577,11395,46022,74.27,99.03,24.76
sidra_9541_PercMoradDPPOColetTot_munic_22_pol.fid-703dc0a5_191866d88cb_-dfc,3301405,Conceição de Macabu - RJ,17971,19905,1934,20992,85.61,94.82,9.21
sidra_9541_PercMoradDPPOColetTot_munic_22_pol.fid-703dc0a5_191866d88cb_-dfb,3301504,Cordeiro - RJ,17370,20568,3198,20736,83.77,99.19,15.42
sidra_9541_PercMoradDPPOColetTot_munic_22_pol.fid-703dc0a5_191866d88cb_-dfa,3301603,Duas Barras - RJ,6603,10623,4020,10959,60.25,96.93,36.68
sidra_9541_PercMoradDPPOColetTot_munic_22_pol.fid-703dc0a5_191866d88cb_-df9,3301702,Duque de Caxias - RJ,733091,782723,49632,807276,90.81,96.96,6.15
sidra_9541_PercMoradDPPOColetTot_munic_22_pol.fid-703dc0a5_191866d88cb_-df8,3301801,Engenheiro Paulo de Frontin - RJ,3376,12116,8740,12201,27.67,99.3,71.63
sidra_9541_PercMoradDPPOColetTot_munic_22_pol.fid-703dc0a5_191866d88cb_-df7,3301850,Guapimirim - RJ,47359,50047,2688,51540,91.89,97.1,5.22
sidra_9541_PercMoradDPPOColetTot_munic_22_pol.fid-703dc0a5_191866d88cb_-df6,2708709,São Miguel dos Milagres - AL,5942,7816,1874,8473,70.13,92.25,22.12
sidra_9541_PercMoradDPPOColetTot_munic_22_pol.fid-703dc0a5_191866d88cb_-df5,2708808,São Sebastião - AL,27765,28172,407,31647,87.73,89.02,1.29
sidra_9541_PercMoradDPPOColetTot_munic_22_pol.fid-703dc0a5_191866d88cb_-df4,2709152,Teotônio Vilela - AL,32924,36270,3346,37986,86.67,95.48,8.81
sidra_9541_PercMoradDPPOColetTot_munic_22_pol.fid-703dc0a5_191866d88cb_-df3,2709202,Traipu - AL,8718,10145,1427,23536,37.04,43.1,6.06
sidra_9541_PercMoradDPPOColetTot_munic_22_pol.fid-703dc0a5_191866d88cb_-df2,2709301,União dos Palmares - AL,49450,50555,1105,58528,84.49,86.38,1.89
sidra_9541_PercMoradDPPOColetTot_munic_22_pol.fid-703dc0a5_191866d88cb_-df1,3306107,Valença - RJ,54033,66142,12109,67926,79.55,97.37,17.83
sidra_9541_PercMoradDPPOColetTot_munic_22_pol.fid-703dc0a5_191866d88cb_-def,3306156,Varre-Sai - RJ,4581,8992,4411,10200,44.91,88.16,43.25
sidra_9541_PercMoradDPPOColetTot_munic_22_pol.fid-703dc0a5_191866d88cb_-dee,3306206,Vassouras - RJ,19555,33195,13640,33908,57.67,97.9,40.23
sidra_9541_PercMoradDPPOColetTot_munic_22_pol.fid-703dc0a5_191866d88cb_-ded,3306305,Volta Redonda - RJ,247961,260319,12358,261207,94.93,99.66,4.73
sidra_9541_PercMoradDPPOColetTot_munic_22_pol.fid-703dc0a5_191866d88cb_-dec,3500105,Adamantina - SP,33165,34053,888,34552,95.99,98.56,2.57
sidra_9541_PercMoradDPPOColetTot_munic_22_pol.fid-703dc0a5_191866d88cb_-deb,3500204,Adolfo - SP,4186,4269,83,4351,96.21,98.12,1.91
sidra_9541_PercMoradDPPOColetTot_munic_22_pol.fid-703dc0a5_191866d88cb_-dea,2708907,Satuba - AL,23473,24076,603,24278,96.68,99.17,2.48
sidra_9541_PercMoradDPPOColetTot_munic_22_pol.fid-703dc0a5_191866d88cb_-de9,2800704,Brejo Grande - SE,6866,6920,54,7824,87.76,88.45,0.69
sidra_9541_PercMoradDPPOColetTot_munic_22_pol.fid-703dc0a5_191866d88cb_-de8,2801009,Campo do Brito - SE,16331,16535,204,18137,90.04,91.17,1.12
sidra_9541_PercMoradDPPOColetTot_munic_22_pol.fid-703dc0a5_191866d88cb_-de7,3500303,Aguaí - SP,29194,30278,1084,32008,91.21,94.6,3.39
sidra_9541_PercMoradDPPOColetTot_munic_22_pol.fid-703dc0a5_191866d88cb_-de6,3500402,Águas da Prata - SP,6866,7151,285,7262,94.55,98.47,3.92
sidra_9541_PercMoradDPPOColetTot_munic_22_pol.fid-703dc0a5_191866d88cb_-de5,2708956,Senador Rui Palmeira - AL,4576,5065,489,12281,37.26,41.24,3.98
sidra_9541_PercMoradDPPOColetTot_munic_22_pol.fid-703dc0a5_191866d88cb_-de4,2709004,Tanque d'Arca - AL,3916,4093,177,5788,67.66,70.72,3.06
sidra_9541_PercMoradDPPOColetTot_munic_22_pol.fid-703dc0a5_191866d88cb_-de3,2709103,Taquarana - AL,11441,13745,2304,18968,60.32,72.46,12.15
sidra_9541_PercMoradDPPOColetTot_munic_22_pol.fid-703dc0a5_191866d88cb_-de2,2802304,Frei Paulo - SE,13271,13657,386,14515,91.43,94.09,2.66
sidra_9541_PercMoradDPPOColetTot_munic_22_pol.fid-703dc0a5_191866d88cb_-de1,2802403,Gararu - SE,6379,6716,337,11054,57.71,60.76,3.05
sidra_9541_PercMoradDPPOColetTot_munic_22_pol.fid-703dc0a5_191866d88cb_-de0,2709400,Viçosa - AL,19595,20453,858,23988,81.69,85.26,3.58
sidra_9541_PercMoradDPPOColetTot_munic_22_pol.fid-703dc0a5_191866d88cb_-ddf,2800100,Amparo do São Francisco - SE,1983,2143,160,2169,91.42,98.8,7.38
sidra_9541_PercMoradDPPOColetTot_munic_22_pol.fid-703dc0a5_191866d88cb_-dde,2800209,Aquidabã - SE,17607,18261,654,20089,87.64,90.9,3.26
sidra_9541_PercMoradDPPOColetTot_munic_22_pol.fid-703dc0a5_191866d88cb_-ddd,2800308,Aracaju - SE,574340,598980,24640,601372,95.5,99.6,4.1
sidra_9541_PercMoradDPPOColetTot_munic_22_pol.fid-703dc0a5_191866d88cb_-ddc,2800407,Arauá - SE,8256,8357,101,10307,80.1,81.08,0.98
sidra_9541_PercMoradDPPOColetTot_munic_22_pol.fid-703dc0a5_191866d88cb_-ddb,2800506,Areia Branca - SE,16042,16182,140,17294,92.76,93.57,0.81
sidra_9541_PercMoradDPPOColetTot_munic_22_pol.fid-703dc0a5_191866d88cb_-dda,2802502,General Maynard - SE,2955,2991,36,3036,97.33,98.52,1.19
sidra_9541_PercMoradDPPOColetTot_munic_22_pol.fid-703dc0a5_191866d88cb_-dd9,2802601,Gracho Cardoso - SE,4002,4029,27,5821,68.75,69.21,0.46
sidra_9541_PercMoradDPPOColetTot_munic_22_pol.fid-703dc0a5_191866d88cb_-dd8,2800605,Barra dos Coqueiros - SE,37635,41038,3403,41491,90.71,98.91,8.2
sidra_9541_PercMoradDPPOColetTot_munic_22_pol.fid-703dc0a5_191866d88cb_-dd7,2800670,Boquim - SE,22495,22776,281,24592,91.47,92.62,1.14
sidra_9541_PercMoradDPPOColetTot_munic_22_pol.fid-703dc0a5_191866d88cb_-dd6,2807204,Siriri - SE,7107,7141,34,7827,90.8,91.24,0.43
sidra_9541_PercMoradDPPOColetTot_munic_22_pol.fid-703dc0a5_191866d88cb_-dd5,2801108,Canhoba - SE,3039,3247,208,3785,80.29,85.79,5.5
sidra_9541_PercMoradDPPOColetTot_munic_22_pol.fid-703dc0a5_191866d88cb_-dd4,2801207,Canindé de São Francisco - SE,20047,20877,830,26770,74.89,77.99,3.1
sidra_9541_PercMoradDPPOColetTot_munic_22_pol.fid-703dc0a5_191866d88cb_-dd3,2801306,Capela - SE,25700,26773,1073,31581,81.38,84.78,3.4
sidra_9541_PercMoradDPPOColetTot_munic_22_pol.fid-703dc0a5_191866d88cb_-dd2,2801405,Carira - SE,16111,16262,151,19883,81.03,81.79,0.76
sidra_9541_PercMoradDPPOColetTot_munic_22_pol.fid-703dc0a5_191866d88cb_-dd1,2807303,Telha - SE,3110,3218,108,3274,94.99,98.29,3.3
sidra_9541_PercMoradDPPOColetTot_munic_22_pol.fid-703dc0a5_191866d88cb_-dd0,2807402,Tobias Barreto - SE,41705,45972,4267,50267,82.97,91.46,8.49
sidra_9541_PercMoradDPPOColetTot_munic_22_pol.fid-703dc0a5_191866d88cb_-dce,2807501,Tomar do Geru - SE,5626,7650,2024,11976,46.98,63.88,16.9
sidra_9541_PercMoradDPPOColetTot_munic_22_pol.fid-703dc0a5_191866d88cb_-dcd,2801504,Carmópolis - SE,12612,13410,798,13840,91.13,96.89,5.77
sidra_9541_PercMoradDPPOColetTot_munic_22_pol.fid-703dc0a5_191866d88cb_-dcc,2801603,Cedro de São João - SE,5056,5307,251,5391,93.79,98.44,4.66
sidra_9541_PercMoradDPPOColetTot_munic_22_pol.fid-703dc0a5_191866d88cb_-dcb,2801702,Cristinápolis - SE,14033,14171,138,17032,82.39,83.2,0.81
sidra_9541_PercMoradDPPOColetTot_munic_22_pol.fid-703dc0a5_191866d88cb_-dca,2801900,Cumbe - SE,3278,3411,133,3818,85.86,89.34,3.48
sidra_9541_PercMoradDPPOColetTot_munic_22_pol.fid-703dc0a5_191866d88cb_-dc9,2802007,Divina Pastora - SE,4157,4200,43,4340,95.78,96.77,0.99
sidra_9541_PercMoradDPPOColetTot_munic_22_pol.fid-703dc0a5_191866d88cb_-dc8,2802106,Estância - SE,53499,57505,4006,64885,82.45,88.63,6.17
sidra_9541_PercMoradDPPOColetTot_munic_22_pol.fid-703dc0a5_191866d88cb_-dc7,2802205,Feira Nova - SE,5166,5199,33,5969,86.55,87.1,0.55
sidra_9541_PercMoradDPPOColetTot_munic_22_pol.fid-703dc0a5_191866d88cb_-dc6,2901106,Amélia Rodrigues - BA,22666,23117,451,24100,94.05,95.92,1.87
sidra_9541_PercMoradDPPOColetTot_munic_22_pol.fid-703dc0a5_191866d88cb_-dc5,2802700,Ilha das Flores - SE,7471,7974,503,8314,89.86,95.91,6.05
sidra_9541_PercMoradDPPOColetTot_munic_22_pol.fid-703dc0a5_191866d88cb_-dc4,2802809,Indiaroba - SE,11944,12074,130,16527,72.27,73.06,0.79
sidra_9541_PercMoradDPPOColetTot_munic_22_pol.fid-703dc0a5_191866d88cb_-dc3,2802908,Itabaiana - SE,96334,97501,1167,103202,93.35,94.48,1.13
sidra_9541_PercMoradDPPOColetTot_munic_22_pol.fid-703dc0a5_191866d88cb_-dc2,2803005,Itabaianinha - SE,31703,33605,1902,40625,78.04,82.72,4.68
sidra_9541_PercMoradDPPOColetTot_munic_22_pol.fid-703dc0a5_191866d88cb_-dc0,2803104,Itabi - SE,3911,3977,66,4727,82.74,84.13,1.4
sidra_9541_PercMoradDPPOColetTot_munic_22_pol.fid-703dc0a5_191866d88cb_-dbf,2803203,Itaporanga d'Ajuda - SE,24177,27380,3203,34351,70.38,79.71,9.32
sidra_9541_PercMoradDPPOColetTot_munic_22_pol.fid-703dc0a5_191866d88cb_-dbe,2803302,Japaratuba - SE,13155,14245,1090,16198,81.21,87.94,6.73
sidra_9541_PercMoradDPPOColetTot_munic_22_pol.fid-703dc0a5_191866d88cb_-dbd,2803401,Japoatã - SE,10426,10496,70,13397,77.82,78.35,0.52
sidra_9541_PercMoradDPPOColetTot_munic_22_pol.fid-703dc0a5_191866d88cb_-dbc,2803500,Lagarto - SE,88696,92301,3605,101428,87.45,91,3.55
sidra_9541_PercMoradDPPOColetTot_munic_22_pol.fid-703dc0a5_191866d88cb_-dbb,2803609,Laranjeiras - SE,22501,23760,1259,23972,93.86,99.12,5.25
sidra_9541_PercMoradDPPOColetTot_munic_22_pol.fid-703dc0a5_191866d88cb_-dba,2803708,Macambira - SE,6082,6163,81,6778,89.73,90.93,1.2
sidra_9541_PercMoradDPPOColetTot_munic_22_pol.fid-703dc0a5_191866d88cb_-db9,2803807,Malhada dos Bois - SE,3463,3474,11,3573,96.92,97.23,0.31
sidra_9541_PercMoradDPPOColetTot_munic_22_pol.fid-703dc0a5_191866d88cb_-db8,2803906,Malhador - SE,10735,10922,187,11523,93.16,94.78,1.62
sidra_9541_PercMoradDPPOColetTot_munic_22_pol.fid-703dc0a5_191866d88cb_-db7,2901155,América Dourada - BA,12142,13388,1246,15088,80.47,88.73,8.26
sidra_9541_PercMoradDPPOColetTot_munic_22_pol.fid-703dc0a5_191866d88cb_-db6,2901205,Anagé - BA,7599,8099,500,25419,29.89,31.86,1.97
sidra_9541_PercMoradDPPOColetTot_munic_22_pol.fid-703dc0a5_191866d88cb_-db5,2901304,Andaraí - BA,9769,10268,499,13040,74.92,78.74,3.83
sidra_9541_PercMoradDPPOColetTot_munic_22_pol.fid-703dc0a5_191866d88cb_-db4,2901353,Andorinha - BA,7691,8493,802,14994,51.29,56.64,5.35
sidra_9541_PercMoradDPPOColetTot_munic_22_pol.fid-703dc0a5_191866d88cb_-db2,2901403,Angical - BA,6264,7830,1566,13711,45.69,57.11,11.42
sidra_9541_PercMoradDPPOColetTot_munic_22_pol.fid-703dc0a5_191866d88cb_-db1,3500600,Águas de São Pedro - SP,2774,2779,5,2779,99.82,100,0.18
sidra_9541_PercMoradDPPOColetTot_munic_22_pol.fid-703dc0a5_191866d88cb_-db0,3500709,Agudos - SP,36127,36628,501,37410,96.57,97.91,1.34
sidra_9541_PercMoradDPPOColetTot_munic_22_pol.fid-703dc0a5_191866d88cb_-daf,3500758,Alambari - SP,5690,5945,255,6131,92.81,96.97,4.16
sidra_9541_PercMoradDPPOColetTot_munic_22_pol.fid-703dc0a5_191866d88cb_-dae,3500808,Alfredo Marcondes - SP,3941,4172,231,4432,88.92,94.13,5.21
sidra_9541_PercMoradDPPOColetTot_munic_22_pol.fid-703dc0a5_191866d88cb_-dad,3500907,Altair - SP,3107,3126,19,3439,90.35,90.9,0.55
sidra_9541_PercMoradDPPOColetTot_munic_22_pol.fid-703dc0a5_191866d88cb_-dac,2804003,Maruim - SE,14920,15219,299,15717,94.93,96.83,1.9
sidra_9541_PercMoradDPPOColetTot_munic_22_pol.fid-703dc0a5_191866d88cb_-dab,2804102,Moita Bonita - SE,10200,10264,64,11046,92.34,92.92,0.58
sidra_9541_PercMoradDPPOColetTot_munic_22_pol.fid-703dc0a5_191866d88cb_-daa,2804201,Monte Alegre de Sergipe - SE,9368,10183,815,14304,65.49,71.19,5.7
sidra_9541_PercMoradDPPOColetTot_munic_22_pol.fid-703dc0a5_191866d88cb_-da9,2804300,Muribeca - SE,7062,7302,240,7816,90.35,93.42,3.07
sidra_9541_PercMoradDPPOColetTot_munic_22_pol.fid-703dc0a5_191866d88cb_-da8,2804409,Neópolis - SE,14237,14850,613,16416,86.73,90.46,3.73
sidra_9541_PercMoradDPPOColetTot_munic_22_pol.fid-703dc0a5_191866d88cb_-da7,2804458,Nossa Senhora Aparecida - SE,6462,6540,78,9218,70.1,70.95,0.85
sidra_9541_PercMoradDPPOColetTot_munic_22_pol.fid-703dc0a5_191866d88cb_-da6,2804508,Nossa Senhora da Glória - SE,33445,33690,245,40769,82.04,82.64,0.6
sidra_9541_PercMoradDPPOColetTot_munic_22_pol.fid-703dc0a5_191866d88cb_-da5,2804607,Nossa Senhora das Dores - SE,21903,23574,1671,24952,87.78,94.48,6.7
sidra_9541_PercMoradDPPOColetTot_munic_22_pol.fid-703dc0a5_191866d88cb_-da4,2902203,Aramari - BA,4140,6453,2313,9808,42.21,65.79,23.58
sidra_9541_PercMoradDPPOColetTot_munic_22_pol.fid-703dc0a5_191866d88cb_-da3,2902252,Arataca - BA,6653,7412,759,10174,65.39,72.85,7.46
sidra_9541_PercMoradDPPOColetTot_munic_22_pol.fid-703dc0a5_191866d88cb_-da2,2902302,Aratuípe - BA,4850,5428,578,8665,55.97,62.64,6.67
sidra_9541_PercMoradDPPOColetTot_munic_22_pol.fid-703dc0a5_191866d88cb_-da1,2902401,Aurelino Leal - BA,9198,9395,197,11170,82.35,84.11,1.76
sidra_9541_PercMoradDPPOColetTot_munic_22_pol.fid-703dc0a5_191866d88cb_-da0,2902500,Baianópolis - BA,4593,4628,35,13597,33.78,34.04,0.26
sidra_9541_PercMoradDPPOColetTot_munic_22_pol.fid-703dc0a5_191866d88cb_-d9f,2902609,Baixa Grande - BA,10680,12265,1585,18164,58.8,67.52,8.73
sidra_9541_PercMoradDPPOColetTot_munic_22_pol.fid-703dc0a5_191866d88cb_-d9e,2902658,Banzaê - BA,9586,9949,363,11933,80.33,83.37,3.04
sidra_9541_PercMoradDPPOColetTot_munic_22_pol.fid-703dc0a5_191866d88cb_-d9d,2902708,Barra - BA,30034,30676,642,50967,58.93,60.19,1.26
sidra_9541_PercMoradDPPOColetTot_munic_22_pol.fid-703dc0a5_191866d88cb_-d9c,2902807,Barra da Estiva - BA,14616,16237,1621,25948,56.33,62.58,6.25
sidra_9541_PercMoradDPPOColetTot_munic_22_pol.fid-703dc0a5_191866d88cb_-d9b,2902906,Barra do Choça - BA,30592,31900,1308,36493,83.83,87.41,3.58
sidra_9541_PercMoradDPPOColetTot_munic_22_pol.fid-703dc0a5_191866d88cb_-d9a,2903003,Barra do Mendes - BA,8337,8645,308,13824,60.31,62.54,2.23
sidra_9541_PercMoradDPPOColetTot_munic_22_pol.fid-703dc0a5_191866d88cb_-d98,2903102,Barra do Rocha - BA,4264,4305,41,5772,73.87,74.58,0.71
sidra_9541_PercMoradDPPOColetTot_munic_22_pol.fid-703dc0a5_191866d88cb_-d97,2903201,Barreiras - BA,128745,150451,21706,159181,80.88,94.52,13.64
sidra_9541_PercMoradDPPOColetTot_munic_22_pol.fid-703dc0a5_191866d88cb_-d96,2903235,Barro Alto - BA,8437,8499,62,13447,62.74,63.2,0.46
sidra_9541_PercMoradDPPOColetTot_munic_22_pol.fid-703dc0a5_191866d88cb_-d95,2903276,Barrocas - BA,13912,14345,433,15200,91.53,94.38,2.85
sidra_9541_PercMoradDPPOColetTot_munic_22_pol.fid-703dc0a5_191866d88cb_-d94,2903300,Barro Preto - BA,4534,4676,142,5833,77.73,80.16,2.43
sidra_9541_PercMoradDPPOColetTot_munic_22_pol.fid-703dc0a5_191866d88cb_-d93,2903409,Belmonte - BA,16061,16503,442,20054,80.09,82.29,2.2
sidra_9541_PercMoradDPPOColetTot_munic_22_pol.fid-703dc0a5_191866d88cb_-d92,2903508,Belo Campo - BA,10155,10330,175,18381,55.25,56.2,0.95
sidra_9541_PercMoradDPPOColetTot_munic_22_pol.fid-703dc0a5_191866d88cb_-d91,2903607,Biritinga - BA,5434,6748,1314,15128,35.92,44.61,8.69
sidra_9541_PercMoradDPPOColetTot_munic_22_pol.fid-703dc0a5_191866d88cb_-d90,2903706,Boa Nova - BA,8004,8422,418,13670,58.55,61.61,3.06
sidra_9541_PercMoradDPPOColetTot_munic_22_pol.fid-703dc0a5_191866d88cb_-d8f,2903805,Boa Vista do Tupim - BA,11032,11081,49,16834,65.53,65.83,0.29
sidra_9541_PercMoradDPPOColetTot_munic_22_pol.fid-703dc0a5_191866d88cb_-d8e,2903904,Bom Jesus da Lapa - BA,47170,48013,843,65248,72.29,73.59,1.29
sidra_9541_PercMoradDPPOColetTot_munic_22_pol.fid-703dc0a5_191866d88cb_-d8d,2804706,Nossa Senhora de Lourdes - SE,4366,5849,1483,6248,69.88,93.61,23.74
sidra_9541_PercMoradDPPOColetTot_munic_22_pol.fid-703dc0a5_191866d88cb_-d8c,2804805,Nossa Senhora do Socorro - SE,171532,186700,15168,191979,89.35,97.25,7.9
sidra_9541_PercMoradDPPOColetTot_munic_22_pol.fid-703dc0a5_191866d88cb_-d8b,2804904,Pacatuba - SE,5640,6363,723,12490,45.16,50.94,5.79
sidra_9541_PercMoradDPPOColetTot_munic_22_pol.fid-703dc0a5_191866d88cb_-d8a,2805000,Pedra Mole - SE,2522,2535,13,2778,90.78,91.25,0.47
sidra_9541_PercMoradDPPOColetTot_munic_22_pol.fid-703dc0a5_191866d88cb_-d89,2805109,Pedrinhas - SE,7111,7146,35,7384,96.3,96.78,0.47
sidra_9541_PercMoradDPPOColetTot_munic_22_pol.fid-703dc0a5_191866d88cb_-d88,2805208,Pinhão - SE,3517,4013,496,5663,62.1,70.86,8.76
sidra_9541_PercMoradDPPOColetTot_munic_22_pol.fid-703dc0a5_191866d88cb_-d87,2805307,Pirambu - SE,6827,6853,26,7882,86.62,86.94,0.33
sidra_9541_PercMoradDPPOColetTot_munic_22_pol.fid-703dc0a5_191866d88cb_-d86,2805406,Poço Redondo - SE,16192,18165,1973,33383,48.5,54.41,5.91
sidra_9541_PercMoradDPPOColetTot_munic_22_pol.fid-703dc0a5_191866d88cb_-d85,2805505,Poço Verde - SE,16955,18019,1064,21754,77.94,82.83,4.89
sidra_9541_PercMoradDPPOColetTot_munic_22_pol.fid-703dc0a5_191866d88cb_-d84,2805604,Porto da Folha - SE,17548,19980,2432,26521,66.17,75.34,9.17
sidra_9541_PercMoradDPPOColetTot_munic_22_pol.fid-703dc0a5_191866d88cb_-d83,2805703,Propriá - SE,25602,26027,425,26548,96.44,98.04,1.6
sidra_9541_PercMoradDPPOColetTot_munic_22_pol.fid-703dc0a5_191866d88cb_-d82,2805802,Riachão do Dantas - SE,13263,14093,830,18304,72.46,76.99,4.53
sidra_9541_PercMoradDPPOColetTot_munic_22_pol.fid-703dc0a5_191866d88cb_-d81,2805901,Riachuelo - SE,8415,8444,29,8732,96.37,96.7,0.33
sidra_9541_PercMoradDPPOColetTot_munic_22_pol.fid-703dc0a5_191866d88cb_-d80,2806008,Ribeirópolis - SE,15562,15662,100,16968,91.71,92.3,0.59
sidra_9541_PercMoradDPPOColetTot_munic_22_pol.fid-703dc0a5_191866d88cb_-d7f,2903953,Bom Jesus da Serra - BA,3635,3748,113,9729,37.36,38.52,1.16
sidra_9541_PercMoradDPPOColetTot_munic_22_pol.fid-703dc0a5_191866d88cb_-d7e,2904001,Boninal - BA,6896,7078,182,13540,50.93,52.27,1.34
sidra_9541_PercMoradDPPOColetTot_munic_22_pol.fid-703dc0a5_191866d88cb_-d7d,2904050,Bonito - BA,13494,14013,519,15800,85.41,88.69,3.28
sidra_9541_PercMoradDPPOColetTot_munic_22_pol.fid-703dc0a5_191866d88cb_-d7c,2904100,Boquira - BA,7102,8731,1629,19315,36.77,45.2,8.43
sidra_9541_PercMoradDPPOColetTot_munic_22_pol.fid-703dc0a5_191866d88cb_-d7b,3501004,Altinópolis - SP,15591,16036,445,16775,92.94,95.59,2.65
sidra_9541_PercMoradDPPOColetTot_munic_22_pol.fid-703dc0a5_191866d88cb_-d36,3501103,Alto Alegre - SP,3182,3555,373,3841,82.84,92.55,9.71
sidra_9541_PercMoradDPPOColetTot_munic_22_pol.fid-703dc0a5_191866d88cb_-d35,3501152,Alumínio - SP,14853,17263,2410,17276,85.97,99.92,13.95
sidra_9541_PercMoradDPPOColetTot_munic_22_pol.fid-703dc0a5_191866d88cb_-d34,3501202,Álvares Florence - SP,2707,3179,472,3901,69.39,81.49,12.1
sidra_9541_PercMoradDPPOColetTot_munic_22_pol.fid-703dc0a5_191866d88cb_-d33,3501301,Álvares Machado - SP,24788,26067,1279,27208,91.11,95.81,4.7
sidra_9541_PercMoradDPPOColetTot_munic_22_pol.fid-703dc0a5_191866d88cb_-d32,3501400,Álvaro de Carvalho - SP,3011,3029,18,3151,95.56,96.13,0.57
sidra_9541_PercMoradDPPOColetTot_munic_22_pol.fid-703dc0a5_191866d88cb_-d31,2806107,Rosário do Catete - SE,8854,8984,130,9275,95.46,96.86,1.4
sidra_9541_PercMoradDPPOColetTot_munic_22_pol.fid-703dc0a5_191866d88cb_-d30,2806206,Salgado - SE,14575,14956,381,20267,71.91,73.79,1.88
sidra_9541_PercMoradDPPOColetTot_munic_22_pol.fid-703dc0a5_191866d88cb_-d2f,2806305,Santa Luzia do Itanhy - SE,11281,11454,173,13602,82.94,84.21,1.27
sidra_9541_PercMoradDPPOColetTot_munic_22_pol.fid-703dc0a5_191866d88cb_-d2e,2806404,Santana do São Francisco - SE,5641,7138,1497,7342,76.83,97.22,20.39
sidra_9541_PercMoradDPPOColetTot_munic_22_pol.fid-703dc0a5_191866d88cb_-d2d,2806503,Santa Rosa de Lima - SE,3612,3832,220,3916,92.24,97.85,5.62
sidra_9541_PercMoradDPPOColetTot_munic_22_pol.fid-703dc0a5_191866d88cb_-d2c,2806602,Santo Amaro das Brotas - SE,9014,9563,549,11045,81.61,86.58,4.97
sidra_9541_PercMoradDPPOColetTot_munic_22_pol.fid-703dc0a5_191866d88cb_-d2b,2806701,São Cristóvão - SE,82092,86505,4413,93353,87.94,92.66,4.73
sidra_9541_PercMoradDPPOColetTot_munic_22_pol.fid-703dc0a5_191866d88cb_-d2a,2806800,São Domingos - SE,9399,9601,202,10316,91.11,93.07,1.96
sidra_9541_PercMoradDPPOColetTot_munic_22_pol.fid-703dc0a5_191866d88cb_-d29,2806909,São Francisco - SE,3031,3127,96,3243,93.46,96.42,2.96
sidra_9541_PercMoradDPPOColetTot_munic_22_pol.fid-703dc0a5_191866d88cb_-d28,2807006,São Miguel do Aleixo - SE,3093,3128,35,3426,90.28,91.3,1.02
sidra_9541_PercMoradDPPOColetTot_munic_22_pol.fid-703dc0a5_191866d88cb_-d27,2807105,Simão Dias - SE,35141,36138,997,42480,82.72,85.07,2.35
sidra_9541_PercMoradDPPOColetTot_munic_22_pol.fid-703dc0a5_191866d88cb_-d26,2807600,Umbaúba - SE,22632,22728,96,23906,94.67,95.07,0.4
sidra_9541_PercMoradDPPOColetTot_munic_22_pol.fid-703dc0a5_191866d88cb_-d25,2900108,Abaíra - BA,3123,4766,1643,7281,42.89,65.46,22.57
sidra_9541_PercMoradDPPOColetTot_munic_22_pol.fid-703dc0a5_191866d88cb_-d24,2900207,Abaré - BA,9272,12501,3229,17630,52.59,70.91,18.32
sidra_9541_PercMoradDPPOColetTot_munic_22_pol.fid-703dc0a5_191866d88cb_-d23,2900306,Acajutiba - BA,11389,11441,52,13751,82.82,83.2,0.38
sidra_9541_PercMoradDPPOColetTot_munic_22_pol.fid-703dc0a5_191866d88cb_-d22,2900355,Adustina - BA,10144,10955,811,14177,71.55,77.27,5.72
sidra_9541_PercMoradDPPOColetTot_munic_22_pol.fid-703dc0a5_191866d88cb_-d21,2900405,Água Fria - BA,7323,9305,1982,14471,50.6,64.3,13.7
sidra_9541_PercMoradDPPOColetTot_munic_22_pol.fid-703dc0a5_191866d88cb_-d20,2900504,Érico Cardoso - BA,4886,5814,928,10600,46.09,54.85,8.75
sidra_9541_PercMoradDPPOColetTot_munic_22_pol.fid-703dc0a5_191866d88cb_-d1f,2900603,Aiquara - BA,3506,3547,41,4433,79.09,80.01,0.92
sidra_9541_PercMoradDPPOColetTot_munic_22_pol.fid-703dc0a5_191866d88cb_-d1e,2900702,Alagoinhas - BA,126336,139856,13520,150814,83.77,92.73,8.96
sidra_9541_PercMoradDPPOColetTot_munic_22_pol.fid-703dc0a5_191866d88cb_-d1c,2900801,Alcobaça - BA,13720,14887,1167,24296,56.47,61.27,4.8
sidra_9541_PercMoradDPPOColetTot_munic_22_pol.fid-703dc0a5_191866d88cb_-d1b,2900900,Almadina - BA,4409,4482,73,5210,84.63,86.03,1.4
sidra_9541_PercMoradDPPOColetTot_munic_22_pol.fid-703dc0a5_191866d88cb_-d1a,2901007,Amargosa - BA,28526,29768,1242,36432,78.3,81.71,3.41
sidra_9541_PercMoradDPPOColetTot_munic_22_pol.fid-703dc0a5_191866d88cb_-d19,2901502,Anguera - BA,6573,7790,1217,11028,59.6,70.64,11.04
sidra_9541_PercMoradDPPOColetTot_munic_22_pol.fid-703dc0a5_191866d88cb_-d18,2901601,Antas - BA,10851,11726,875,14195,76.44,82.61,6.16
sidra_9541_PercMoradDPPOColetTot_munic_22_pol.fid-703dc0a5_191866d88cb_-d17,2901700,Antônio Cardoso - BA,4303,5783,1480,11144,38.61,51.89,13.28
sidra_9541_PercMoradDPPOColetTot_munic_22_pol.fid-703dc0a5_191866d88cb_-d16,2901809,Antônio Gonçalves - BA,8295,8430,135,10862,76.37,77.61,1.24
sidra_9541_PercMoradDPPOColetTot_munic_22_pol.fid-703dc0a5_191866d88cb_-d15,2901908,Aporá - BA,12867,13315,448,15860,81.13,83.95,2.82
sidra_9541_PercMoradDPPOColetTot_munic_22_pol.fid-703dc0a5_191866d88cb_-d13,2901957,Apuarema - BA,5276,5369,93,6880,76.69,78.04,1.35
sidra_9541_PercMoradDPPOColetTot_munic_22_pol.fid-703dc0a5_191866d88cb_-d12,2902005,Aracatu - BA,4221,4584,363,13935,30.29,32.9,2.6
sidra_9541_PercMoradDPPOColetTot_munic_22_pol.fid-703dc0a5_191866d88cb_-d11,2902054,Araçás - BA,8791,9278,487,11550,76.11,80.33,4.22
sidra_9541_PercMoradDPPOColetTot_munic_22_pol.fid-703dc0a5_191866d88cb_-d10,2902104,Araci - BA,24625,32020,7395,48235,51.05,66.38,15.33
sidra_9541_PercMoradDPPOColetTot_munic_22_pol.fid-703dc0a5_191866d88cb_-d0f,2905305,Cafarnaum - BA,11530,13438,1908,17460,66.04,76.96,10.93
sidra_9541_PercMoradDPPOColetTot_munic_22_pol.fid-703dc0a5_191866d88cb_-d0e,2905404,Cairu - BA,11194,17081,5887,17724,63.16,96.37,33.21
sidra_9541_PercMoradDPPOColetTot_munic_22_pol.fid-703dc0a5_191866d88cb_-d0d,2905503,Caldeirão Grande - BA,6559,8983,2424,13073,50.17,68.71,18.54
sidra_9541_PercMoradDPPOColetTot_munic_22_pol.fid-703dc0a5_191866d88cb_-d0c,2905602,Camacan - BA,17868,20252,2384,22519,79.35,89.93,10.59
sidra_9541_PercMoradDPPOColetTot_munic_22_pol.fid-703dc0a5_191866d88cb_-d0b,2905701,Camaçari - BA,222045,287764,65719,299874,74.05,95.96,21.92
sidra_9541_PercMoradDPPOColetTot_munic_22_pol.fid-703dc0a5_191866d88cb_-d0a,2905800,Camamu - BA,16988,22133,5145,30444,55.8,72.7,16.9
sidra_9541_PercMoradDPPOColetTot_munic_22_pol.fid-703dc0a5_191866d88cb_-d09,2905909,Campo Alegre de Lourdes - BA,6913,7834,921,30624,22.57,25.58,3.01
sidra_9541_PercMoradDPPOColetTot_munic_22_pol.fid-703dc0a5_191866d88cb_-d08,2906006,Campo Formoso - BA,48306,51543,3237,71265,67.78,72.33,4.54
sidra_9541_PercMoradDPPOColetTot_munic_22_pol.fid-703dc0a5_191866d88cb_-d07,2906105,Canápolis - BA,4999,5093,94,10209,48.97,49.89,0.92
sidra_9541_PercMoradDPPOColetTot_munic_22_pol.fid-703dc0a5_191866d88cb_-d05,2906204,Canarana - BA,16633,17891,1258,24122,68.95,74.17,5.22
sidra_9541_PercMoradDPPOColetTot_munic_22_pol.fid-703dc0a5_191866d88cb_-d04,2906303,Canavieiras - BA,25072,26190,1118,32335,77.54,81,3.46
sidra_9541_PercMoradDPPOColetTot_munic_22_pol.fid-703dc0a5_191866d88cb_-d03,2906402,Candeal - BA,4423,4990,567,7771,56.92,64.21,7.3
sidra_9541_PercMoradDPPOColetTot_munic_22_pol.fid-703dc0a5_191866d88cb_-d02,2906501,Candeias - BA,50893,67831,16938,72319,70.37,93.79,23.42
sidra_9541_PercMoradDPPOColetTot_munic_22_pol.fid-703dc0a5_191866d88cb_-d01,2906600,Candiba - BA,7776,7814,38,13009,59.77,60.07,0.29
sidra_9541_PercMoradDPPOColetTot_munic_22_pol.fid-703dc0a5_191866d88cb_-d00,2906709,Cândido Sales - BA,17053,19614,2561,25226,67.6,77.75,10.15
sidra_9541_PercMoradDPPOColetTot_munic_22_pol.fid-703dc0a5_191866d88cb_-cff,2906808,Cansanção - BA,14036,21662,7626,37402,37.53,57.92,20.39
sidra_9541_PercMoradDPPOColetTot_munic_22_pol.fid-703dc0a5_191866d88cb_-cfe,2906824,Canudos - BA,11017,11106,89,16077,68.53,69.08,0.55
sidra_9541_PercMoradDPPOColetTot_munic_22_pol.fid-703dc0a5_191866d88cb_-cfc,2906857,Capela do Alto Alegre - BA,7920,8765,845,10740,73.74,81.61,7.87
sidra_9541_PercMoradDPPOColetTot_munic_22_pol.fid-703dc0a5_191866d88cb_-cfb,2907608,Central - BA,13443,13543,100,16317,82.39,83,0.61
sidra_9541_PercMoradDPPOColetTot_munic_22_pol.fid-703dc0a5_191866d88cb_-cfa,2907707,Chorrochó - BA,5296,5467,171,10576,50.08,51.69,1.62
sidra_9541_PercMoradDPPOColetTot_munic_22_pol.fid-703dc0a5_191866d88cb_-cf9,2907806,Cícero Dantas - BA,21379,24949,3570,30866,69.26,80.83,11.57
sidra_9541_PercMoradDPPOColetTot_munic_22_pol.fid-703dc0a5_191866d88cb_-cf8,2907905,Cipó - BA,13144,13307,163,17221,76.33,77.27,0.95
sidra_9541_PercMoradDPPOColetTot_munic_22_pol.fid-703dc0a5_191866d88cb_-cf7,2908002,Coaraci - BA,12964,16137,3173,17328,74.82,93.13,18.31
sidra_9541_PercMoradDPPOColetTot_munic_22_pol.fid-703dc0a5_191866d88cb_-cf6,2908101,Cocos - BA,9935,10732,797,19132,51.93,56.09,4.17
sidra_9541_PercMoradDPPOColetTot_munic_22_pol.fid-703dc0a5_191866d88cb_-cf4,2908200,Conceição da Feira - BA,16977,18258,1281,20767,81.75,87.92,6.17
sidra_9541_PercMoradDPPOColetTot_munic_22_pol.fid-703dc0a5_191866d88cb_-cf3,2908309,Conceição do Almeida - BA,9005,11198,2193,15734,57.23,71.17,13.94
sidra_9541_PercMoradDPPOColetTot_munic_22_pol.fid-703dc0a5_191866d88cb_-cf2,2908408,Conceição do Coité - BA,53719,59546,5827,67809,79.22,87.81,8.59
sidra_9541_PercMoradDPPOColetTot_munic_22_pol.fid-703dc0a5_191866d88cb_-cf1,2908507,Conceição do Jacuípe - BA,33626,33981,355,35285,95.3,96.3,1.01
sidra_9541_PercMoradDPPOColetTot_munic_22_pol.fid-703dc0a5_191866d88cb_-cf0,2910909,Firmino Alves - BA,1266,4525,3259,4868,26.01,92.95,66.95
sidra_9541_PercMoradDPPOColetTot_munic_22_pol.fid-703dc0a5_191866d88cb_-cef,2911006,Floresta Azul - BA,7996,8323,327,11058,72.31,75.27,2.96
sidra_9541_PercMoradDPPOColetTot_munic_22_pol.fid-703dc0a5_191866d88cb_-cee,2911105,Formosa do Rio Preto - BA,18117,19944,1827,25805,70.21,77.29,7.08
sidra_9541_PercMoradDPPOColetTot_munic_22_pol.fid-703dc0a5_191866d88cb_-ced,2911204,Gandu - BA,27214,27646,432,32108,84.76,86.1,1.35
sidra_9541_PercMoradDPPOColetTot_munic_22_pol.fid-703dc0a5_191866d88cb_-cec,2911253,Gavião - BA,3018,3039,21,4360,69.22,69.7,0.48
sidra_9541_PercMoradDPPOColetTot_munic_22_pol.fid-703dc0a5_191866d88cb_-ceb,2911303,Gentio do Ouro - BA,6146,6215,69,10883,56.47,57.11,0.63
sidra_9541_PercMoradDPPOColetTot_munic_22_pol.fid-703dc0a5_191866d88cb_-cea,2911402,Glória - BA,12905,12933,28,15475,83.39,83.57,0.18
sidra_9541_PercMoradDPPOColetTot_munic_22_pol.fid-703dc0a5_191866d88cb_-ce9,2911501,Gongogi - BA,3328,4779,1451,5550,59.96,86.11,26.14
sidra_9541_PercMoradDPPOColetTot_munic_22_pol.fid-703dc0a5_191866d88cb_-ce8,2911600,Governador Mangabeira - BA,11569,12960,1391,20458,56.55,63.35,6.8
sidra_9541_PercMoradDPPOColetTot_munic_22_pol.fid-703dc0a5_191866d88cb_-ce7,2911659,Guajeru - BA,2413,2437,24,8049,29.98,30.28,0.3
sidra_9541_PercMoradDPPOColetTot_munic_22_pol.fid-703dc0a5_191866d88cb_-ce6,2911709,Guanambi - BA,71967,73418,1451,87691,82.07,83.72,1.65
sidra_9541_PercMoradDPPOColetTot_munic_22_pol.fid-703dc0a5_191866d88cb_-ce5,2911808,Guaratinga - BA,12106,12966,860,19016,63.66,68.18,4.52
sidra_9541_PercMoradDPPOColetTot_munic_22_pol.fid-703dc0a5_191866d88cb_-ce4,2911857,Heliópolis - BA,8274,8806,532,12258,67.5,71.84,4.34
sidra_9541_PercMoradDPPOColetTot_munic_22_pol.fid-703dc0a5_191866d88cb_-ce3,2911907,Iaçu - BA,19533,19868,335,24580,79.47,80.83,1.36
sidra_9541_PercMoradDPPOColetTot_munic_22_pol.fid-703dc0a5_191866d88cb_-ce2,2912004,Ibiassucê - BA,6261,6616,355,10426,60.05,63.46,3.4
sidra_9541_PercMoradDPPOColetTot_munic_22_pol.fid-703dc0a5_191866d88cb_-ce1,2912103,Ibicaraí - BA,18860,20257,1397,21619,87.24,93.7,6.46
sidra_9541_PercMoradDPPOColetTot_munic_22_pol.fid-703dc0a5_191866d88cb_-ce0,2912202,Ibicoara - BA,16103,19376,3273,20759,77.57,93.34,15.77
sidra_9541_PercMoradDPPOColetTot_munic_22_pol.fid-703dc0a5_191866d88cb_-cdf,2912301,Ibicuí - BA,9990,11457,1467,13918,71.78,82.32,10.54
sidra_9541_PercMoradDPPOColetTot_munic_22_pol.fid-703dc0a5_191866d88cb_-cde,2912400,Ibipeba - BA,12377,12840,463,16580,74.65,77.44,2.79
sidra_9541_PercMoradDPPOColetTot_munic_22_pol.fid-703dc0a5_191866d88cb_-cdd,2912509,Ibipitanga - BA,7030,7200,170,13863,50.71,51.94,1.23
sidra_9541_PercMoradDPPOColetTot_munic_22_pol.fid-703dc0a5_191866d88cb_-cdc,2912608,Ibiquera - BA,1633,2552,919,3724,43.85,68.53,24.68
sidra_9541_PercMoradDPPOColetTot_munic_22_pol.fid-703dc0a5_191866d88cb_-cdb,2912707,Ibirapitanga - BA,14986,15792,806,25311,59.21,62.39,3.18
sidra_9541_PercMoradDPPOColetTot_munic_22_pol.fid-703dc0a5_191866d88cb_-cda,2912806,Ibirapuã - BA,5816,6586,770,8888,65.44,74.1,8.66
sidra_9541_PercMoradDPPOColetTot_munic_22_pol.fid-703dc0a5_191866d88cb_-cd9,2912905,Ibirataia - BA,14888,15689,801,18769,79.32,83.59,4.27
sidra_9541_PercMoradDPPOColetTot_munic_22_pol.fid-703dc0a5_191866d88cb_-cd8,2913002,Ibitiara - BA,6002,6307,305,14552,41.25,43.34,2.1
sidra_9541_PercMoradDPPOColetTot_munic_22_pol.fid-703dc0a5_191866d88cb_-cd7,2913101,Ibititá - BA,13585,14987,1402,16934,80.22,88.5,8.28
sidra_9541_PercMoradDPPOColetTot_munic_22_pol.fid-703dc0a5_191866d88cb_-cd6,2913200,Ibotirama - BA,20724,21353,629,26265,78.9,81.3,2.39
sidra_9541_PercMoradDPPOColetTot_munic_22_pol.fid-703dc0a5_191866d88cb_-cd5,2913309,Ichu - BA,5450,5614,164,6180,88.19,90.84,2.65
sidra_9541_PercMoradDPPOColetTot_munic_22_pol.fid-703dc0a5_191866d88cb_-cd4,2913408,Igaporã - BA,8174,8762,588,15524,52.65,56.44,3.79
sidra_9541_PercMoradDPPOColetTot_munic_22_pol.fid-703dc0a5_191866d88cb_-cd3,2913457,Igrapiúna - BA,5375,7037,1662,13134,40.92,53.58,12.65
sidra_9541_PercMoradDPPOColetTot_munic_22_pol.fid-703dc0a5_191866d88cb_-cd2,2913507,Iguaí - BA,13797,15237,1440,21440,64.35,71.07,6.72
sidra_9541_PercMoradDPPOColetTot_munic_22_pol.fid-703dc0a5_191866d88cb_-cd1,2913606,Ilhéus - BA,125351,159795,34444,178207,70.34,89.67,19.33
sidra_9541_PercMoradDPPOColetTot_munic_22_pol.fid-703dc0a5_191866d88cb_-ccf,2916104,Itaparica - BA,13684,17887,4203,19686,69.51,90.86,21.35
sidra_9541_PercMoradDPPOColetTot_munic_22_pol.fid-703dc0a5_191866d88cb_-cce,2916203,Itapé - BA,7005,8646,1641,10314,67.92,83.83,15.91
sidra_9541_PercMoradDPPOColetTot_munic_22_pol.fid-703dc0a5_191866d88cb_-ccd,2916302,Itapebi - BA,6513,7862,1349,9124,71.38,86.17,14.79
sidra_9541_PercMoradDPPOColetTot_munic_22_pol.fid-703dc0a5_191866d88cb_-ccc,2916401,Itapetinga - BA,61480,63499,2019,65763,93.49,96.56,3.07
sidra_9541_PercMoradDPPOColetTot_munic_22_pol.fid-703dc0a5_191866d88cb_-ccb,2916500,Itapicuru - BA,18979,19539,560,31634,60,61.77,1.77
sidra_9541_PercMoradDPPOColetTot_munic_22_pol.fid-703dc0a5_191866d88cb_-cca,2916609,Itapitanga - BA,7916,8270,354,10264,77.12,80.57,3.45
sidra_9541_PercMoradDPPOColetTot_munic_22_pol.fid-703dc0a5_191866d88cb_-cc8,2916708,Itaquara - BA,4687,6034,1347,8150,57.51,74.04,16.53
sidra_9541_PercMoradDPPOColetTot_munic_22_pol.fid-703dc0a5_191866d88cb_-cc7,2916807,Itarantim - BA,13838,14720,882,17035,81.23,86.41,5.18
sidra_9541_PercMoradDPPOColetTot_munic_22_pol.fid-703dc0a5_191866d88cb_-cc6,2916856,Itatim - BA,12393,12464,71,15698,78.95,79.4,0.45
sidra_9541_PercMoradDPPOColetTot_munic_22_pol.fid-703dc0a5_191866d88cb_-cc5,2916906,Itiruçu - BA,8241,9711,1470,10947,75.28,88.71,13.43
sidra_9541_PercMoradDPPOColetTot_munic_22_pol.fid-703dc0a5_191866d88cb_-cc4,2917003,Itiúba - BA,13447,19210,5763,33855,39.72,56.74,17.02
sidra_9541_PercMoradDPPOColetTot_munic_22_pol.fid-703dc0a5_191866d88cb_-cc2,2917102,Itororó - BA,13060,15333,2273,16587,78.74,92.44,13.7
sidra_9541_PercMoradDPPOColetTot_munic_22_pol.fid-703dc0a5_191866d88cb_-cc1,2917201,Ituaçu - BA,8459,8550,91,17876,47.32,47.83,0.51
sidra_9541_PercMoradDPPOColetTot_munic_22_pol.fid-703dc0a5_191866d88cb_-cc0,2917300,Ituberá - BA,14876,17829,2953,21886,67.97,81.46,13.49
sidra_9541_PercMoradDPPOColetTot_munic_22_pol.fid-703dc0a5_191866d88cb_-cbf,2917334,Iuiu - BA,7812,7890,78,11103,70.36,71.06,0.7
sidra_9541_PercMoradDPPOColetTot_munic_22_pol.fid-703dc0a5_191866d88cb_-cbe,2917359,Jaborandi - BA,4507,5608,1101,9264,48.65,60.54,11.88
sidra_9541_PercMoradDPPOColetTot_munic_22_pol.fid-703dc0a5_191866d88cb_-cbc,2917409,Jacaraci - BA,5547,6126,579,14436,38.42,42.44,4.01
sidra_9541_PercMoradDPPOColetTot_munic_22_pol.fid-703dc0a5_191866d88cb_-cba,2917508,Jacobina - BA,71073,77527,6454,82451,86.2,94.03,7.83
sidra_9541_PercMoradDPPOColetTot_munic_22_pol.fid-703dc0a5_191866d88cb_-cb9,2917607,Jaguaquara - BA,38870,40309,1439,45878,84.72,87.86,3.14
sidra_9541_PercMoradDPPOColetTot_munic_22_pol.fid-703dc0a5_191866d88cb_-cb8,2917706,Jaguarari - BA,24387,26018,1631,32679,74.63,79.62,4.99
sidra_9541_PercMoradDPPOColetTot_munic_22_pol.fid-703dc0a5_191866d88cb_-cb7,2917805,Jaguaripe - BA,6267,9930,3663,17586,35.64,56.47,20.83
sidra_9541_PercMoradDPPOColetTot_munic_22_pol.fid-703dc0a5_191866d88cb_-cb5,2917904,Jandaíra - BA,7437,7702,265,9258,80.33,83.19,2.86
sidra_9541_PercMoradDPPOColetTot_munic_22_pol.fid-703dc0a5_191866d88cb_-cb4,2918001,Jequié - BA,127078,148399,21321,158203,80.33,93.8,13.48
sidra_9541_PercMoradDPPOColetTot_munic_22_pol.fid-703dc0a5_191866d88cb_-cb3,2918100,Jeremoabo - BA,24876,26415,1539,37503,66.33,70.43,4.1
sidra_9541_PercMoradDPPOColetTot_munic_22_pol.fid-703dc0a5_191866d88cb_-cb2,2918209,Jiquiriçá - BA,6663,7457,794,13605,48.97,54.81,5.84
sidra_9541_PercMoradDPPOColetTot_munic_22_pol.fid-703dc0a5_191866d88cb_-cb1,2918308,Jitaúna - BA,9073,10846,1773,14285,63.51,75.93,12.41
sidra_9541_PercMoradDPPOColetTot_munic_22_pol.fid-703dc0a5_191866d88cb_-caf,2918357,João Dourado - BA,21257,22878,1621,24846,85.56,92.08,6.52
sidra_9541_PercMoradDPPOColetTot_munic_22_pol.fid-703dc0a5_191866d88cb_-cae,2918407,Juazeiro - BA,208895,212399,3504,236765,88.23,89.71,1.48
sidra_9541_PercMoradDPPOColetTot_munic_22_pol.fid-703dc0a5_191866d88cb_-cad,2918456,Jucuruçu - BA,5345,5426,81,9638,55.46,56.3,0.84
sidra_9541_PercMoradDPPOColetTot_munic_22_pol.fid-703dc0a5_191866d88cb_-cac,2918506,Jussara - BA,11960,12132,172,16335,73.22,74.27,1.05
sidra_9541_PercMoradDPPOColetTot_munic_22_pol.fid-703dc0a5_191866d88cb_-cab,2918555,Jussari - BA,4361,5058,697,5888,74.07,85.9,11.84
sidra_9541_PercMoradDPPOColetTot_munic_22_pol.fid-703dc0a5_191866d88cb_-caa,2918605,Jussiape - BA,3188,3217,29,7379,43.2,43.6,0.39
sidra_9541_PercMoradDPPOColetTot_munic_22_pol.fid-703dc0a5_191866d88cb_-ca8,2918704,Lafaiete Coutinho - BA,3282,3470,188,4074,80.56,85.17,4.61
sidra_9541_PercMoradDPPOColetTot_munic_22_pol.fid-703dc0a5_191866d88cb_-ca7,2918753,Lagoa Real - BA,3941,4298,357,14100,27.95,30.48,2.53
sidra_9541_PercMoradDPPOColetTot_munic_22_pol.fid-703dc0a5_191866d88cb_-ca6,2918803,Laje - BA,8784,10704,1920,21007,41.81,50.95,9.14
sidra_9541_PercMoradDPPOColetTot_munic_22_pol.fid-703dc0a5_191866d88cb_-ca5,2918902,Lajedão - BA,2731,2907,176,3842,71.08,75.66,4.58
sidra_9541_PercMoradDPPOColetTot_munic_22_pol.fid-703dc0a5_191866d88cb_-ca4,2919009,Lajedinho - BA,1890,1944,54,3524,53.63,55.16,1.53
sidra_9541_PercMoradDPPOColetTot_munic_22_pol.fid-703dc0a5_191866d88cb_-ca3,2919058,Lajedo do Tabocal - BA,6003,6348,345,7488,80.17,84.78,4.61
sidra_9541_PercMoradDPPOColetTot_munic_22_pol.fid-703dc0a5_191866d88cb_-ca2,2919108,Lamarão - BA,1041,3478,2437,9015,11.55,38.58,27.03
sidra_9541_PercMoradDPPOColetTot_munic_22_pol.fid-703dc0a5_191866d88cb_-ca1,2919157,Lapão - BA,21654,21881,227,25690,84.29,85.17,0.88
sidra_9541_PercMoradDPPOColetTot_munic_22_pol.fid-703dc0a5_191866d88cb_-ca0,2919207,Lauro de Freitas - BA,133601,200982,67381,202591,65.95,99.21,33.26
sidra_9541_PercMoradDPPOColetTot_munic_22_pol.fid-703dc0a5_191866d88cb_-c9f,2919306,Lençóis - BA,6940,8994,2054,10655,65.13,84.41,19.28
sidra_9541_PercMoradDPPOColetTot_munic_22_pol.fid-703dc0a5_191866d88cb_-c9e,2922052,Mulungu do Morro - BA,8610,8857,247,13149,65.48,67.36,1.88
sidra_9541_PercMoradDPPOColetTot_munic_22_pol.fid-703dc0a5_191866d88cb_-c9d,2922730,Nova Fátima - BA,6895,7081,186,7963,86.59,88.92,2.34
sidra_9541_PercMoradDPPOColetTot_munic_22_pol.fid-703dc0a5_191866d88cb_-c9c,2922755,Nova Ibiá - BA,3300,3650,350,6492,50.83,56.22,5.39
sidra_9541_PercMoradDPPOColetTot_munic_22_pol.fid-703dc0a5_191866d88cb_-c9b,2922805,Nova Itarana - BA,3939,6327,2388,7778,50.64,81.34,30.7
sidra_9541_PercMoradDPPOColetTot_munic_22_pol.fid-703dc0a5_191866d88cb_-c9a,2922854,Nova Redenção - BA,4692,4977,285,7529,62.32,66.1,3.79
sidra_9541_PercMoradDPPOColetTot_munic_22_pol.fid-703dc0a5_191866d88cb_-c99,2922904,Nova Soure - BA,14923,16593,1670,24198,61.67,68.57,6.9
sidra_9541_PercMoradDPPOColetTot_munic_22_pol.fid-703dc0a5_191866d88cb_-c98,2923001,Nova Viçosa - BA,35485,36014,529,39418,90.02,91.36,1.34
sidra_9541_PercMoradDPPOColetTot_munic_22_pol.fid-703dc0a5_191866d88cb_-c97,2923035,Novo Horizonte - BA,4415,5062,647,11139,39.64,45.44,5.81
sidra_9541_PercMoradDPPOColetTot_munic_22_pol.fid-703dc0a5_191866d88cb_-c96,2923050,Novo Triunfo - BA,6281,7112,831,10656,58.94,66.74,7.8
sidra_9541_PercMoradDPPOColetTot_munic_22_pol.fid-703dc0a5_191866d88cb_-c95,2923100,Olindina - BA,16560,17536,976,22587,73.32,77.64,4.32
sidra_9541_PercMoradDPPOColetTot_munic_22_pol.fid-703dc0a5_191866d88cb_-c94,2923209,Oliveira dos Brejinhos - BA,11708,12635,927,20699,56.56,61.04,4.48
sidra_9541_PercMoradDPPOColetTot_munic_22_pol.fid-703dc0a5_191866d88cb_-c93,2923308,Ouriçangas - BA,4091,5617,1526,7708,53.07,72.87,19.8
sidra_9541_PercMoradDPPOColetTot_munic_22_pol.fid-703dc0a5_191866d88cb_-c92,2923357,Ourolândia - BA,13664,15865,2201,19224,71.08,82.53,11.45
sidra_9541_PercMoradDPPOColetTot_munic_22_pol.fid-703dc0a5_191866d88cb_-c91,2923407,Palmas de Monte Alto - BA,10640,10954,314,20062,53.04,54.6,1.57
sidra_9541_PercMoradDPPOColetTot_munic_22_pol.fid-703dc0a5_191866d88cb_-c90,2923506,Palmeiras - BA,5900,7655,1755,10276,57.42,74.49,17.08
sidra_9541_PercMoradDPPOColetTot_munic_22_pol.fid-703dc0a5_191866d88cb_-c8f,2923605,Paramirim - BA,9194,13921,4727,20339,45.2,68.44,23.24
sidra_9541_PercMoradDPPOColetTot_munic_22_pol.fid-703dc0a5_191866d88cb_-c8e,2923704,Paratinga - BA,9945,11636,1691,29249,34,39.78,5.78
sidra_9541_PercMoradDPPOColetTot_munic_22_pol.fid-703dc0a5_191866d88cb_-c8d,2923803,Paripiranga - BA,15528,18199,2671,26601,58.37,68.41,10.04
sidra_9541_PercMoradDPPOColetTot_munic_22_pol.fid-703dc0a5_191866d88cb_-c8c,2923902,Pau Brasil - BA,6322,6338,16,9357,67.56,67.74,0.17
sidra_9541_PercMoradDPPOColetTot_munic_22_pol.fid-703dc0a5_191866d88cb_-c8b,2927309,Salinas da Margarida - BA,13013,14820,1807,14981,86.86,98.93,12.06
sidra_9541_PercMoradDPPOColetTot_munic_22_pol.fid-703dc0a5_191866d88cb_-c8a,2927408,Salvador - BA,1373435,2362514,989079,2407866,57.04,98.12,41.08
sidra_9541_PercMoradDPPOColetTot_munic_22_pol.fid-703dc0a5_191866d88cb_-c89,2927507,Santa Bárbara - BA,12337,14433,2096,20935,58.93,68.94,10.01
sidra_9541_PercMoradDPPOColetTot_munic_22_pol.fid-703dc0a5_191866d88cb_-c88,2927606,Santa Brígida - BA,7003,7141,138,14945,46.86,47.78,0.92
sidra_9541_PercMoradDPPOColetTot_munic_22_pol.fid-703dc0a5_191866d88cb_-c87,2927705,Santa Cruz Cabrália - BA,22408,23686,1278,28741,77.97,82.41,4.45
sidra_9541_PercMoradDPPOColetTot_munic_22_pol.fid-703dc0a5_191866d88cb_-c86,2927804,Santa Cruz da Vitória - BA,3911,4100,189,4654,84.04,88.1,4.06
sidra_9541_PercMoradDPPOColetTot_munic_22_pol.fid-703dc0a5_191866d88cb_-c85,2927903,Santa Inês - BA,9682,9899,217,10238,94.57,96.69,2.12
sidra_9541_PercMoradDPPOColetTot_munic_22_pol.fid-703dc0a5_191866d88cb_-c83,2928000,Santaluz - BA,26500,30618,4118,37780,70.14,81.04,10.9
sidra_9541_PercMoradDPPOColetTot_munic_22_pol.fid-703dc0a5_191866d88cb_-c82,2932804,Utinga - BA,12132,13864,1732,16253,74.64,85.3,10.66
sidra_9541_PercMoradDPPOColetTot_munic_22_pol.fid-703dc0a5_191866d88cb_-c81,2932903,Valença - BA,57716,64301,6585,85254,67.7,75.42,7.72
sidra_9541_PercMoradDPPOColetTot_munic_22_pol.fid-703dc0a5_191866d88cb_-c80,2933000,Valente - BA,22041,22754,713,24362,90.47,93.4,2.93
sidra_9541_PercMoradDPPOColetTot_munic_22_pol.fid-703dc0a5_191866d88cb_-c7f,2933059,Várzea da Roça - BA,9086,10365,1279,13800,65.84,75.11,9.27
sidra_9541_PercMoradDPPOColetTot_munic_22_pol.fid-703dc0a5_191866d88cb_-c7e,2933109,Várzea do Poço - BA,6667,6899,232,8100,82.31,85.17,2.86
sidra_9541_PercMoradDPPOColetTot_munic_22_pol.fid-703dc0a5_191866d88cb_-c7d,4302402,Bom Retiro do Sul - RS,11469,12126,657,12230,93.78,99.15,5.37
sidra_9541_PercMoradDPPOColetTot_munic_22_pol.fid-703dc0a5_191866d88cb_-c7c,4302451,Boqueirão do Leão - RS,2464,4545,2081,6225,39.58,73.01,33.43
sidra_9541_PercMoradDPPOColetTot_munic_22_pol.fid-703dc0a5_191866d88cb_-c7b,2933158,Várzea Nova - BA,10166,10678,512,13363,76.08,79.91,3.83
sidra_9541_PercMoradDPPOColetTot_munic_22_pol.fid-703dc0a5_191866d88cb_-c7a,2933174,Varzedo - BA,3119,5871,2752,9889,31.54,59.37,27.83
sidra_9541_PercMoradDPPOColetTot_munic_22_pol.fid-703dc0a5_191866d88cb_-c78,2933208,Vera Cruz - BA,26310,38301,11991,42486,61.93,90.15,28.22
sidra_9541_PercMoradDPPOColetTot_munic_22_pol.fid-703dc0a5_191866d88cb_-c77,2933257,Vereda - BA,4478,4533,55,6002,74.61,75.52,0.92
sidra_9541_PercMoradDPPOColetTot_munic_22_pol.fid-703dc0a5_191866d88cb_-c76,2933307,Vitória da Conquista - BA,328305,345136,16831,369737,88.79,93.35,4.55
sidra_9541_PercMoradDPPOColetTot_munic_22_pol.fid-703dc0a5_191866d88cb_-c75,2933406,Wagner - BA,7428,7448,20,9502,78.17,78.38,0.21
sidra_9541_PercMoradDPPOColetTot_munic_22_pol.fid-703dc0a5_191866d88cb_-c74,2933455,Wanderley - BA,7170,7555,385,12962,55.32,58.29,2.97
sidra_9541_PercMoradDPPOColetTot_munic_22_pol.fid-703dc0a5_191866d88cb_-c73,2933505,Wenceslau Guimarães - BA,10948,13309,2361,24421,44.83,54.5,9.67
sidra_9541_PercMoradDPPOColetTot_munic_22_pol.fid-703dc0a5_191866d88cb_-c72,2933604,Xique-Xique - BA,32436,32919,483,44451,72.97,74.06,1.09
sidra_9541_PercMoradDPPOColetTot_munic_22_pol.fid-703dc0a5_191866d88cb_-c70,3100104,Abadia dos Dourados - MG,4446,4734,288,6271,70.9,75.49,4.59
sidra_9541_PercMoradDPPOColetTot_munic_22_pol.fid-703dc0a5_191866d88cb_-c6f,3100203,Abaeté - MG,20085,20664,579,22559,89.03,91.6,2.57
sidra_9541_PercMoradDPPOColetTot_munic_22_pol.fid-703dc0a5_191866d88cb_-c6e,3100302,Abre Campo - MG,8423,9211,788,13603,61.92,67.71,5.79
sidra_9541_PercMoradDPPOColetTot_munic_22_pol.fid-703dc0a5_191866d88cb_-c6d,3100401,Acaiaca - MG,2884,3518,634,3909,73.78,90,16.22
sidra_9541_PercMoradDPPOColetTot_munic_22_pol.fid-703dc0a5_191866d88cb_-c6c,3100500,Açucena - MG,4632,5150,518,8763,52.86,58.77,5.91
sidra_9541_PercMoradDPPOColetTot_munic_22_pol.fid-703dc0a5_191866d88cb_-c6b,3100609,Água Boa - MG,5942,6662,720,12557,47.32,53.05,5.73
sidra_9541_PercMoradDPPOColetTot_munic_22_pol.fid-703dc0a5_191866d88cb_-c69,3100708,Água Comprida - MG,1795,1888,93,2105,85.27,89.69,4.42
sidra_9541_PercMoradDPPOColetTot_munic_22_pol.fid-703dc0a5_191866d88cb_-c68,3100807,Aguanil - MG,3693,4122,429,4334,85.21,95.11,9.9
sidra_9541_PercMoradDPPOColetTot_munic_22_pol.fid-703dc0a5_191866d88cb_-c67,3100906,Águas Formosas - MG,14268,14401,133,18391,77.58,78.3,0.72
sidra_9541_PercMoradDPPOColetTot_munic_22_pol.fid-703dc0a5_191866d88cb_-c66,3101003,Águas Vermelhas - MG,11305,11432,127,14031,80.57,81.48,0.91
sidra_9541_PercMoradDPPOColetTot_munic_22_pol.fid-703dc0a5_191866d88cb_-c65,3101102,Aimorés - MG,20021,20653,632,25044,79.94,82.47,2.52
sidra_9541_PercMoradDPPOColetTot_munic_22_pol.fid-703dc0a5_191866d88cb_-c64,3101201,Aiuruoca - MG,3158,5403,2245,6162,51.25,87.68,36.43
sidra_9541_PercMoradDPPOColetTot_munic_22_pol.fid-703dc0a5_191866d88cb_-c63,3101300,Alagoa - MG,1786,2338,552,2739,65.21,85.36,20.15
sidra_9541_PercMoradDPPOColetTot_munic_22_pol.fid-703dc0a5_191866d88cb_-c62,3101409,Albertina - MG,2472,2807,335,2951,83.77,95.12,11.35
sidra_9541_PercMoradDPPOColetTot_munic_22_pol.fid-703dc0a5_191866d88cb_-c61,3101508,Além Paraíba - MG,15121,29751,14630,30466,49.63,97.65,48.02
sidra_9541_PercMoradDPPOColetTot_munic_22_pol.fid-703dc0a5_191866d88cb_-c5f,3101607,Alfenas - MG,72601,77191,4590,78528,92.45,98.3,5.85
sidra_9541_PercMoradDPPOColetTot_munic_22_pol.fid-703dc0a5_191866d88cb_-c5e,3101631,Alfredo Vasconcelos - MG,6607,6701,94,6931,95.33,96.68,1.36
sidra_9541_PercMoradDPPOColetTot_munic_22_pol.fid-703dc0a5_191866d88cb_-c5d,3101706,Almenara - MG,33670,33918,248,40056,84.06,84.68,0.62
sidra_9541_PercMoradDPPOColetTot_munic_22_pol.fid-703dc0a5_191866d88cb_-c5c,3101805,Alpercata - MG,3875,5758,1883,6844,56.62,84.13,27.51
sidra_9541_PercMoradDPPOColetTot_munic_22_pol.fid-703dc0a5_191866d88cb_-c5b,3101904,Alpinópolis - MG,14532,17291,2759,18257,79.6,94.71,15.11
sidra_9541_PercMoradDPPOColetTot_munic_22_pol.fid-703dc0a5_191866d88cb_-c5a,3102001,Alterosa - MG,4158,12266,8108,13854,30.01,88.54,58.52
sidra_9541_PercMoradDPPOColetTot_munic_22_pol.fid-703dc0a5_191866d88cb_-c59,3102050,Alto Caparaó - MG,4732,5335,603,5752,82.27,92.75,10.48
sidra_9541_PercMoradDPPOColetTot_munic_22_pol.fid-703dc0a5_191866d88cb_-c58,3102100,Alto Rio Doce - MG,6288,7214,926,10844,57.99,66.53,8.54
sidra_9541_PercMoradDPPOColetTot_munic_22_pol.fid-703dc0a5_191866d88cb_-c57,3102209,Alvarenga - MG,2964,3170,206,3959,74.87,80.07,5.2
sidra_9541_PercMoradDPPOColetTot_munic_22_pol.fid-703dc0a5_191866d88cb_-c56,3102308,Alvinópolis - MG,11484,12677,1193,15019,76.46,84.41,7.94
sidra_9541_PercMoradDPPOColetTot_munic_22_pol.fid-703dc0a5_191866d88cb_-c54,3102407,Alvorada de Minas - MG,2555,2783,228,4157,61.46,66.95,5.48
sidra_9541_PercMoradDPPOColetTot_munic_22_pol.fid-703dc0a5_191866d88cb_-c53,3102506,Amparo do Serra - MG,3459,3551,92,4515,76.61,78.65,2.04
sidra_9541_PercMoradDPPOColetTot_munic_22_pol.fid-703dc0a5_191866d88cb_-c52,3102605,Andradas - MG,34935,38875,3940,40293,86.7,96.48,9.78
sidra_9541_PercMoradDPPOColetTot_munic_22_pol.fid-703dc0a5_191866d88cb_-c51,3102704,Cachoeira de Pajeú - MG,6119,6173,54,9078,67.4,68,0.59
sidra_9541_PercMoradDPPOColetTot_munic_22_pol.fid-703dc0a5_191866d88cb_-c50,3102803,Andrelândia - MG,9810,10180,370,11864,82.69,85.81,3.12
sidra_9541_PercMoradDPPOColetTot_munic_22_pol.fid-703dc0a5_191866d88cb_-c4f,3102852,Angelândia - MG,4665,4693,28,7716,60.46,60.82,0.36
sidra_9541_PercMoradDPPOColetTot_munic_22_pol.fid-703dc0a5_191866d88cb_-c4e,3102902,Antônio Carlos - MG,7112,9623,2511,11081,64.18,86.84,22.66
sidra_9541_PercMoradDPPOColetTot_munic_22_pol.fid-703dc0a5_191866d88cb_-c4c,3103009,Antônio Dias - MG,6867,7153,286,9205,74.6,77.71,3.11
sidra_9541_PercMoradDPPOColetTot_munic_22_pol.fid-703dc0a5_191866d88cb_-c4b,3103108,Antônio Prado de Minas - MG,1245,1296,51,1537,81,84.32,3.32
sidra_9541_PercMoradDPPOColetTot_munic_22_pol.fid-703dc0a5_191866d88cb_-c4a,3103207,Araçaí - MG,1757,1964,207,2180,80.6,90.09,9.5
sidra_9541_PercMoradDPPOColetTot_munic_22_pol.fid-703dc0a5_191866d88cb_-c49,3103306,Aracitaba - MG,1708,1766,58,2046,83.48,86.31,2.83
sidra_9541_PercMoradDPPOColetTot_munic_22_pol.fid-703dc0a5_191866d88cb_-c48,3103405,Araçuaí - MG,25457,26119,662,34101,74.65,76.59,1.94
sidra_9541_PercMoradDPPOColetTot_munic_22_pol.fid-703dc0a5_191866d88cb_-c47,3103504,Araguari - MG,110692,112739,2047,116968,94.63,96.38,1.75
sidra_9541_PercMoradDPPOColetTot_munic_22_pol.fid-703dc0a5_191866d88cb_-c45,3103603,Arantina - MG,2762,2812,50,2915,94.75,96.47,1.72
sidra_9541_PercMoradDPPOColetTot_munic_22_pol.fid-703dc0a5_191866d88cb_-c44,3103702,Araponga - MG,4942,5707,765,8043,61.44,70.96,9.51
sidra_9541_PercMoradDPPOColetTot_munic_22_pol.fid-703dc0a5_191866d88cb_-c43,3103751,Araporã - MG,8175,8312,137,8467,96.55,98.17,1.62
sidra_9541_PercMoradDPPOColetTot_munic_22_pol.fid-703dc0a5_191866d88cb_-c42,3157336,Santa Cruz de Minas - MG,8016,8103,87,8103,98.93,100,1.07
sidra_9541_PercMoradDPPOColetTot_munic_22_pol.fid-703dc0a5_191866d88cb_-c41,3157377,Santa Cruz de Salinas - MG,1916,2040,124,3902,49.1,52.28,3.18
sidra_9541_PercMoradDPPOColetTot_munic_22_pol.fid-703dc0a5_191866d88cb_-c40,3157401,Santa Cruz do Escalvado - MG,3285,4096,811,4673,70.3,87.65,17.36
sidra_9541_PercMoradDPPOColetTot_munic_22_pol.fid-703dc0a5_191866d88cb_-c3f,3157500,Santa Efigênia de Minas - MG,2828,2930,102,4031,70.16,72.69,2.53
sidra_9541_PercMoradDPPOColetTot_munic_22_pol.fid-703dc0a5_191866d88cb_-c3e,3157609,Santa Fé de Minas - MG,1976,1995,19,3519,56.15,56.69,0.54
sidra_9541_PercMoradDPPOColetTot_munic_22_pol.fid-703dc0a5_191866d88cb_-c3d,3157658,Santa Helena de Minas - MG,3532,3573,41,5938,59.48,60.17,0.69
sidra_9541_PercMoradDPPOColetTot_munic_22_pol.fid-703dc0a5_191866d88cb_-c3c,3157708,Santa Juliana - MG,14634,15391,757,15668,93.4,98.23,4.83
sidra_9541_PercMoradDPPOColetTot_munic_22_pol.fid-703dc0a5_191866d88cb_-c3b,3157807,Santa Luzia - MG,200784,214894,14110,218588,91.86,98.31,6.46
sidra_9541_PercMoradDPPOColetTot_munic_22_pol.fid-703dc0a5_191866d88cb_-c3a,3157906,Santa Margarida - MG,11767,14092,2325,16387,71.81,86,14.19
sidra_9541_PercMoradDPPOColetTot_munic_22_pol.fid-703dc0a5_191866d88cb_-c39,3158003,Santa Maria de Itabira - MG,7363,8204,841,10443,70.51,78.56,8.05
sidra_9541_PercMoradDPPOColetTot_munic_22_pol.fid-703dc0a5_191866d88cb_-c38,3158102,Santa Maria do Salto - MG,3546,3609,63,4750,74.65,75.98,1.33
sidra_9541_PercMoradDPPOColetTot_munic_22_pol.fid-703dc0a5_191866d88cb_-c37,3158201,Santa Maria do Suaçuí - MG,8491,9331,840,12655,67.1,73.73,6.64
sidra_9541_PercMoradDPPOColetTot_munic_22_pol.fid-703dc0a5_191866d88cb_-c35,3158300,Santana da Vargem - MG,5579,5875,296,6686,83.44,87.87,4.43
sidra_9541_PercMoradDPPOColetTot_munic_22_pol.fid-703dc0a5_191866d88cb_-c34,3158409,Santana de Cataguases - MG,2193,3119,926,3487,62.89,89.45,26.56
sidra_9541_PercMoradDPPOColetTot_munic_22_pol.fid-703dc0a5_191866d88cb_-c33,3158508,Santana de Pirapama - MG,3055,3164,109,7002,43.63,45.19,1.56
sidra_9541_PercMoradDPPOColetTot_munic_22_pol.fid-703dc0a5_191866d88cb_-c32,3158607,Santana do Deserto - MG,2953,3627,674,3742,78.92,96.93,18.01
sidra_9541_PercMoradDPPOColetTot_munic_22_pol.fid-703dc0a5_191866d88cb_-c31,3158706,Santana do Garambéu - MG,1734,1753,19,2135,81.22,82.11,0.89
sidra_9541_PercMoradDPPOColetTot_munic_22_pol.fid-703dc0a5_191866d88cb_-c30,3158805,Santana do Jacaré - MG,4111,4129,18,4185,98.23,98.66,0.43
sidra_9541_PercMoradDPPOColetTot_munic_22_pol.fid-703dc0a5_191866d88cb_-c2f,3158904,Santana do Manhuaçu - MG,4600,6262,1662,8974,51.26,69.78,18.52
sidra_9541_PercMoradDPPOColetTot_munic_22_pol.fid-703dc0a5_191866d88cb_-c2e,3158953,Santana do Paraíso - MG,44295,44404,109,44762,98.96,99.2,0.24
sidra_9541_PercMoradDPPOColetTot_munic_22_pol.fid-703dc0a5_191866d88cb_-c2d,3159001,Santana do Riacho - MG,4180,4549,369,5307,78.76,85.72,6.95
sidra_9541_PercMoradDPPOColetTot_munic_22_pol.fid-703dc0a5_191866d88cb_-c2b,3203304,Mantenópolis - ES,8848,10064,1216,12695,69.7,79.28,9.58
sidra_9541_PercMoradDPPOColetTot_munic_22_pol.fid-703dc0a5_191866d88cb_-c2a,3203320,Marataízes - ES,30737,39787,9050,41823,73.49,95.13,21.64
sidra_9541_PercMoradDPPOColetTot_munic_22_pol.fid-703dc0a5_191866d88cb_-c29,3203346,Marechal Floriano - ES,9340,16977,7637,17608,53.04,96.42,43.37
sidra_9541_PercMoradDPPOColetTot_munic_22_pol.fid-703dc0a5_191866d88cb_-c28,3203353,Marilândia - ES,9407,10885,1478,12386,75.95,87.88,11.93
sidra_9541_PercMoradDPPOColetTot_munic_22_pol.fid-703dc0a5_191866d88cb_-c27,3203403,Mimoso do Sul - ES,13953,18526,4573,24383,57.22,75.98,18.75
sidra_9541_PercMoradDPPOColetTot_munic_22_pol.fid-703dc0a5_191866d88cb_-c26,3203502,Montanha - ES,15804,15836,32,18869,83.76,83.93,0.17
sidra_9541_PercMoradDPPOColetTot_munic_22_pol.fid-703dc0a5_191866d88cb_-c25,3203601,Mucurici - ES,4238,4251,13,5466,77.53,77.77,0.24
sidra_9541_PercMoradDPPOColetTot_munic_22_pol.fid-703dc0a5_191866d88cb_-c24,3203700,Muniz Freire - ES,10266,13303,3037,18140,56.59,73.34,16.74
sidra_9541_PercMoradDPPOColetTot_munic_22_pol.fid-703dc0a5_191866d88cb_-c23,3203809,Muqui - ES,8678,11293,2615,13702,63.33,82.42,19.08
sidra_9541_PercMoradDPPOColetTot_munic_22_pol.fid-703dc0a5_191866d88cb_-c22,3203908,Nova Venécia - ES,36703,38352,1649,48944,74.99,78.36,3.37
sidra_9541_PercMoradDPPOColetTot_munic_22_pol.fid-703dc0a5_191866d88cb_-c21,3204005,Pancas - ES,9133,10208,1075,18872,48.39,54.09,5.7
sidra_9541_PercMoradDPPOColetTot_munic_22_pol.fid-703dc0a5_191866d88cb_-c20,3204054,Pedro Canário - ES,19949,19988,39,21501,92.78,92.96,0.18
sidra_9541_PercMoradDPPOColetTot_munic_22_pol.fid-703dc0a5_191866d88cb_-c1e,3204104,Pinheiros - ES,19554,19675,121,23785,82.21,82.72,0.51
sidra_9541_PercMoradDPPOColetTot_munic_22_pol.fid-703dc0a5_191866d88cb_-c1d,3204203,Piúma - ES,18336,21996,3660,22237,82.46,98.92,16.46
sidra_9541_PercMoradDPPOColetTot_munic_22_pol.fid-703dc0a5_191866d88cb_-c1c,3204252,Ponto Belo - ES,5285,5512,227,6474,81.63,85.14,3.51
sidra_9541_PercMoradDPPOColetTot_munic_22_pol.fid-703dc0a5_191866d88cb_-c1b,3204302,Presidente Kennedy - ES,7819,13029,5210,13654,57.27,95.42,38.16
sidra_9541_PercMoradDPPOColetTot_munic_22_pol.fid-703dc0a5_191866d88cb_-c1a,3204351,Rio Bananal - ES,10779,11910,1131,19237,56.03,61.91,5.88
sidra_9541_PercMoradDPPOColetTot_munic_22_pol.fid-703dc0a5_191866d88cb_-c19,3204401,Rio Novo do Sul - ES,6992,10657,3665,11055,63.25,96.4,33.15
sidra_9541_PercMoradDPPOColetTot_munic_22_pol.fid-703dc0a5_191866d88cb_-c17,3204500,Santa Leopoldina - ES,7093,8782,1689,13105,54.12,67.01,12.89
sidra_9541_PercMoradDPPOColetTot_munic_22_pol.fid-703dc0a5_191866d88cb_-c16,3204559,Santa Maria de Jetibá - ES,21945,29354,7409,41618,52.73,70.53,17.8
sidra_9541_PercMoradDPPOColetTot_munic_22_pol.fid-703dc0a5_191866d88cb_-c15,3204609,Santa Teresa - ES,17217,20689,3472,22767,75.62,90.87,15.25
sidra_9541_PercMoradDPPOColetTot_munic_22_pol.fid-703dc0a5_191866d88cb_-c14,3204658,São Domingos do Norte - ES,3963,5531,1568,8337,47.54,66.34,18.81
sidra_9541_PercMoradDPPOColetTot_munic_22_pol.fid-703dc0a5_191866d88cb_-c13,3204708,São Gabriel da Palha - ES,25405,26191,786,32219,78.85,81.29,2.44
sidra_9541_PercMoradDPPOColetTot_munic_22_pol.fid-703dc0a5_191866d88cb_-c12,3204807,São José do Calçado - ES,8721,9895,1174,10823,80.58,91.43,10.85
sidra_9541_PercMoradDPPOColetTot_munic_22_pol.fid-703dc0a5_191866d88cb_-c10,3204906,São Mateus - ES,105093,107554,2461,122598,85.72,87.73,2.01
sidra_9541_PercMoradDPPOColetTot_munic_22_pol.fid-703dc0a5_191866d88cb_-c0e,3204955,São Roque do Canaã - ES,6906,9195,2289,10880,63.47,84.51,21.04
sidra_9541_PercMoradDPPOColetTot_munic_22_pol.fid-703dc0a5_191866d88cb_-c0d,3205002,Serra - ES,462015,516601,54586,518797,89.06,99.58,10.52
sidra_9541_PercMoradDPPOColetTot_munic_22_pol.fid-703dc0a5_191866d88cb_-c0c,3205010,Sooretama - ES,22805,23285,480,26464,86.17,87.99,1.81
sidra_9541_PercMoradDPPOColetTot_munic_22_pol.fid-703dc0a5_191866d88cb_-c0a,3205036,Vargem Alta - ES,9079,18304,9225,19544,46.45,93.66,47.2
sidra_9541_PercMoradDPPOColetTot_munic_22_pol.fid-703dc0a5_191866d88cb_-c09,3205069,Venda Nova do Imigrante - ES,21867,23354,1487,23822,91.79,98.04,6.24
sidra_9541_PercMoradDPPOColetTot_munic_22_pol.fid-703dc0a5_191866d88cb_-c08,3205101,Viana - ES,65140,68057,2917,70622,92.24,96.37,4.13
sidra_9541_PercMoradDPPOColetTot_munic_22_pol.fid-703dc0a5_191866d88cb_-c07,3205150,Vila Pavão - ES,4062,4962,900,8902,45.63,55.74,10.11
sidra_9541_PercMoradDPPOColetTot_munic_22_pol.fid-703dc0a5_191866d88cb_-c06,3205176,Vila Valério - ES,5613,6645,1032,13681,41.03,48.57,7.54
sidra_9541_PercMoradDPPOColetTot_munic_22_pol.fid-703dc0a5_191866d88cb_-c05,3205200,Vila Velha - ES,406838,455466,48628,458741,88.69,99.29,10.6
sidra_9541_PercMoradDPPOColetTot_munic_22_pol.fid-703dc0a5_191866d88cb_-c03,3205309,Vitória - ES,303384,321389,18005,322254,94.14,99.73,5.59
sidra_9541_PercMoradDPPOColetTot_munic_22_pol.fid-703dc0a5_191866d88cb_-c02,3300100,Angra dos Reis - RJ,134560,165861,31301,167240,80.46,99.18,18.72
sidra_9541_PercMoradDPPOColetTot_munic_22_pol.fid-703dc0a5_191866d88cb_-c01,3300159,Aperibé - RJ,10027,10605,578,11011,91.06,96.31,5.25
sidra_9541_PercMoradDPPOColetTot_munic_22_pol.fid-703dc0a5_191866d88cb_-c00,3300209,Araruama - RJ,119777,124294,4517,129098,92.78,96.28,3.5
sidra_9541_PercMoradDPPOColetTot_munic_22_pol.fid-703dc0a5_191866d88cb_-bff,3300225,Areal - RJ,6055,11587,5532,11820,51.23,98.03,46.8
sidra_9541_PercMoradDPPOColetTot_munic_22_pol.fid-703dc0a5_191866d88cb_-bfe,3300233,Armação dos Búzios - RJ,22602,39649,17047,39818,56.76,99.58,42.81
sidra_9541_PercMoradDPPOColetTot_munic_22_pol.fid-703dc0a5_191866d88cb_-bfc,3300258,Arraial do Cabo - RJ,21449,30787,9338,30965,69.27,99.43,30.16
sidra_9541_PercMoradDPPOColetTot_munic_22_pol.fid-703dc0a5_191866d88cb_-bfb,3300308,Barra do Piraí - RJ,72134,90942,18808,92763,77.76,98.04,20.28
sidra_9541_PercMoradDPPOColetTot_munic_22_pol.fid-703dc0a5_191866d88cb_-bf9,3300407,Barra Mansa - RJ,153685,168730,15045,169614,90.61,99.48,8.87
sidra_9541_PercMoradDPPOColetTot_munic_22_pol.fid-703dc0a5_191866d88cb_-bf7,3300456,Belford Roxo - RJ,390060,422626,32566,482696,80.81,87.56,6.75
sidra_9541_PercMoradDPPOColetTot_munic_22_pol.fid-703dc0a5_191866d88cb_-bf6,3300506,Bom Jardim - RJ,20438,27580,7142,28060,72.84,98.29,25.45
sidra_9541_PercMoradDPPOColetTot_munic_22_pol.fid-703dc0a5_191866d88cb_-bf5,3300605,Bom Jesus do Itabapoana - RJ,30655,33269,2614,35005,87.57,95.04,7.47
sidra_9541_PercMoradDPPOColetTot_munic_22_pol.fid-703dc0a5_191866d88cb_-bf3,3300704,Cabo Frio - RJ,185467,213624,28157,221764,83.63,96.33,12.7
sidra_9541_PercMoradDPPOColetTot_munic_22_pol.fid-703dc0a5_191866d88cb_-bf2,3300803,Cachoeiras de Macacu - RJ,44037,53131,9094,56912,77.38,93.36,15.98
sidra_9541_PercMoradDPPOColetTot_munic_22_pol.fid-703dc0a5_191866d88cb_-bf1,3300902,Cambuci - RJ,3907,12752,8845,14585,26.79,87.43,60.64
sidra_9541_PercMoradDPPOColetTot_munic_22_pol.fid-703dc0a5_191866d88cb_-bf0,3300936,Carapebus - RJ,12000,12855,855,13833,86.75,92.93,6.18
sidra_9541_PercMoradDPPOColetTot_munic_22_pol.fid-703dc0a5_191866d88cb_-bef,3300951,Comendador Levy Gasparian - RJ,6125,8536,2411,8710,70.32,98,27.68
sidra_9541_PercMoradDPPOColetTot_munic_22_pol.fid-703dc0a5_191866d88cb_-bee,3301009,Campos dos Goytacazes - RJ,453838,467501,13663,481324,94.29,97.13,2.84
sidra_9541_PercMoradDPPOColetTot_munic_22_pol.fid-703dc0a5_191866d88cb_-bec,3301108,Cantagalo - RJ,17469,18418,949,19347,90.29,95.2,4.91
sidra_9541_PercMoradDPPOColetTot_munic_22_pol.fid-703dc0a5_191866d88cb_-beb,3301157,Cardoso Moreira - RJ,9636,11572,1936,12937,74.48,89.45,14.96
sidra_9541_PercMoradDPPOColetTot_munic_22_pol.fid-703dc0a5_191866d88cb_-bea,3301876,Iguaba Grande - RJ,24114,27483,3369,27911,86.4,98.47,12.07
sidra_9541_PercMoradDPPOColetTot_munic_22_pol.fid-703dc0a5_191866d88cb_-be9,3301900,Itaboraí - RJ,205122,216092,10970,223888,91.62,96.52,4.9
sidra_9541_PercMoradDPPOColetTot_munic_22_pol.fid-703dc0a5_191866d88cb_-be8,3302007,Itaguaí - RJ,107583,113548,5965,116492,92.35,97.47,5.12
sidra_9541_PercMoradDPPOColetTot_munic_22_pol.fid-703dc0a5_191866d88cb_-be7,3302056,Italva - RJ,12756,13118,362,14061,90.72,93.29,2.57
sidra_9541_PercMoradDPPOColetTot_munic_22_pol.fid-703dc0a5_191866d88cb_-be6,3302106,Itaocara - RJ,11220,20882,9662,22819,49.17,91.51,42.34
sidra_9541_PercMoradDPPOColetTot_munic_22_pol.fid-703dc0a5_191866d88cb_-be5,3302205,Itaperuna - RJ,94481,96508,2027,100311,94.19,96.21,2.02
sidra_9541_PercMoradDPPOColetTot_munic_22_pol.fid-703dc0a5_191866d88cb_-be4,3302254,Itatiaia - RJ,29141,30577,1436,30767,94.72,99.38,4.67
sidra_9541_PercMoradDPPOColetTot_munic_22_pol.fid-703dc0a5_191866d88cb_-be3,3302270,Japeri - RJ,80778,87198,6420,91195,88.58,95.62,7.04
sidra_9541_PercMoradDPPOColetTot_munic_22_pol.fid-703dc0a5_191866d88cb_-be2,3302304,Laje do Muriaé - RJ,4688,6783,2095,7335,63.91,92.47,28.56
sidra_9541_PercMoradDPPOColetTot_munic_22_pol.fid-703dc0a5_191866d88cb_-be1,3302403,Macaé - RJ,215275,243180,27905,246134,87.46,98.8,11.34
sidra_9541_PercMoradDPPOColetTot_munic_22_pol.fid-703dc0a5_191866d88cb_-be0,3302452,Macuco - RJ,5138,5289,151,5415,94.88,97.67,2.79
sidra_9541_PercMoradDPPOColetTot_munic_22_pol.fid-703dc0a5_191866d88cb_-bdf,3302502,Magé - RJ,207037,220107,13070,226035,91.6,97.38,5.78
sidra_9541_PercMoradDPPOColetTot_munic_22_pol.fid-703dc0a5_191866d88cb_-bde,3302601,Mangaratiba - RJ,25276,40780,15504,41186,61.37,99.01,37.64
sidra_9541_PercMoradDPPOColetTot_munic_22_pol.fid-703dc0a5_191866d88cb_-bdd,3302700,Maricá - RJ,180691,195128,14437,196864,91.78,99.12,7.33
sidra_9541_PercMoradDPPOColetTot_munic_22_pol.fid-703dc0a5_191866d88cb_-bdc,3302809,Mendes - RJ,12793,17361,4568,17461,73.27,99.43,26.16
sidra_9541_PercMoradDPPOColetTot_munic_22_pol.fid-703dc0a5_191866d88cb_-bdb,3302858,Mesquita - RJ,157717,165928,8211,166824,94.54,99.46,4.92
sidra_9541_PercMoradDPPOColetTot_munic_22_pol.fid-703dc0a5_191866d88cb_-bda,3302908,Miguel Pereira - RJ,22632,26388,3756,26550,85.24,99.39,14.15
sidra_9541_PercMoradDPPOColetTot_munic_22_pol.fid-703dc0a5_191866d88cb_-bd9,3303005,Miracema - RJ,23276,25922,2646,26823,86.78,96.64,9.86
sidra_9541_PercMoradDPPOColetTot_munic_22_pol.fid-703dc0a5_191866d88cb_-bd8,3303104,Natividade - RJ,12730,14125,1395,15012,84.8,94.09,9.29
sidra_9541_PercMoradDPPOColetTot_munic_22_pol.fid-703dc0a5_191866d88cb_-bd7,3303203,Nilópolis - RJ,143494,146059,2565,146640,97.85,99.6,1.75
sidra_9541_PercMoradDPPOColetTot_munic_22_pol.fid-703dc0a5_191866d88cb_-bd6,3303302,Niterói - RJ,385011,476987,91976,480085,80.2,99.35,19.16
sidra_9541_PercMoradDPPOColetTot_munic_22_pol.fid-703dc0a5_191866d88cb_-bd5,3303401,Nova Friburgo - RJ,158458,188266,29808,189322,83.7,99.44,15.74
sidra_9541_PercMoradDPPOColetTot_munic_22_pol.fid-703dc0a5_191866d88cb_-bd3,3303500,Nova Iguaçu - RJ,726294,767938,41644,784572,92.57,97.88,5.31
sidra_9541_PercMoradDPPOColetTot_munic_22_pol.fid-703dc0a5_191866d88cb_-bd2,3303609,Paracambi - RJ,29618,40321,10703,41152,71.97,97.98,26.01
sidra_9541_PercMoradDPPOColetTot_munic_22_pol.fid-703dc0a5_191866d88cb_-bd1,3303708,Paraíba do Sul - RJ,31878,40848,8970,41959,75.97,97.35,21.38
sidra_9541_PercMoradDPPOColetTot_munic_22_pol.fid-703dc0a5_191866d88cb_-bd0,3303807,Paraty - RJ,32742,44382,11640,45074,72.64,98.46,25.82
sidra_9541_PercMoradDPPOColetTot_munic_22_pol.fid-703dc0a5_191866d88cb_-bcf,3303856,Paty do Alferes - RJ,14512,28447,13935,29545,49.12,96.28,47.17
sidra_9541_PercMoradDPPOColetTot_munic_22_pol.fid-703dc0a5_191866d88cb_-bce,3303906,Petrópolis - RJ,133354,276796,143442,277958,47.98,99.58,51.61
sidra_9541_PercMoradDPPOColetTot_munic_22_pol.fid-703dc0a5_191866d88cb_-bcd,3303955,Pinheiral - RJ,20047,23961,3914,24264,82.62,98.75,16.13
sidra_9541_PercMoradDPPOColetTot_munic_22_pol.fid-703dc0a5_191866d88cb_-bcc,3304003,Piraí - RJ,20128,26937,6809,27466,73.28,98.07,24.79
sidra_9541_PercMoradDPPOColetTot_munic_22_pol.fid-703dc0a5_191866d88cb_-bcb,3304102,Porciúncula - RJ,13693,15115,1422,17230,79.47,87.72,8.25
sidra_9541_PercMoradDPPOColetTot_munic_22_pol.fid-703dc0a5_191866d88cb_-bca,3304110,Porto Real - RJ,20270,20302,32,20350,99.61,99.76,0.16
sidra_9541_PercMoradDPPOColetTot_munic_22_pol.fid-703dc0a5_191866d88cb_-bc9,3304128,Quatis - RJ,13009,13397,388,13669,95.17,98.01,2.84
sidra_9541_PercMoradDPPOColetTot_munic_22_pol.fid-703dc0a5_191866d88cb_-bc8,3304144,Queimados - RJ,128068,137074,9006,140327,91.26,97.68,6.42
sidra_9541_PercMoradDPPOColetTot_munic_22_pol.fid-703dc0a5_191866d88cb_-bc7,3304151,Quissamã - RJ,21538,21843,305,22334,96.44,97.8,1.37
sidra_9541_PercMoradDPPOColetTot_munic_22_pol.fid-703dc0a5_191866d88cb_-bc6,3304201,Resende - RJ,123523,128073,4550,128808,95.9,99.43,3.53
sidra_9541_PercMoradDPPOColetTot_munic_22_pol.fid-703dc0a5_191866d88cb_-bc5,3304300,Rio Bonito - RJ,52861,54376,1515,56175,94.1,96.8,2.7
sidra_9541_PercMoradDPPOColetTot_munic_22_pol.fid-703dc0a5_191866d88cb_-bc4,3304409,Rio Claro - RJ,10983,16402,5419,17382,63.19,94.36,31.18
sidra_9541_PercMoradDPPOColetTot_munic_22_pol.fid-703dc0a5_191866d88cb_-bc3,3304508,Rio das Flores - RJ,4826,8643,3817,8946,53.95,96.61,42.67
sidra_9541_PercMoradDPPOColetTot_munic_22_pol.fid-703dc0a5_191866d88cb_-bc2,3304524,Rio das Ostras - RJ,151301,155817,4516,156377,96.75,99.64,2.89
sidra_9541_PercMoradDPPOColetTot_munic_22_pol.fid-703dc0a5_191866d88cb_-bc1,3304557,Rio de Janeiro - RJ,4922814,6118035,1195221,6174549,79.73,99.08,19.36
sidra_9541_PercMoradDPPOColetTot_munic_22_pol.fid-703dc0a5_191866d88cb_-bbf,3304607,Santa Maria Madalena - RJ,3235,9542,6307,10198,31.72,93.57,61.85
sidra_9541_PercMoradDPPOColetTot_munic_22_pol.fid-703dc0a5_191866d88cb_-bbd,3304706,Santo Antônio de Pádua - RJ,29498,38671,9173,41195,71.61,93.87,22.27
sidra_9541_PercMoradDPPOColetTot_munic_22_pol.fid-703dc0a5_191866d88cb_-bbc,3304755,São Francisco de Itabapoana - RJ,37732,42258,4526,45034,83.79,93.84,10.05
sidra_9541_PercMoradDPPOColetTot_munic_22_pol.fid-703dc0a5_191866d88cb_-bba,3304805,São Fidélis - RJ,29621,35129,5508,38908,76.13,90.29,14.16
sidra_9541_PercMoradDPPOColetTot_munic_22_pol.fid-703dc0a5_191866d88cb_-bb9,3304904,São Gonçalo - RJ,794146,868094,73948,895610,88.67,96.93,8.26
sidra_9541_PercMoradDPPOColetTot_munic_22_pol.fid-703dc0a5_191866d88cb_-bb8,3305000,São João da Barra - RJ,34989,36138,1149,36492,95.88,99.03,3.15
sidra_9541_PercMoradDPPOColetTot_munic_22_pol.fid-703dc0a5_191866d88cb_-bb7,3305109,São João de Meriti - RJ,421205,434817,13612,440727,95.57,98.66,3.09
sidra_9541_PercMoradDPPOColetTot_munic_22_pol.fid-703dc0a5_191866d88cb_-bb6,3305133,São José de Ubá - RJ,5481,6680,1199,7067,77.56,94.52,16.97
sidra_9541_PercMoradDPPOColetTot_munic_22_pol.fid-703dc0a5_191866d88cb_-bb5,3305158,São José do Vale do Rio Preto - RJ,2265,21825,19560,22069,10.26,98.89,88.63
sidra_9541_PercMoradDPPOColetTot_munic_22_pol.fid-703dc0a5_191866d88cb_-bb4,3305208,São Pedro da Aldeia - RJ,97114,101503,4389,103868,93.5,97.72,4.23
sidra_9541_PercMoradDPPOColetTot_munic_22_pol.fid-703dc0a5_191866d88cb_-bb3,3305307,São Sebastião do Alto - RJ,3497,6774,3277,7742,45.17,87.5,42.33
sidra_9541_PercMoradDPPOColetTot_munic_22_pol.fid-703dc0a5_191866d88cb_-bb2,3305406,Sapucaia - RJ,7477,16619,9142,17701,42.24,93.89,51.65
sidra_9541_PercMoradDPPOColetTot_munic_22_pol.fid-703dc0a5_191866d88cb_-bb1,3305505,Saquarema - RJ,83114,87150,4036,89266,93.11,97.63,4.52
sidra_9541_PercMoradDPPOColetTot_munic_22_pol.fid-703dc0a5_191866d88cb_-bb0,3305554,Seropédica - RJ,74636,77634,2998,79896,93.42,97.17,3.75
sidra_9541_PercMoradDPPOColetTot_munic_22_pol.fid-703dc0a5_191866d88cb_-baf,3305604,Silva Jardim - RJ,19924,20433,509,21303,93.53,95.92,2.39
sidra_9541_PercMoradDPPOColetTot_munic_22_pol.fid-703dc0a5_191866d88cb_-bae,3305703,Sumidouro - RJ,7610,14602,6992,15195,50.08,96.1,46.02
sidra_9541_PercMoradDPPOColetTot_munic_22_pol.fid-703dc0a5_191866d88cb_-bad,3305752,Tanguá - RJ,30084,30458,374,31008,97.02,98.23,1.21
sidra_9541_PercMoradDPPOColetTot_munic_22_pol.fid-703dc0a5_191866d88cb_-bac,3305802,Teresópolis - RJ,124046,162423,38377,164749,75.29,98.59,23.29
sidra_9541_PercMoradDPPOColetTot_munic_22_pol.fid-703dc0a5_191866d88cb_-bab,3305901,Trajano de Moraes - RJ,3729,8755,5026,10248,36.39,85.43,49.04
sidra_9541_PercMoradDPPOColetTot_munic_22_pol.fid-703dc0a5_191866d88cb_-baa,3306008,Três Rios - RJ,65362,77253,11891,78227,83.55,98.75,15.2
sidra_9541_PercMoradDPPOColetTot_munic_22_pol.fid-703dc0a5_191866d88cb_-ba9,3500501,Águas de Lindóia - SP,16777,17667,890,17806,94.22,99.22,5
sidra_9541_PercMoradDPPOColetTot_munic_22_pol.fid-703dc0a5_191866d88cb_-ba8,3500550,Águas de Santa Bárbara - SP,6586,6927,341,7162,91.96,96.72,4.76
sidra_9541_PercMoradDPPOColetTot_munic_22_pol.fid-703dc0a5_191866d88cb_-ba7,4302501,Bossoroca - RS,3682,3901,219,5887,62.54,66.26,3.72
sidra_9541_PercMoradDPPOColetTot_munic_22_pol.fid-703dc0a5_191866d88cb_-ba6,4302584,Bozano - RS,371,1347,976,2150,17.26,62.65,45.4
sidra_9541_PercMoradDPPOColetTot_munic_22_pol.fid-703dc0a5_191866d88cb_-ba5,4302600,Braga - RS,2409,2421,12,3258,73.94,74.31,0.37
sidra_9541_PercMoradDPPOColetTot_munic_22_pol.fid-703dc0a5_191866d88cb_-ba4,3501509,Alvinlândia - SP,2757,2863,106,2885,95.56,99.24,3.67
sidra_9541_PercMoradDPPOColetTot_munic_22_pol.fid-703dc0a5_191866d88cb_-ba3,3501608,Americana - SP,225340,236319,10979,236515,95.28,99.92,4.64
sidra_9541_PercMoradDPPOColetTot_munic_22_pol.fid-703dc0a5_191866d88cb_-ba2,3501707,Américo Brasiliense - SP,32788,32879,91,32920,99.6,99.88,0.28
sidra_9541_PercMoradDPPOColetTot_munic_22_pol.fid-703dc0a5_191866d88cb_-ba1,3501806,Américo de Campos - SP,5246,5443,197,5868,89.4,92.76,3.36
sidra_9541_PercMoradDPPOColetTot_munic_22_pol.fid-703dc0a5_191866d88cb_-ba0,3501905,Amparo - SP,59485,66946,7461,67683,87.89,98.91,11.02
sidra_9541_PercMoradDPPOColetTot_munic_22_pol.fid-703dc0a5_191866d88cb_-b9f,3502002,Analândia - SP,3986,4309,323,4580,87.03,94.08,7.05
sidra_9541_PercMoradDPPOColetTot_munic_22_pol.fid-703dc0a5_191866d88cb_-b9e,3502101,Andradina - SP,55308,55849,541,57887,95.54,96.48,0.93
sidra_9541_PercMoradDPPOColetTot_munic_22_pol.fid-703dc0a5_191866d88cb_-b9d,3502200,Angatuba - SP,21554,22054,500,23956,89.97,92.06,2.09
sidra_9541_PercMoradDPPOColetTot_munic_22_pol.fid-703dc0a5_191866d88cb_-b9c,3502309,Anhembi - SP,4948,5480,532,5654,87.51,96.92,9.41
sidra_9541_PercMoradDPPOColetTot_munic_22_pol.fid-703dc0a5_191866d88cb_-b9b,3502408,Anhumas - SP,3587,3718,131,4001,89.65,92.93,3.27
sidra_9541_PercMoradDPPOColetTot_munic_22_pol.fid-703dc0a5_191866d88cb_-b9a,3502507,Aparecida - SP,26407,31926,5519,32345,81.64,98.7,17.06
sidra_9541_PercMoradDPPOColetTot_munic_22_pol.fid-703dc0a5_191866d88cb_-b99,3502606,Aparecida d'Oeste - SP,3535,3784,249,4064,86.98,93.11,6.13
sidra_9541_PercMoradDPPOColetTot_munic_22_pol.fid-703dc0a5_191866d88cb_-b98,3502705,Apiaí - SP,20905,22781,1876,24492,85.35,93.01,7.66
sidra_9541_PercMoradDPPOColetTot_munic_22_pol.fid-703dc0a5_191866d88cb_-b97,3502754,Araçariguama - SP,19191,20502,1311,21462,89.42,95.53,6.11
sidra_9541_PercMoradDPPOColetTot_munic_22_pol.fid-703dc0a5_191866d88cb_-b96,3502804,Araçatuba - SP,187055,198243,11188,199537,93.74,99.35,5.61
sidra_9541_PercMoradDPPOColetTot_munic_22_pol.fid-703dc0a5_191866d88cb_-b95,3502903,Araçoiaba da Serra - SP,26831,32066,5235,32325,83,99.2,16.19
sidra_9541_PercMoradDPPOColetTot_munic_22_pol.fid-703dc0a5_191866d88cb_-b94,3503000,Aramina - SP,5116,5302,186,5405,94.65,98.09,3.44
sidra_9541_PercMoradDPPOColetTot_munic_22_pol.fid-703dc0a5_191866d88cb_-b93,3503109,Arandu - SP,6405,6650,245,6824,93.86,97.45,3.59
sidra_9541_PercMoradDPPOColetTot_munic_22_pol.fid-703dc0a5_191866d88cb_-b92,3503158,Arapeí - SP,1921,2259,338,2330,82.45,96.95,14.51
sidra_9541_PercMoradDPPOColetTot_munic_22_pol.fid-703dc0a5_191866d88cb_-b91,3503208,Araraquara - SP,233669,239388,5719,240422,97.19,99.57,2.38
sidra_9541_PercMoradDPPOColetTot_munic_22_pol.fid-703dc0a5_191866d88cb_-b90,3503307,Araras - SP,126738,129784,3046,130528,97.1,99.43,2.33
sidra_9541_PercMoradDPPOColetTot_munic_22_pol.fid-703dc0a5_191866d88cb_-b8f,3503356,Arco-Íris - SP,1572,1692,120,2044,76.91,82.78,5.87
sidra_9541_PercMoradDPPOColetTot_munic_22_pol.fid-703dc0a5_191866d88cb_-b8e,3503406,Arealva - SP,6482,7537,1055,8095,80.07,93.11,13.03
sidra_9541_PercMoradDPPOColetTot_munic_22_pol.fid-703dc0a5_191866d88cb_-b8d,3503505,Areias - SP,3129,3343,214,3507,89.22,95.32,6.1
sidra_9541_PercMoradDPPOColetTot_munic_22_pol.fid-703dc0a5_191866d88cb_-b8c,3503604,Areiópolis - SP,9919,9965,46,10113,98.08,98.54,0.45
sidra_9541_PercMoradDPPOColetTot_munic_22_pol.fid-703dc0a5_191866d88cb_-b8b,3503703,Ariranha - SP,7446,7514,68,7596,98.03,98.92,0.9
sidra_9541_PercMoradDPPOColetTot_munic_22_pol.fid-703dc0a5_191866d88cb_-b8a,3503802,Artur Nogueira - SP,46795,50966,4171,51419,91.01,99.12,8.11
sidra_9541_PercMoradDPPOColetTot_munic_22_pol.fid-703dc0a5_191866d88cb_-b89,3503901,Arujá - SP,84381,86197,1816,86567,97.47,99.57,2.1
sidra_9541_PercMoradDPPOColetTot_munic_22_pol.fid-703dc0a5_191866d88cb_-b88,3503950,Aspásia - SP,1482,1615,133,1839,80.59,87.82,7.23
sidra_9541_PercMoradDPPOColetTot_munic_22_pol.fid-703dc0a5_191866d88cb_-b87,3504008,Assis - SP,96284,98812,2528,99861,96.42,98.95,2.53
sidra_9541_PercMoradDPPOColetTot_munic_22_pol.fid-703dc0a5_191866d88cb_-b86,3504107,Atibaia - SP,144620,156753,12133,157804,91.65,99.33,7.69
sidra_9541_PercMoradDPPOColetTot_munic_22_pol.fid-703dc0a5_191866d88cb_-b85,3504206,Auriflama - SP,12410,13152,742,13662,90.84,96.27,5.43
sidra_9541_PercMoradDPPOColetTot_munic_22_pol.fid-703dc0a5_191866d88cb_-b84,3504305,Avaí - SP,3755,4174,419,4483,83.76,93.11,9.35
sidra_9541_PercMoradDPPOColetTot_munic_22_pol.fid-703dc0a5_191866d88cb_-b83,3504404,Avanhandava - SP,9607,9624,17,9981,96.25,96.42,0.17
sidra_9541_PercMoradDPPOColetTot_munic_22_pol.fid-703dc0a5_191866d88cb_-b82,3504503,Avaré - SP,85484,89000,3516,90558,94.4,98.28,3.88
sidra_9541_PercMoradDPPOColetTot_munic_22_pol.fid-703dc0a5_191866d88cb_-b80,3504602,Bady Bassitt - SP,26477,26939,462,27248,97.17,98.87,1.7
sidra_9541_PercMoradDPPOColetTot_munic_22_pol.fid-703dc0a5_191866d88cb_-b7f,4312609,Muçum - RS,4430,4484,54,4566,97.02,98.2,1.18
sidra_9541_PercMoradDPPOColetTot_munic_22_pol.fid-703dc0a5_191866d88cb_-b7e,4312617,Muitos Capões - RS,35,2322,2287,2878,1.22,80.68,79.46
sidra_9541_PercMoradDPPOColetTot_munic_22_pol.fid-703dc0a5_191866d88cb_-b7d,3504701,Balbinos - SP,1291,1305,14,1368,94.37,95.39,1.02
sidra_9541_PercMoradDPPOColetTot_munic_22_pol.fid-703dc0a5_191866d88cb_-b7c,3507308,Boracéia - SP,4528,4582,54,4715,96.03,97.18,1.15
sidra_9541_PercMoradDPPOColetTot_munic_22_pol.fid-703dc0a5_191866d88cb_-b7b,3507407,Borborema - SP,13202,13381,179,14187,93.06,94.32,1.26
sidra_9541_PercMoradDPPOColetTot_munic_22_pol.fid-703dc0a5_191866d88cb_-b7a,3507456,Borebi - SP,2508,2586,78,2713,92.44,95.32,2.88
sidra_9541_PercMoradDPPOColetTot_munic_22_pol.fid-703dc0a5_191866d88cb_-b79,3507506,Botucatu - SP,138234,143742,5508,144654,95.56,99.37,3.81
sidra_9541_PercMoradDPPOColetTot_munic_22_pol.fid-703dc0a5_191866d88cb_-b78,3507605,Bragança Paulista - SP,163508,175895,12387,176393,92.7,99.72,7.02
sidra_9541_PercMoradDPPOColetTot_munic_22_pol.fid-703dc0a5_191866d88cb_-b77,3504800,Bálsamo - SP,9273,9393,120,9595,96.64,97.89,1.25
sidra_9541_PercMoradDPPOColetTot_munic_22_pol.fid-703dc0a5_191866d88cb_-b76,3504909,Bananal - SP,8337,9583,1246,9942,83.86,96.39,12.53
sidra_9541_PercMoradDPPOColetTot_munic_22_pol.fid-703dc0a5_191866d88cb_-b75,3505005,Barão de Antonina - SP,2239,3474,1235,3498,64.01,99.31,35.31
sidra_9541_PercMoradDPPOColetTot_munic_22_pol.fid-703dc0a5_191866d88cb_-b74,3505104,Barbosa - SP,5123,5285,162,5639,90.85,93.72,2.87
sidra_9541_PercMoradDPPOColetTot_munic_22_pol.fid-703dc0a5_191866d88cb_-b73,3505203,Bariri - SP,30494,30955,461,31541,96.68,98.14,1.46
sidra_9541_PercMoradDPPOColetTot_munic_22_pol.fid-703dc0a5_191866d88cb_-b72,3507704,Braúna - SP,4920,5050,130,5355,91.88,94.3,2.43
sidra_9541_PercMoradDPPOColetTot_munic_22_pol.fid-703dc0a5_191866d88cb_-b71,3505302,Barra Bonita - SP,33352,34028,676,34249,97.38,99.35,1.97
sidra_9541_PercMoradDPPOColetTot_munic_22_pol.fid-703dc0a5_191866d88cb_-b70,3505351,Barra do Chapéu - SP,4274,4519,245,5179,82.53,87.26,4.73
sidra_9541_PercMoradDPPOColetTot_munic_22_pol.fid-703dc0a5_191866d88cb_-b6f,3505401,Barra do Turvo - SP,5727,6217,490,6867,83.4,90.53,7.14
sidra_9541_PercMoradDPPOColetTot_munic_22_pol.fid-703dc0a5_191866d88cb_-b6e,3505500,Barretos - SP,118889,119915,1026,121957,97.48,98.33,0.84
sidra_9541_PercMoradDPPOColetTot_munic_22_pol.fid-703dc0a5_191866d88cb_-b6d,3505609,Barrinha - SP,31892,32012,120,32086,99.4,99.77,0.37
sidra_9541_PercMoradDPPOColetTot_munic_22_pol.fid-703dc0a5_191866d88cb_-b6c,3505708,Barueri - SP,161639,316168,154529,316252,51.11,99.97,48.86
sidra_9541_PercMoradDPPOColetTot_munic_22_pol.fid-703dc0a5_191866d88cb_-b6b,3505807,Bastos - SP,17980,19841,1861,21489,83.67,92.33,8.66
sidra_9541_PercMoradDPPOColetTot_munic_22_pol.fid-703dc0a5_191866d88cb_-b6a,3505906,Batatais - SP,55901,57190,1289,58228,96,98.22,2.21
sidra_9541_PercMoradDPPOColetTot_munic_22_pol.fid-703dc0a5_191866d88cb_-b69,3506003,Bauru - SP,351117,369184,18067,371471,94.52,99.38,4.86
sidra_9541_PercMoradDPPOColetTot_munic_22_pol.fid-703dc0a5_191866d88cb_-b68,3506102,Bebedouro - SP,74053,74874,821,76121,97.28,98.36,1.08
sidra_9541_PercMoradDPPOColetTot_munic_22_pol.fid-703dc0a5_191866d88cb_-b67,3506201,Bento de Abreu - SP,2508,2508,,2605,96.28,96.28,
sidra_9541_PercMoradDPPOColetTot_munic_22_pol.fid-703dc0a5_191866d88cb_-b66,3506300,Bernardino de Campos - SP,9679,10214,535,10544,91.8,96.87,5.07
sidra_9541_PercMoradDPPOColetTot_munic_22_pol.fid-703dc0a5_191866d88cb_-b65,3506359,Bertioga - SP,56156,63616,7460,63985,87.76,99.42,11.66
sidra_9541_PercMoradDPPOColetTot_munic_22_pol.fid-703dc0a5_191866d88cb_-b64,3506409,Bilac - SP,6991,7068,77,7286,95.95,97.01,1.06
sidra_9541_PercMoradDPPOColetTot_munic_22_pol.fid-703dc0a5_191866d88cb_-b63,3506508,Birigui - SP,116578,117415,837,118612,98.29,98.99,0.71
sidra_9541_PercMoradDPPOColetTot_munic_22_pol.fid-703dc0a5_191866d88cb_-b61,3506607,Biritiba Mirim - SP,26296,28344,2048,29623,88.77,95.68,6.91
sidra_9541_PercMoradDPPOColetTot_munic_22_pol.fid-703dc0a5_191866d88cb_-b60,3506706,Boa Esperança do Sul - SP,12313,12591,278,12945,95.12,97.27,2.15
sidra_9541_PercMoradDPPOColetTot_munic_22_pol.fid-703dc0a5_191866d88cb_-b5f,3506805,Bocaina - SP,10754,10994,240,11234,95.73,97.86,2.14
sidra_9541_PercMoradDPPOColetTot_munic_22_pol.fid-703dc0a5_191866d88cb_-b5e,3506904,Bofete - SP,7848,10275,2427,10445,75.14,98.37,23.24
sidra_9541_PercMoradDPPOColetTot_munic_22_pol.fid-703dc0a5_191866d88cb_-b5d,3507001,Boituva - SP,53953,60884,6931,61028,88.41,99.76,11.36
sidra_9541_PercMoradDPPOColetTot_munic_22_pol.fid-703dc0a5_191866d88cb_-b5c,3507100,Bom Jesus dos Perdões - SP,19881,21780,1899,21929,90.66,99.32,8.66
sidra_9541_PercMoradDPPOColetTot_munic_22_pol.fid-703dc0a5_191866d88cb_-b5b,3509809,Campos Novos Paulista - SP,4340,4479,139,4870,89.12,91.97,2.85
sidra_9541_PercMoradDPPOColetTot_munic_22_pol.fid-703dc0a5_191866d88cb_-b5a,3509908,Cananéia - SP,11119,11753,634,12231,90.91,96.09,5.18
sidra_9541_PercMoradDPPOColetTot_munic_22_pol.fid-703dc0a5_191866d88cb_-b59,3507159,Bom Sucesso de Itararé - SP,3470,3510,40,3554,97.64,98.76,1.13
sidra_9541_PercMoradDPPOColetTot_munic_22_pol.fid-703dc0a5_191866d88cb_-b58,3507209,Borá - SP,810,828,18,907,89.31,91.29,1.98
sidra_9541_PercMoradDPPOColetTot_munic_22_pol.fid-703dc0a5_191866d88cb_-b57,3515301,Estrela do Norte - SP,2233,2252,19,2703,82.61,83.31,0.7
sidra_9541_PercMoradDPPOColetTot_munic_22_pol.fid-703dc0a5_191866d88cb_-b56,3507753,Brejo Alegre - SP,2470,2471,1,2530,97.63,97.67,0.04
sidra_9541_PercMoradDPPOColetTot_munic_22_pol.fid-703dc0a5_191866d88cb_-b55,3507803,Brodowski - SP,24370,24882,512,25157,96.87,98.91,2.04
sidra_9541_PercMoradDPPOColetTot_munic_22_pol.fid-703dc0a5_191866d88cb_-b54,3507902,Brotas - SP,22665,23240,575,23799,95.24,97.65,2.42
sidra_9541_PercMoradDPPOColetTot_munic_22_pol.fid-703dc0a5_191866d88cb_-b53,3508009,Buri - SP,17079,18526,1447,20225,84.44,91.6,7.15
sidra_9541_PercMoradDPPOColetTot_munic_22_pol.fid-703dc0a5_191866d88cb_-b52,3508108,Buritama - SP,16445,16642,197,17132,95.99,97.14,1.15
sidra_9541_PercMoradDPPOColetTot_munic_22_pol.fid-703dc0a5_191866d88cb_-b51,3508207,Buritizal - SP,3782,4097,315,4347,87,94.25,7.25
sidra_9541_PercMoradDPPOColetTot_munic_22_pol.fid-703dc0a5_191866d88cb_-b50,3508306,Cabrália Paulista - SP,3742,3761,19,4288,87.27,87.71,0.44
sidra_9541_PercMoradDPPOColetTot_munic_22_pol.fid-703dc0a5_191866d88cb_-b4f,3508405,Cabreúva - SP,10649,46686,36037,46900,22.71,99.54,76.84
sidra_9541_PercMoradDPPOColetTot_munic_22_pol.fid-703dc0a5_191866d88cb_-b4e,3508504,Caçapava - SP,92167,95495,3328,95943,96.06,99.53,3.47
sidra_9541_PercMoradDPPOColetTot_munic_22_pol.fid-703dc0a5_191866d88cb_-b4d,3508603,Cachoeira Paulista - SP,30495,31154,659,31504,96.8,98.89,2.09
sidra_9541_PercMoradDPPOColetTot_munic_22_pol.fid-703dc0a5_191866d88cb_-b4c,3508702,Caconde - SP,11830,15783,3953,17018,69.51,92.74,23.23
sidra_9541_PercMoradDPPOColetTot_munic_22_pol.fid-703dc0a5_191866d88cb_-b4b,3508801,Cafelândia - SP,15511,15689,178,16615,93.36,94.43,1.07
sidra_9541_PercMoradDPPOColetTot_munic_22_pol.fid-703dc0a5_191866d88cb_-b4a,3508900,Caiabu - SP,3352,3374,22,3712,90.3,90.89,0.59
sidra_9541_PercMoradDPPOColetTot_munic_22_pol.fid-703dc0a5_191866d88cb_-b49,3509007,Caieiras - SP,87977,94548,6571,94759,92.84,99.78,6.93
sidra_9541_PercMoradDPPOColetTot_munic_22_pol.fid-703dc0a5_191866d88cb_-b48,3509106,Caiuá - SP,2687,2765,78,4314,62.29,64.09,1.81
sidra_9541_PercMoradDPPOColetTot_munic_22_pol.fid-703dc0a5_191866d88cb_-b47,3509205,Cajamar - SP,77939,92191,14252,92567,84.2,99.59,15.4
sidra_9541_PercMoradDPPOColetTot_munic_22_pol.fid-703dc0a5_191866d88cb_-b46,3509254,Cajati - SP,26829,27856,1027,28511,94.1,97.7,3.6
sidra_9541_PercMoradDPPOColetTot_munic_22_pol.fid-703dc0a5_191866d88cb_-b45,3509304,Cajobi - SP,8690,8856,166,9127,95.21,97.03,1.82
sidra_9541_PercMoradDPPOColetTot_munic_22_pol.fid-703dc0a5_191866d88cb_-b44,3509403,Cajuru - SP,21109,22680,1571,23773,88.79,95.4,6.61
sidra_9541_PercMoradDPPOColetTot_munic_22_pol.fid-703dc0a5_191866d88cb_-b43,3509452,Campina do Monte Alegre - SP,5678,5831,153,5946,95.49,98.07,2.57
sidra_9541_PercMoradDPPOColetTot_munic_22_pol.fid-703dc0a5_191866d88cb_-b42,3509502,Campinas - SP,993654,1132061,138407,1134878,87.56,99.75,12.2
sidra_9541_PercMoradDPPOColetTot_munic_22_pol.fid-703dc0a5_191866d88cb_-b41,3509601,Campo Limpo Paulista - SP,75604,76930,1326,77186,97.95,99.67,1.72
sidra_9541_PercMoradDPPOColetTot_munic_22_pol.fid-703dc0a5_191866d88cb_-b40,3509700,Campos do Jordão - SP,36584,46472,9888,46610,78.49,99.7,21.21
sidra_9541_PercMoradDPPOColetTot_munic_22_pol.fid-703dc0a5_191866d88cb_-b3f,3509957,Canas - SP,4712,4806,94,4913,95.91,97.82,1.91
sidra_9541_PercMoradDPPOColetTot_munic_22_pol.fid-703dc0a5_191866d88cb_-b3e,3510005,Cândido Mota - SP,28132,28700,568,29386,95.73,97.67,1.93
sidra_9541_PercMoradDPPOColetTot_munic_22_pol.fid-703dc0a5_191866d88cb_-b3d,3510104,Cândido Rodrigues - SP,2606,2639,33,2876,90.61,91.76,1.15
sidra_9541_PercMoradDPPOColetTot_munic_22_pol.fid-703dc0a5_191866d88cb_-b3c,3515707,Ferraz de Vasconcelos - SP,165949,177260,11311,178297,93.07,99.42,6.34
sidra_9541_PercMoradDPPOColetTot_munic_22_pol.fid-703dc0a5_191866d88cb_-b3b,3515806,Flora Rica - SP,1262,1262,,1487,84.87,84.87,
sidra_9541_PercMoradDPPOColetTot_munic_22_pol.fid-703dc0a5_191866d88cb_-b3a,3515905,Floreal - SP,2404,2551,147,2733,87.96,93.34,5.38
sidra_9541_PercMoradDPPOColetTot_munic_22_pol.fid-703dc0a5_191866d88cb_-b39,3516002,Flórida Paulista - SP,10681,10890,209,11561,92.39,94.2,1.81
sidra_9541_PercMoradDPPOColetTot_munic_22_pol.fid-703dc0a5_191866d88cb_-b38,4121307,Rancho Alegre - PR,3214,3305,91,3512,91.51,94.11,2.59
sidra_9541_PercMoradDPPOColetTot_munic_22_pol.fid-703dc0a5_191866d88cb_-b37,4121356,Rancho Alegre D'Oeste - PR,2290,2290,,2618,87.47,87.47,
sidra_9541_PercMoradDPPOColetTot_munic_22_pol.fid-703dc0a5_191866d88cb_-b36,4121406,Realeza - PR,15610,16623,1013,19211,81.26,86.53,5.27
sidra_9541_PercMoradDPPOColetTot_munic_22_pol.fid-703dc0a5_191866d88cb_-b35,4121505,Rebouças - PR,10538,10717,179,14503,72.66,73.9,1.23
sidra_9541_PercMoradDPPOColetTot_munic_22_pol.fid-703dc0a5_191866d88cb_-b34,4121604,Renascença - PR,4869,5046,177,6845,71.13,73.72,2.59
sidra_9541_PercMoradDPPOColetTot_munic_22_pol.fid-703dc0a5_191866d88cb_-b33,4121703,Reserva - PR,18942,19140,198,24441,77.5,78.31,0.81
sidra_9541_PercMoradDPPOColetTot_munic_22_pol.fid-703dc0a5_191866d88cb_-b32,3510153,Canitar - SP,5915,6218,303,6281,94.17,99,4.82
sidra_9541_PercMoradDPPOColetTot_munic_22_pol.fid-703dc0a5_191866d88cb_-b31,3510203,Capão Bonito - SP,43677,44208,531,46202,94.53,95.68,1.15
sidra_9541_PercMoradDPPOColetTot_munic_22_pol.fid-703dc0a5_191866d88cb_-b30,3510302,Capela do Alto - SP,2770,20461,17691,20621,13.43,99.22,85.79
sidra_9541_PercMoradDPPOColetTot_munic_22_pol.fid-703dc0a5_191866d88cb_-b2f,3510401,Capivari - SP,44852,49758,4906,50009,89.69,99.5,9.81
sidra_9541_PercMoradDPPOColetTot_munic_22_pol.fid-703dc0a5_191866d88cb_-b2e,3510500,Caraguatatuba - SP,129736,133210,3474,133875,96.91,99.5,2.59
sidra_9541_PercMoradDPPOColetTot_munic_22_pol.fid-703dc0a5_191866d88cb_-b2d,3510609,Carapicuíba - SP,357635,386240,28605,386633,92.5,99.9,7.4
sidra_9541_PercMoradDPPOColetTot_munic_22_pol.fid-703dc0a5_191866d88cb_-b2c,3510708,Cardoso - SP,10437,10944,507,11312,92.26,96.75,4.48
sidra_9541_PercMoradDPPOColetTot_munic_22_pol.fid-703dc0a5_191866d88cb_-b2b,3510807,Casa Branca - SP,23984,25142,1158,26456,90.66,95.03,4.38
sidra_9541_PercMoradDPPOColetTot_munic_22_pol.fid-703dc0a5_191866d88cb_-b2a,3510906,Cássia dos Coqueiros - SP,2214,2560,346,2788,79.41,91.82,12.41
sidra_9541_PercMoradDPPOColetTot_munic_22_pol.fid-703dc0a5_191866d88cb_-b29,3511003,Castilho - SP,15428,17308,1880,19788,77.97,87.47,9.5
sidra_9541_PercMoradDPPOColetTot_munic_22_pol.fid-703dc0a5_191866d88cb_-b28,3511102,Catanduva - SP,112064,115038,2974,115591,96.95,99.52,2.57
sidra_9541_PercMoradDPPOColetTot_munic_22_pol.fid-703dc0a5_191866d88cb_-b27,3516606,Gália - SP,5385,5885,500,6350,84.8,92.68,7.87
sidra_9541_PercMoradDPPOColetTot_munic_22_pol.fid-703dc0a5_191866d88cb_-b26,3516705,Garça - SP,40728,41017,289,41937,97.12,97.81,0.69
sidra_9541_PercMoradDPPOColetTot_munic_22_pol.fid-703dc0a5_191866d88cb_-b25,3516804,Gastão Vidigal - SP,3040,3157,117,3244,93.71,97.32,3.61
sidra_9541_PercMoradDPPOColetTot_munic_22_pol.fid-703dc0a5_191866d88cb_-b24,3516853,Gavião Peixoto - SP,4518,4595,77,4700,96.13,97.77,1.64
sidra_9541_PercMoradDPPOColetTot_munic_22_pol.fid-703dc0a5_191866d88cb_-b23,3516903,General Salgado - SP,9422,9778,356,10265,91.79,95.26,3.47
sidra_9541_PercMoradDPPOColetTot_munic_22_pol.fid-703dc0a5_191866d88cb_-b22,3517000,Getulina - SP,7973,8379,406,8965,88.93,93.46,4.53
sidra_9541_PercMoradDPPOColetTot_munic_22_pol.fid-703dc0a5_191866d88cb_-b21,3517109,Glicério - SP,3883,3909,26,4124,94.16,94.79,0.63
sidra_9541_PercMoradDPPOColetTot_munic_22_pol.fid-703dc0a5_191866d88cb_-b20,3517208,Guaiçara - SP,10606,11047,441,11237,94.38,98.31,3.92
sidra_9541_PercMoradDPPOColetTot_munic_22_pol.fid-703dc0a5_191866d88cb_-b1f,3517307,Guaimbê - SP,5047,5191,144,5508,91.63,94.24,2.61
sidra_9541_PercMoradDPPOColetTot_munic_22_pol.fid-703dc0a5_191866d88cb_-b1e,3517406,Guaíra - SP,38130,38331,201,39197,97.28,97.79,0.51
sidra_9541_PercMoradDPPOColetTot_munic_22_pol.fid-703dc0a5_191866d88cb_-b1d,3517505,Guapiaçu - SP,20719,20850,131,21657,95.67,96.27,0.6
sidra_9541_PercMoradDPPOColetTot_munic_22_pol.fid-703dc0a5_191866d88cb_-b1c,3517604,Guapiara - SP,14038,15411,1373,17056,82.31,90.36,8.05
sidra_9541_PercMoradDPPOColetTot_munic_22_pol.fid-703dc0a5_191866d88cb_-b1b,3517703,Guará - SP,17907,18164,257,18561,96.48,97.86,1.38
sidra_9541_PercMoradDPPOColetTot_munic_22_pol.fid-703dc0a5_191866d88cb_-b1a,3517802,Guaraçaí - SP,6186,6381,195,7418,83.39,86.02,2.63
sidra_9541_PercMoradDPPOColetTot_munic_22_pol.fid-703dc0a5_191866d88cb_-b19,3517901,Guaraci - SP,9509,9883,374,10313,92.2,95.83,3.63
sidra_9541_PercMoradDPPOColetTot_munic_22_pol.fid-703dc0a5_191866d88cb_-b18,4121752,Reserva do Iguaçu - PR,4830,5374,544,6543,73.82,82.13,8.31
sidra_9541_PercMoradDPPOColetTot_munic_22_pol.fid-703dc0a5_191866d88cb_-b17,4121802,Ribeirão Claro - PR,9633,11947,2314,12330,78.13,96.89,18.77
sidra_9541_PercMoradDPPOColetTot_munic_22_pol.fid-703dc0a5_191866d88cb_-b16,4121901,Ribeirão do Pinhal - PR,12035,12377,342,12959,92.87,95.51,2.64
sidra_9541_PercMoradDPPOColetTot_munic_22_pol.fid-703dc0a5_191866d88cb_-b15,4122008,Rio Azul - PR,7199,11233,4034,13933,51.67,80.62,28.95
sidra_9541_PercMoradDPPOColetTot_munic_22_pol.fid-703dc0a5_191866d88cb_-b14,4122107,Rio Bom - PR,2494,2675,181,3155,79.05,84.79,5.74
sidra_9541_PercMoradDPPOColetTot_munic_22_pol.fid-703dc0a5_191866d88cb_-b12,4122156,Rio Bonito do Iguaçu - PR,5548,5922,374,13911,39.88,42.57,2.69
sidra_9541_PercMoradDPPOColetTot_munic_22_pol.fid-703dc0a5_191866d88cb_-b11,4122172,Rio Branco do Ivaí - PR,2491,2668,177,3803,65.5,70.16,4.65
sidra_9541_PercMoradDPPOColetTot_munic_22_pol.fid-703dc0a5_191866d88cb_-b10,4122206,Rio Branco do Sul - PR,32721,33572,851,37481,87.3,89.57,2.27
sidra_9541_PercMoradDPPOColetTot_munic_22_pol.fid-703dc0a5_191866d88cb_-b0f,4122305,Rio Negro - PR,27852,29738,1886,31209,89.24,95.29,6.04
sidra_9541_PercMoradDPPOColetTot_munic_22_pol.fid-703dc0a5_191866d88cb_-b0e,4122404,Rolândia - PR,69040,69798,758,71189,96.98,98.05,1.06
sidra_9541_PercMoradDPPOColetTot_munic_22_pol.fid-703dc0a5_191866d88cb_-b0d,3511201,Catiguá - SP,6778,6867,89,6991,96.95,98.23,1.27
sidra_9541_PercMoradDPPOColetTot_munic_22_pol.fid-703dc0a5_191866d88cb_-b0c,3511300,Cedral - SP,11891,11952,61,12560,94.67,95.16,0.49
sidra_9541_PercMoradDPPOColetTot_munic_22_pol.fid-703dc0a5_191866d88cb_-b0b,3511409,Cerqueira César - SP,18485,19286,801,20257,91.25,95.21,3.95
sidra_9541_PercMoradDPPOColetTot_munic_22_pol.fid-703dc0a5_191866d88cb_-b0a,3511508,Cerquilho - SP,43415,44290,875,44533,97.49,99.45,1.96
sidra_9541_PercMoradDPPOColetTot_munic_22_pol.fid-703dc0a5_191866d88cb_-b09,3511607,Cesário Lange - SP,17527,17696,169,17948,97.65,98.6,0.94
sidra_9541_PercMoradDPPOColetTot_munic_22_pol.fid-703dc0a5_191866d88cb_-b08,3511706,Charqueada - SP,15259,15375,116,15529,98.26,99.01,0.75
sidra_9541_PercMoradDPPOColetTot_munic_22_pol.fid-703dc0a5_191866d88cb_-b07,3511904,Clementina - SP,6734,6797,63,6963,96.71,97.62,0.9
sidra_9541_PercMoradDPPOColetTot_munic_22_pol.fid-703dc0a5_191866d88cb_-b06,3512001,Colina - SP,17752,17832,80,18444,96.25,96.68,0.43
sidra_9541_PercMoradDPPOColetTot_munic_22_pol.fid-703dc0a5_191866d88cb_-b05,3512100,Colômbia - SP,5626,5677,51,6394,87.99,88.79,0.8
sidra_9541_PercMoradDPPOColetTot_munic_22_pol.fid-703dc0a5_191866d88cb_-b04,3512209,Conchal - SP,26787,27563,776,28039,95.53,98.3,2.77
sidra_9541_PercMoradDPPOColetTot_munic_22_pol.fid-703dc0a5_191866d88cb_-b03,3512308,Conchas - SP,12926,14177,1251,15163,85.25,93.5,8.25
sidra_9541_PercMoradDPPOColetTot_munic_22_pol.fid-703dc0a5_191866d88cb_-b02,3518800,Guarulhos - SP,1211729,1274940,63211,1284053,94.37,99.29,4.92
sidra_9541_PercMoradDPPOColetTot_munic_22_pol.fid-703dc0a5_191866d88cb_-b01,3518859,Guatapará - SP,6708,6730,22,7275,92.21,92.51,0.3
sidra_9541_PercMoradDPPOColetTot_munic_22_pol.fid-703dc0a5_191866d88cb_-b00,3518909,Guzolândia - SP,3761,4044,283,4244,88.62,95.29,6.67
sidra_9541_PercMoradDPPOColetTot_munic_22_pol.fid-703dc0a5_191866d88cb_-aff,3519006,Herculândia - SP,8414,8534,120,9112,92.34,93.66,1.32
sidra_9541_PercMoradDPPOColetTot_munic_22_pol.fid-703dc0a5_191866d88cb_-afe,4122503,Roncador - PR,8462,8641,179,11212,75.47,77.07,1.6
sidra_9541_PercMoradDPPOColetTot_munic_22_pol.fid-703dc0a5_191866d88cb_-afd,3512407,Cordeirópolis - SP,23656,24270,614,24477,96.65,99.15,2.51
sidra_9541_PercMoradDPPOColetTot_munic_22_pol.fid-703dc0a5_191866d88cb_-afc,3512506,Coroados - SP,5123,5161,38,5399,94.89,95.59,0.7
sidra_9541_PercMoradDPPOColetTot_munic_22_pol.fid-703dc0a5_191866d88cb_-afb,3512605,Coronel Macedo - SP,3853,3913,60,4280,90.02,91.43,1.4
sidra_9541_PercMoradDPPOColetTot_munic_22_pol.fid-703dc0a5_191866d88cb_-afa,3512704,Corumbataí - SP,3004,3557,553,4186,71.76,84.97,13.21
sidra_9541_PercMoradDPPOColetTot_munic_22_pol.fid-703dc0a5_191866d88cb_-af9,3512803,Cosmópolis - SP,56365,59451,3086,59655,94.48,99.66,5.17
sidra_9541_PercMoradDPPOColetTot_munic_22_pol.fid-703dc0a5_191866d88cb_-af8,3512902,Cosmorama - SP,7356,7744,388,8717,84.39,88.84,4.45
sidra_9541_PercMoradDPPOColetTot_munic_22_pol.fid-703dc0a5_191866d88cb_-af7,3513009,Cotia - SP,240901,272209,31308,273741,88,99.44,11.44
sidra_9541_PercMoradDPPOColetTot_munic_22_pol.fid-703dc0a5_191866d88cb_-af5,3513108,Cravinhos - SP,32725,32954,229,33209,98.54,99.23,0.69
sidra_9541_PercMoradDPPOColetTot_munic_22_pol.fid-703dc0a5_191866d88cb_-af4,3513207,Cristais Paulista - SP,7782,8542,760,9261,84.03,92.24,8.21
sidra_9541_PercMoradDPPOColetTot_munic_22_pol.fid-703dc0a5_191866d88cb_-af3,3519709,Ibiúna - SP,56259,70819,14560,75494,74.52,93.81,19.29
sidra_9541_PercMoradDPPOColetTot_munic_22_pol.fid-703dc0a5_191866d88cb_-af2,3519808,Icém - SP,6623,6751,128,6922,95.68,97.53,1.85
sidra_9541_PercMoradDPPOColetTot_munic_22_pol.fid-703dc0a5_191866d88cb_-af1,3519907,Iepê - SP,7054,7254,200,7583,93.02,95.66,2.64
sidra_9541_PercMoradDPPOColetTot_munic_22_pol.fid-703dc0a5_191866d88cb_-af0,3520004,Igaraçu do Tietê - SP,22463,22631,168,22862,98.25,98.99,0.73
sidra_9541_PercMoradDPPOColetTot_munic_22_pol.fid-703dc0a5_191866d88cb_-aef,3520103,Igarapava - SP,25284,25819,535,26160,96.65,98.7,2.05
sidra_9541_PercMoradDPPOColetTot_munic_22_pol.fid-703dc0a5_191866d88cb_-aee,3520202,Igaratá - SP,9023,10166,1143,10576,85.32,96.12,10.81
sidra_9541_PercMoradDPPOColetTot_munic_22_pol.fid-703dc0a5_191866d88cb_-aed,3520301,Iguape - SP,24320,26173,1853,29068,83.67,90.04,6.37
sidra_9541_PercMoradDPPOColetTot_munic_22_pol.fid-703dc0a5_191866d88cb_-aec,3520400,Ilhabela - SP,25995,34499,8504,34851,74.59,98.99,24.4
sidra_9541_PercMoradDPPOColetTot_munic_22_pol.fid-703dc0a5_191866d88cb_-aea,3520426,Ilha Comprida - SP,11616,13283,1667,13319,87.21,99.73,12.52
sidra_9541_PercMoradDPPOColetTot_munic_22_pol.fid-703dc0a5_191866d88cb_-ae9,3520442,Ilha Solteira - SP,23905,24243,338,25534,93.62,94.94,1.32
sidra_9541_PercMoradDPPOColetTot_munic_22_pol.fid-703dc0a5_191866d88cb_-ae8,3520509,Indaiatuba - SP,233991,254827,20836,255155,91.71,99.87,8.17
sidra_9541_PercMoradDPPOColetTot_munic_22_pol.fid-703dc0a5_191866d88cb_-ae7,3520608,Indiana - SP,4797,4921,124,5090,94.24,96.68,2.44
sidra_9541_PercMoradDPPOColetTot_munic_22_pol.fid-703dc0a5_191866d88cb_-ae6,3513306,Cruzália - SP,1920,2011,91,2108,91.08,95.4,4.32
sidra_9541_PercMoradDPPOColetTot_munic_22_pol.fid-703dc0a5_191866d88cb_-ae5,3513405,Cruzeiro - SP,71924,74451,2527,74852,96.09,99.46,3.38
sidra_9541_PercMoradDPPOColetTot_munic_22_pol.fid-703dc0a5_191866d88cb_-ae4,3513504,Cubatão - SP,79044,111437,32393,112397,70.33,99.15,28.82
sidra_9541_PercMoradDPPOColetTot_munic_22_pol.fid-703dc0a5_191866d88cb_-ae3,3513603,Cunha - SP,12606,17475,4869,22063,57.14,79.21,22.07
sidra_9541_PercMoradDPPOColetTot_munic_22_pol.fid-703dc0a5_191866d88cb_-ae2,3513702,Descalvado - SP,29305,29721,416,31622,92.67,93.99,1.32
sidra_9541_PercMoradDPPOColetTot_munic_22_pol.fid-703dc0a5_191866d88cb_-ae1,3513801,Diadema - SP,372557,391221,18664,392352,94.95,99.71,4.76
sidra_9541_PercMoradDPPOColetTot_munic_22_pol.fid-703dc0a5_191866d88cb_-ae0,3520806,Inúbia Paulista - SP,3439,3552,113,3595,95.66,98.8,3.14
sidra_9541_PercMoradDPPOColetTot_munic_22_pol.fid-703dc0a5_191866d88cb_-adf,3513850,Dirce Reis - SP,1555,1564,9,1620,95.99,96.54,0.56
sidra_9541_PercMoradDPPOColetTot_munic_22_pol.fid-703dc0a5_191866d88cb_-ade,3513900,Divinolândia - SP,8329,9927,1598,10977,75.88,90.43,14.56
sidra_9541_PercMoradDPPOColetTot_munic_22_pol.fid-703dc0a5_191866d88cb_-add,3522653,Itapirapuã Paulista - SP,3694,3772,78,4305,85.81,87.62,1.81
sidra_9541_PercMoradDPPOColetTot_munic_22_pol.fid-703dc0a5_191866d88cb_-adb,3522703,Itápolis - SP,36784,37424,640,39439,93.27,94.89,1.62
sidra_9541_PercMoradDPPOColetTot_munic_22_pol.fid-703dc0a5_191866d88cb_-ada,3522802,Itaporanga - SP,11863,12443,580,14023,84.6,88.73,4.14
sidra_9541_PercMoradDPPOColetTot_munic_22_pol.fid-703dc0a5_191866d88cb_-ad9,3514007,Dobrada - SP,8661,8672,11,8758,98.89,99.02,0.13
sidra_9541_PercMoradDPPOColetTot_munic_22_pol.fid-703dc0a5_191866d88cb_-ad8,3514106,Dois Córregos - SP,23395,23849,454,24354,96.06,97.93,1.86
sidra_9541_PercMoradDPPOColetTot_munic_22_pol.fid-703dc0a5_191866d88cb_-ad7,3525102,Jardinópolis - SP,42202,42770,568,43296,97.47,98.79,1.31
sidra_9541_PercMoradDPPOColetTot_munic_22_pol.fid-703dc0a5_191866d88cb_-ad6,3525201,Jarinu - SP,35426,37239,1813,37475,94.53,99.37,4.84
sidra_9541_PercMoradDPPOColetTot_munic_22_pol.fid-703dc0a5_191866d88cb_-ad5,3525300,Jaú - SP,129426,131994,2568,132779,97.47,99.41,1.93
sidra_9541_PercMoradDPPOColetTot_munic_22_pol.fid-703dc0a5_191866d88cb_-ad4,3525409,Jeriquara - SP,3469,3513,44,3863,89.8,90.94,1.14
sidra_9541_PercMoradDPPOColetTot_munic_22_pol.fid-703dc0a5_191866d88cb_-ad3,3525508,Joanópolis - SP,9736,12613,2877,12753,76.34,98.9,22.56
sidra_9541_PercMoradDPPOColetTot_munic_22_pol.fid-703dc0a5_191866d88cb_-ad2,3525607,João Ramalho - SP,4089,4200,111,4363,93.72,96.26,2.54
sidra_9541_PercMoradDPPOColetTot_munic_22_pol.fid-703dc0a5_191866d88cb_-ad1,3525706,José Bonifácio - SP,34323,35072,749,36517,93.99,96.04,2.05
sidra_9541_PercMoradDPPOColetTot_munic_22_pol.fid-703dc0a5_191866d88cb_-ad0,3525805,Júlio Mesquita - SP,4187,4187,,4254,98.43,98.43,
sidra_9541_PercMoradDPPOColetTot_munic_22_pol.fid-703dc0a5_191866d88cb_-acf,3514205,Dolcinópolis - SP,2002,2082,80,2206,90.75,94.38,3.63
sidra_9541_PercMoradDPPOColetTot_munic_22_pol.fid-703dc0a5_191866d88cb_-ace,3514304,Dourado - SP,7675,7992,317,8075,95.05,98.97,3.93
sidra_9541_PercMoradDPPOColetTot_munic_22_pol.fid-703dc0a5_191866d88cb_-acd,3514403,Dracena - SP,42561,43463,902,44326,96.02,98.05,2.03
sidra_9541_PercMoradDPPOColetTot_munic_22_pol.fid-703dc0a5_191866d88cb_-acc,3514502,Duartina - SP,11163,11775,612,12305,90.72,95.69,4.97
sidra_9541_PercMoradDPPOColetTot_munic_22_pol.fid-703dc0a5_191866d88cb_-acb,3514601,Dumont - SP,9331,9369,38,9465,98.58,98.99,0.4
sidra_9541_PercMoradDPPOColetTot_munic_22_pol.fid-703dc0a5_191866d88cb_-aca,3514700,Echaporã - SP,5665,5829,164,6204,91.31,93.96,2.64
sidra_9541_PercMoradDPPOColetTot_munic_22_pol.fid-703dc0a5_191866d88cb_-ac9,3514809,Eldorado - SP,9845,11263,1418,13055,75.41,86.27,10.86
sidra_9541_PercMoradDPPOColetTot_munic_22_pol.fid-703dc0a5_191866d88cb_-ac7,3514908,Elias Fausto - SP,1162,17416,16254,17677,6.57,98.52,91.95
sidra_9541_PercMoradDPPOColetTot_munic_22_pol.fid-703dc0a5_191866d88cb_-ac6,3527306,Louveira - SP,49723,51606,1883,51763,96.06,99.7,3.64
sidra_9541_PercMoradDPPOColetTot_munic_22_pol.fid-703dc0a5_191866d88cb_-ac5,3527405,Lucélia - SP,16957,17150,193,17479,97.01,98.12,1.1
sidra_9541_PercMoradDPPOColetTot_munic_22_pol.fid-703dc0a5_191866d88cb_-ac4,3527504,Lucianópolis - SP,2137,2290,153,2368,90.24,96.71,6.46
sidra_9541_PercMoradDPPOColetTot_munic_22_pol.fid-703dc0a5_191866d88cb_-ac3,3527603,Luís Antônio - SP,12041,12153,112,12260,98.21,99.13,0.91
sidra_9541_PercMoradDPPOColetTot_munic_22_pol.fid-703dc0a5_191866d88cb_-ac2,3527702,Luiziânia - SP,4361,4464,103,4682,93.14,95.34,2.2
sidra_9541_PercMoradDPPOColetTot_munic_22_pol.fid-703dc0a5_191866d88cb_-ac1,3527801,Lupércio - SP,3713,3881,168,3981,93.27,97.49,4.22
sidra_9541_PercMoradDPPOColetTot_munic_22_pol.fid-703dc0a5_191866d88cb_-ac0,3527900,Lutécia - SP,2055,2368,313,2661,77.23,88.99,11.76
sidra_9541_PercMoradDPPOColetTot_munic_22_pol.fid-703dc0a5_191866d88cb_-abf,3528007,Macatuba - SP,16629,16685,56,16788,99.05,99.39,0.33
sidra_9541_PercMoradDPPOColetTot_munic_22_pol.fid-703dc0a5_191866d88cb_-abe,3528106,Macaubal - SP,6731,6908,177,7446,90.4,92.77,2.38
sidra_9541_PercMoradDPPOColetTot_munic_22_pol.fid-703dc0a5_191866d88cb_-abd,3528205,Macedônia - SP,3114,3420,306,3944,78.96,86.71,7.76
sidra_9541_PercMoradDPPOColetTot_munic_22_pol.fid-703dc0a5_191866d88cb_-abc,3528304,Magda - SP,2780,2942,162,3163,87.89,93.01,5.12
sidra_9541_PercMoradDPPOColetTot_munic_22_pol.fid-703dc0a5_191866d88cb_-abb,3528403,Mairinque - SP,42298,48134,5836,48931,86.44,98.37,11.93
sidra_9541_PercMoradDPPOColetTot_munic_22_pol.fid-703dc0a5_191866d88cb_-aba,3528502,Mairiporã - SP,84614,91695,7081,93551,90.45,98.02,7.57
sidra_9541_PercMoradDPPOColetTot_munic_22_pol.fid-703dc0a5_191866d88cb_-ab9,3528601,Manduri - SP,9149,9347,198,9844,92.94,94.95,2.01
sidra_9541_PercMoradDPPOColetTot_munic_22_pol.fid-703dc0a5_191866d88cb_-ab8,3528700,Marabá Paulista - SP,1781,1816,35,3499,50.9,51.9,1
sidra_9541_PercMoradDPPOColetTot_munic_22_pol.fid-703dc0a5_191866d88cb_-ab7,3528809,Maracaí - SP,11635,11978,343,12651,91.97,94.68,2.71
sidra_9541_PercMoradDPPOColetTot_munic_22_pol.fid-703dc0a5_191866d88cb_-ab6,3514924,Elisiário - SP,3107,3124,17,3138,99.01,99.55,0.54
sidra_9541_PercMoradDPPOColetTot_munic_22_pol.fid-703dc0a5_191866d88cb_-ab5,3514957,Embaúba - SP,2145,2155,10,2323,92.34,92.77,0.43
sidra_9541_PercMoradDPPOColetTot_munic_22_pol.fid-703dc0a5_191866d88cb_-ab4,3515004,Embu das Artes - SP,221944,248029,26085,250148,88.73,99.15,10.43
sidra_9541_PercMoradDPPOColetTot_munic_22_pol.fid-703dc0a5_191866d88cb_-ab3,3515103,Embu-Guaçu - SP,61900,65948,4048,66632,92.9,98.97,6.08
sidra_9541_PercMoradDPPOColetTot_munic_22_pol.fid-703dc0a5_191866d88cb_-ab2,3515129,Emilianópolis - SP,2826,2895,69,3012,93.82,96.12,2.29
sidra_9541_PercMoradDPPOColetTot_munic_22_pol.fid-703dc0a5_191866d88cb_-ab1,3531100,Mongaguá - SP,55916,58523,2607,59169,94.5,98.91,4.41
sidra_9541_PercMoradDPPOColetTot_munic_22_pol.fid-703dc0a5_191866d88cb_-ab0,3531209,Monte Alegre do Sul - SP,7431,8380,949,8623,86.18,97.18,11.01
sidra_9541_PercMoradDPPOColetTot_munic_22_pol.fid-703dc0a5_191866d88cb_-aaf,3531308,Monte Alto - SP,45572,45974,402,47417,96.11,96.96,0.85
sidra_9541_PercMoradDPPOColetTot_munic_22_pol.fid-703dc0a5_191866d88cb_-aae,3531407,Monte Aprazível - SP,20829,21368,539,22220,93.74,96.17,2.43
sidra_9541_PercMoradDPPOColetTot_munic_22_pol.fid-703dc0a5_191866d88cb_-aad,3531506,Monte Azul Paulista - SP,17192,17704,512,18125,94.85,97.68,2.82
sidra_9541_PercMoradDPPOColetTot_munic_22_pol.fid-703dc0a5_191866d88cb_-aac,3531605,Monte Castelo - SP,3595,3959,364,4219,85.21,93.84,8.63
sidra_9541_PercMoradDPPOColetTot_munic_22_pol.fid-703dc0a5_191866d88cb_-aab,3531704,Monteiro Lobato - SP,2241,3983,1742,4121,54.38,96.65,42.27
sidra_9541_PercMoradDPPOColetTot_munic_22_pol.fid-703dc0a5_191866d88cb_-aaa,3531803,Monte Mor - SP,60202,63728,3526,64586,93.21,98.67,5.46
sidra_9541_PercMoradDPPOColetTot_munic_22_pol.fid-703dc0a5_191866d88cb_-aa9,3531902,Morro Agudo - SP,26709,27043,334,27862,95.86,97.06,1.2
sidra_9541_PercMoradDPPOColetTot_munic_22_pol.fid-703dc0a5_191866d88cb_-aa8,3532009,Morungaba - SP,12284,13382,1098,13567,90.54,98.64,8.09
sidra_9541_PercMoradDPPOColetTot_munic_22_pol.fid-703dc0a5_191866d88cb_-aa7,3532058,Motuca - SP,3648,3811,163,4034,90.43,94.47,4.04
sidra_9541_PercMoradDPPOColetTot_munic_22_pol.fid-703dc0a5_191866d88cb_-aa6,3515152,Engenheiro Coelho - SP,17455,19028,1573,19438,89.8,97.89,8.09
sidra_9541_PercMoradDPPOColetTot_munic_22_pol.fid-703dc0a5_191866d88cb_-aa5,3515186,Espírito Santo do Pinhal - SP,37572,38745,1173,39611,94.85,97.81,2.96
sidra_9541_PercMoradDPPOColetTot_munic_22_pol.fid-703dc0a5_191866d88cb_-aa4,3532108,Murutinga do Sul - SP,2905,2933,28,3712,78.26,79.01,0.75
sidra_9541_PercMoradDPPOColetTot_munic_22_pol.fid-703dc0a5_191866d88cb_-aa3,3532157,Nantes - SP,2544,2575,31,2660,95.64,96.8,1.17
sidra_9541_PercMoradDPPOColetTot_munic_22_pol.fid-703dc0a5_191866d88cb_-aa2,3532207,Narandiba - SP,5381,5412,31,5710,94.24,94.78,0.54
sidra_9541_PercMoradDPPOColetTot_munic_22_pol.fid-703dc0a5_191866d88cb_-aa1,3532306,Natividade da Serra - SP,3295,6424,3129,6989,47.15,91.92,44.77
sidra_9541_PercMoradDPPOColetTot_munic_22_pol.fid-703dc0a5_191866d88cb_-aa0,3532405,Nazaré Paulista - SP,11386,17236,5850,18183,62.62,94.79,32.17
sidra_9541_PercMoradDPPOColetTot_munic_22_pol.fid-703dc0a5_191866d88cb_-a9f,3532504,Neves Paulista - SP,9113,9183,70,9662,94.32,95.04,0.72
sidra_9541_PercMoradDPPOColetTot_munic_22_pol.fid-703dc0a5_191866d88cb_-a9e,3532603,Nhandeara - SP,8584,8997,413,9758,87.97,92.2,4.23
sidra_9541_PercMoradDPPOColetTot_munic_22_pol.fid-703dc0a5_191866d88cb_-a9d,3532702,Nipoã - SP,4452,4523,71,4748,93.77,95.26,1.5
sidra_9541_PercMoradDPPOColetTot_munic_22_pol.fid-703dc0a5_191866d88cb_-a9c,3532801,Nova Aliança - SP,6281,6370,89,6690,93.89,95.22,1.33
sidra_9541_PercMoradDPPOColetTot_munic_22_pol.fid-703dc0a5_191866d88cb_-a9b,3532827,Nova Campina - SP,7739,8093,354,8492,91.13,95.3,4.17
sidra_9541_PercMoradDPPOColetTot_munic_22_pol.fid-703dc0a5_191866d88cb_-a9a,3515194,Espírito Santo do Turvo - SP,3870,3914,44,4155,93.14,94.2,1.06
sidra_9541_PercMoradDPPOColetTot_munic_22_pol.fid-703dc0a5_191866d88cb_-a99,3515202,Estrela d'Oeste - SP,7934,8496,562,9292,85.39,91.43,6.05
sidra_9541_PercMoradDPPOColetTot_munic_22_pol.fid-703dc0a5_191866d88cb_-a98,3515350,Euclides da Cunha Paulista - SP,5403,5668,265,7919,68.23,71.57,3.35
sidra_9541_PercMoradDPPOColetTot_munic_22_pol.fid-703dc0a5_191866d88cb_-a97,3515400,Fartura - SP,14059,15736,1677,16584,84.77,94.89,10.11
sidra_9541_PercMoradDPPOColetTot_munic_22_pol.fid-703dc0a5_191866d88cb_-a96,3515509,Fernandópolis - SP,68958,69531,573,71005,97.12,97.92,0.81
sidra_9541_PercMoradDPPOColetTot_munic_22_pol.fid-703dc0a5_191866d88cb_-a95,3515608,Fernando Prestes - SP,5451,5458,7,5938,91.8,91.92,0.12
sidra_9541_PercMoradDPPOColetTot_munic_22_pol.fid-703dc0a5_191866d88cb_-a94,3515657,Fernão - SP,1590,1590,,1655,96.07,96.07,
sidra_9541_PercMoradDPPOColetTot_munic_22_pol.fid-703dc0a5_191866d88cb_-a93,3516101,Florínea - SP,2614,2650,36,2768,94.44,95.74,1.3
sidra_9541_PercMoradDPPOColetTot_munic_22_pol.fid-703dc0a5_191866d88cb_-a92,3516200,Franca - SP,339672,349566,9894,350944,96.79,99.61,2.82
sidra_9541_PercMoradDPPOColetTot_munic_22_pol.fid-703dc0a5_191866d88cb_-a90,3516309,Francisco Morato - SP,153834,162836,9002,164967,93.25,98.71,5.46
sidra_9541_PercMoradDPPOColetTot_munic_22_pol.fid-703dc0a5_191866d88cb_-a8f,3516408,Franco da Rocha - SP,133847,139120,5273,140159,95.5,99.26,3.76
sidra_9541_PercMoradDPPOColetTot_munic_22_pol.fid-703dc0a5_191866d88cb_-a8e,3516507,Gabriel Monteiro - SP,2599,2638,39,2763,94.06,95.48,1.41
sidra_9541_PercMoradDPPOColetTot_munic_22_pol.fid-703dc0a5_191866d88cb_-a8d,3518008,Guarani d'Oeste - SP,1747,1880,133,1968,88.77,95.53,6.76
sidra_9541_PercMoradDPPOColetTot_munic_22_pol.fid-703dc0a5_191866d88cb_-a8c,3518107,Guarantã - SP,5278,5598,320,6403,82.43,87.43,5
sidra_9541_PercMoradDPPOColetTot_munic_22_pol.fid-703dc0a5_191866d88cb_-a8b,3518206,Guararapes - SP,29447,29975,528,30985,95.04,96.74,1.7
sidra_9541_PercMoradDPPOColetTot_munic_22_pol.fid-703dc0a5_191866d88cb_-a8a,3518305,Guararema - SP,25422,30674,5252,31184,81.52,98.36,16.84
sidra_9541_PercMoradDPPOColetTot_munic_22_pol.fid-703dc0a5_191866d88cb_-a89,3518404,Guaratinguetá - SP,112022,116503,4481,117126,95.64,99.47,3.83
sidra_9541_PercMoradDPPOColetTot_munic_22_pol.fid-703dc0a5_191866d88cb_-a88,3518503,Guareí - SP,11019,11572,553,12269,89.81,94.32,4.51
sidra_9541_PercMoradDPPOColetTot_munic_22_pol.fid-703dc0a5_191866d88cb_-a87,3518602,Guariba - SP,36470,36573,103,36710,99.35,99.63,0.28
sidra_9541_PercMoradDPPOColetTot_munic_22_pol.fid-703dc0a5_191866d88cb_-a86,3518701,Guarujá - SP,229865,286432,56567,287098,80.07,99.77,19.7
sidra_9541_PercMoradDPPOColetTot_munic_22_pol.fid-703dc0a5_191866d88cb_-a85,3519055,Holambra - SP,14559,14954,395,15052,96.72,99.35,2.62
sidra_9541_PercMoradDPPOColetTot_munic_22_pol.fid-703dc0a5_191866d88cb_-a84,3519071,Hortolândia - SP,216770,232104,15334,232196,93.36,99.96,6.6
sidra_9541_PercMoradDPPOColetTot_munic_22_pol.fid-703dc0a5_191866d88cb_-a83,3519105,Iacanga - SP,9729,9774,45,10436,93.23,93.66,0.43
sidra_9541_PercMoradDPPOColetTot_munic_22_pol.fid-703dc0a5_191866d88cb_-a82,3519204,Iacri - SP,5440,5489,49,6130,88.74,89.54,0.8
sidra_9541_PercMoradDPPOColetTot_munic_22_pol.fid-703dc0a5_191866d88cb_-a81,3519253,Iaras - SP,3605,3632,27,5112,70.52,71.05,0.53
sidra_9541_PercMoradDPPOColetTot_munic_22_pol.fid-703dc0a5_191866d88cb_-a80,3519303,Ibaté - SP,31662,32031,369,32175,98.41,99.55,1.15
sidra_9541_PercMoradDPPOColetTot_munic_22_pol.fid-703dc0a5_191866d88cb_-a7f,3519402,Ibirá - SP,11295,11364,69,11671,96.78,97.37,0.59
sidra_9541_PercMoradDPPOColetTot_munic_22_pol.fid-703dc0a5_191866d88cb_-a7e,3519501,Ibirarema - SP,6018,6159,141,6363,94.58,96.79,2.22
sidra_9541_PercMoradDPPOColetTot_munic_22_pol.fid-703dc0a5_191866d88cb_-a7d,3519600,Ibitinga - SP,58005,59353,1348,59896,96.84,99.09,2.25
sidra_9541_PercMoradDPPOColetTot_munic_22_pol.fid-703dc0a5_191866d88cb_-a7c,3520707,Indiaporã - SP,3405,3835,430,4028,84.53,95.21,10.68
sidra_9541_PercMoradDPPOColetTot_munic_22_pol.fid-703dc0a5_191866d88cb_-a7b,3520905,Ipaussu - SP,13313,13476,163,13704,97.15,98.34,1.19
sidra_9541_PercMoradDPPOColetTot_munic_22_pol.fid-703dc0a5_191866d88cb_-a7a,3521002,Iperó - SP,16302,33276,16974,33604,48.51,99.02,50.51
sidra_9541_PercMoradDPPOColetTot_munic_22_pol.fid-703dc0a5_191866d88cb_-a79,3521101,Ipeúna - SP,6375,6667,292,6830,93.34,97.61,4.28
sidra_9541_PercMoradDPPOColetTot_munic_22_pol.fid-703dc0a5_191866d88cb_-a78,3521150,Ipiguá - SP,6080,6437,357,6761,89.93,95.21,5.28
sidra_9541_PercMoradDPPOColetTot_munic_22_pol.fid-703dc0a5_191866d88cb_-a77,3521200,Iporanga - SP,3157,3252,95,4039,78.16,80.51,2.35
sidra_9541_PercMoradDPPOColetTot_munic_22_pol.fid-703dc0a5_191866d88cb_-a76,3521309,Ipuã - SP,13935,14212,277,14445,96.47,98.39,1.92
sidra_9541_PercMoradDPPOColetTot_munic_22_pol.fid-703dc0a5_191866d88cb_-a75,3521408,Iracemápolis - SP,21564,21891,327,21943,98.27,99.76,1.49
sidra_9541_PercMoradDPPOColetTot_munic_22_pol.fid-703dc0a5_191866d88cb_-a74,3521507,Irapuã - SP,5993,6676,683,6846,87.54,97.52,9.98
sidra_9541_PercMoradDPPOColetTot_munic_22_pol.fid-703dc0a5_191866d88cb_-a73,3521606,Irapuru - SP,5296,5372,76,5881,90.05,91.35,1.29
sidra_9541_PercMoradDPPOColetTot_munic_22_pol.fid-703dc0a5_191866d88cb_-a72,3521705,Itaberá - SP,15004,16015,1011,17939,83.64,89.27,5.64
sidra_9541_PercMoradDPPOColetTot_munic_22_pol.fid-703dc0a5_191866d88cb_-a71,3521804,Itaí - SP,21386,22660,1274,24098,88.75,94.03,5.29
sidra_9541_PercMoradDPPOColetTot_munic_22_pol.fid-703dc0a5_191866d88cb_-a70,3521903,Itajobi - SP,15050,15536,486,16948,88.8,91.67,2.87
sidra_9541_PercMoradDPPOColetTot_munic_22_pol.fid-703dc0a5_191866d88cb_-a6f,3522000,Itaju - SP,2919,3332,413,3618,80.68,92.1,11.42
sidra_9541_PercMoradDPPOColetTot_munic_22_pol.fid-703dc0a5_191866d88cb_-a6e,3522109,Itanhaém - SP,103278,109888,6610,112223,92.03,97.92,5.89
sidra_9541_PercMoradDPPOColetTot_munic_22_pol.fid-703dc0a5_191866d88cb_-a6d,3522158,Itaoca - SP,534,3339,2805,3422,15.6,97.57,81.97
sidra_9541_PercMoradDPPOColetTot_munic_22_pol.fid-703dc0a5_191866d88cb_-a6c,3522208,Itapecerica da Serra - SP,142483,155892,13409,157865,90.26,98.75,8.49
sidra_9541_PercMoradDPPOColetTot_munic_22_pol.fid-703dc0a5_191866d88cb_-a6b,3522307,Itapetininga - SP,147456,152011,4555,154307,95.56,98.51,2.95
sidra_9541_PercMoradDPPOColetTot_munic_22_pol.fid-703dc0a5_191866d88cb_-a6a,3522406,Itapeva - SP,75469,86621,11152,89562,84.26,96.72,12.45
sidra_9541_PercMoradDPPOColetTot_munic_22_pol.fid-703dc0a5_191866d88cb_-a69,3522505,Itapevi - SP,214115,229739,15624,231893,92.33,99.07,6.74
sidra_9541_PercMoradDPPOColetTot_munic_22_pol.fid-703dc0a5_191866d88cb_-a68,3522604,Itapira - SP,69341,71037,1696,71448,97.05,99.42,2.37
sidra_9541_PercMoradDPPOColetTot_munic_22_pol.fid-703dc0a5_191866d88cb_-a67,3522901,Itapuí - SP,13376,13455,79,13610,98.28,98.86,0.58
sidra_9541_PercMoradDPPOColetTot_munic_22_pol.fid-703dc0a5_191866d88cb_-a66,3523008,Itapura - SP,3721,3858,137,3974,93.63,97.08,3.45
sidra_9541_PercMoradDPPOColetTot_munic_22_pol.fid-703dc0a5_191866d88cb_-a65,3523107,Itaquaquecetuba - SP,346676,367382,20706,368933,93.97,99.58,5.61
sidra_9541_PercMoradDPPOColetTot_munic_22_pol.fid-703dc0a5_191866d88cb_-a64,3523206,Itararé - SP,42926,43319,393,44358,96.77,97.66,0.89
sidra_9541_PercMoradDPPOColetTot_munic_22_pol.fid-703dc0a5_191866d88cb_-a63,3523305,Itariri - SP,13129,14564,1435,15461,84.92,94.2,9.28
sidra_9541_PercMoradDPPOColetTot_munic_22_pol.fid-703dc0a5_191866d88cb_-a62,3523404,Itatiba - SP,115624,120785,5161,121209,95.39,99.65,4.26
sidra_9541_PercMoradDPPOColetTot_munic_22_pol.fid-703dc0a5_191866d88cb_-a61,3523503,Itatinga - SP,16412,17706,1294,18058,90.88,98.05,7.17
sidra_9541_PercMoradDPPOColetTot_munic_22_pol.fid-703dc0a5_191866d88cb_-a60,3523602,Itirapina - SP,11961,12873,912,13138,91.04,97.98,6.94
sidra_9541_PercMoradDPPOColetTot_munic_22_pol.fid-703dc0a5_191866d88cb_-a5f,3533106,Nova Guataporanga - SP,1975,2102,127,2153,91.73,97.63,5.9
sidra_9541_PercMoradDPPOColetTot_munic_22_pol.fid-703dc0a5_191866d88cb_-a5e,3533205,Nova Independência - SP,3549,3749,200,4020,88.28,93.26,4.98
sidra_9541_PercMoradDPPOColetTot_munic_22_pol.fid-703dc0a5_191866d88cb_-a5d,3533254,Novais - SP,4217,4228,11,4412,95.58,95.83,0.25
sidra_9541_PercMoradDPPOColetTot_munic_22_pol.fid-703dc0a5_191866d88cb_-a5c,3523701,Itirapuã - SP,5078,5412,334,5756,88.22,94.02,5.8
sidra_9541_PercMoradDPPOColetTot_munic_22_pol.fid-703dc0a5_191866d88cb_-a5b,3523800,Itobi - SP,7319,7356,37,8000,91.49,91.95,0.46
sidra_9541_PercMoradDPPOColetTot_munic_22_pol.fid-703dc0a5_191866d88cb_-a5a,3523909,Itu - SP,32681,165904,133223,167719,19.49,98.92,79.43
sidra_9541_PercMoradDPPOColetTot_munic_22_pol.fid-703dc0a5_191866d88cb_-a58,3524006,Itupeva - SP,65882,70164,4282,70552,93.38,99.45,6.07
sidra_9541_PercMoradDPPOColetTot_munic_22_pol.fid-703dc0a5_191866d88cb_-a57,3524105,Ituverava - SP,36434,36871,437,37484,97.2,98.36,1.17
sidra_9541_PercMoradDPPOColetTot_munic_22_pol.fid-703dc0a5_191866d88cb_-a56,3524204,Jaborandi - SP,5895,5984,89,6197,95.13,96.56,1.44
sidra_9541_PercMoradDPPOColetTot_munic_22_pol.fid-703dc0a5_191866d88cb_-a55,3524303,Jaboticabal - SP,68734,70755,2021,71622,95.97,98.79,2.82
sidra_9541_PercMoradDPPOColetTot_munic_22_pol.fid-703dc0a5_191866d88cb_-a54,3524402,Jacareí - SP,219575,239383,19808,240009,91.49,99.74,8.25
sidra_9541_PercMoradDPPOColetTot_munic_22_pol.fid-703dc0a5_191866d88cb_-a53,3524501,Jaci - SP,6906,7217,311,7444,92.77,96.95,4.18
sidra_9541_PercMoradDPPOColetTot_munic_22_pol.fid-703dc0a5_191866d88cb_-a52,3524600,Jacupiranga - SP,14926,15171,245,16056,92.96,94.49,1.53
sidra_9541_PercMoradDPPOColetTot_munic_22_pol.fid-703dc0a5_191866d88cb_-a51,3524709,Jaguariúna - SP,47008,59044,12036,59148,79.48,99.82,20.35
sidra_9541_PercMoradDPPOColetTot_munic_22_pol.fid-703dc0a5_191866d88cb_-a50,3524808,Jales - SP,46076,47007,931,48638,94.73,96.65,1.91
sidra_9541_PercMoradDPPOColetTot_munic_22_pol.fid-703dc0a5_191866d88cb_-a4f,3524907,Jambeiro - SP,5251,6239,988,6375,82.37,97.87,15.5
sidra_9541_PercMoradDPPOColetTot_munic_22_pol.fid-703dc0a5_191866d88cb_-a4e,3525003,Jandira - SP,107018,117978,10960,118024,90.67,99.96,9.29
sidra_9541_PercMoradDPPOColetTot_munic_22_pol.fid-703dc0a5_191866d88cb_-a4d,3525854,Jumirim - SP,2656,2963,307,3056,86.91,96.96,10.05
sidra_9541_PercMoradDPPOColetTot_munic_22_pol.fid-703dc0a5_191866d88cb_-a4c,3525904,Jundiaí - SP,361770,440823,79053,441299,81.98,99.89,17.91
sidra_9541_PercMoradDPPOColetTot_munic_22_pol.fid-703dc0a5_191866d88cb_-a4b,3526001,Junqueirópolis - SP,17898,18129,231,19108,93.67,94.88,1.21
sidra_9541_PercMoradDPPOColetTot_munic_22_pol.fid-703dc0a5_191866d88cb_-a4a,3526100,Juquiá - SP,12766,15182,2416,17109,74.62,88.74,14.12
sidra_9541_PercMoradDPPOColetTot_munic_22_pol.fid-703dc0a5_191866d88cb_-a49,3526209,Juquitiba - SP,21062,25708,4646,27301,77.15,94.17,17.02
sidra_9541_PercMoradDPPOColetTot_munic_22_pol.fid-703dc0a5_191866d88cb_-a48,3526308,Lagoinha - SP,3346,4836,1490,4991,67.04,96.89,29.85
sidra_9541_PercMoradDPPOColetTot_munic_22_pol.fid-703dc0a5_191866d88cb_-a46,3526407,Laranjal Paulista - SP,23024,25773,2749,26188,87.92,98.42,10.5
sidra_9541_PercMoradDPPOColetTot_munic_22_pol.fid-703dc0a5_191866d88cb_-a45,3526506,Lavínia - SP,4456,4535,79,4798,92.87,94.52,1.65
sidra_9541_PercMoradDPPOColetTot_munic_22_pol.fid-703dc0a5_191866d88cb_-a44,3526605,Lavrinhas - SP,6504,6993,489,7140,91.09,97.94,6.85
sidra_9541_PercMoradDPPOColetTot_munic_22_pol.fid-703dc0a5_191866d88cb_-a43,3526704,Leme - SP,96231,96929,698,97943,98.25,98.96,0.71
sidra_9541_PercMoradDPPOColetTot_munic_22_pol.fid-703dc0a5_191866d88cb_-a42,3526803,Lençóis Paulista - SP,4822,66016,61194,66269,7.28,99.62,92.34
sidra_9541_PercMoradDPPOColetTot_munic_22_pol.fid-703dc0a5_191866d88cb_-a41,3526902,Limeira - SP,274836,288715,13879,290273,94.68,99.46,4.78
sidra_9541_PercMoradDPPOColetTot_munic_22_pol.fid-703dc0a5_191866d88cb_-a40,3535705,Paraíso - SP,5270,5783,513,6099,86.41,94.82,8.41
sidra_9541_PercMoradDPPOColetTot_munic_22_pol.fid-703dc0a5_191866d88cb_-a3f,3535804,Paranapanema - SP,17322,18206,884,19353,89.51,94.07,4.57
sidra_9541_PercMoradDPPOColetTot_munic_22_pol.fid-703dc0a5_191866d88cb_-a3e,3535903,Paranapuã - SP,3755,3814,59,4027,93.25,94.71,1.47
sidra_9541_PercMoradDPPOColetTot_munic_22_pol.fid-703dc0a5_191866d88cb_-a3d,3536000,Parapuã - SP,9355,9536,181,10553,88.65,90.36,1.72
sidra_9541_PercMoradDPPOColetTot_munic_22_pol.fid-703dc0a5_191866d88cb_-a3c,3536109,Pardinho - SP,6374,6967,593,7139,89.28,97.59,8.31
sidra_9541_PercMoradDPPOColetTot_munic_22_pol.fid-703dc0a5_191866d88cb_-a3b,3536208,Pariquera-Açu - SP,16915,18582,1667,19199,88.1,96.79,8.68
sidra_9541_PercMoradDPPOColetTot_munic_22_pol.fid-703dc0a5_191866d88cb_-a3a,3527009,Lindóia - SP,6186,6955,769,7014,88.2,99.16,10.96
sidra_9541_PercMoradDPPOColetTot_munic_22_pol.fid-703dc0a5_191866d88cb_-a39,3527108,Lins - SP,73204,73509,305,74106,98.78,99.19,0.41
sidra_9541_PercMoradDPPOColetTot_munic_22_pol.fid-703dc0a5_191866d88cb_-a38,3527207,Lorena - SP,80117,83623,3506,84571,94.73,98.88,4.15
sidra_9541_PercMoradDPPOColetTot_munic_22_pol.fid-703dc0a5_191866d88cb_-a37,3527256,Lourdes - SP,1839,1880,41,1904,96.59,98.74,2.15
sidra_9541_PercMoradDPPOColetTot_munic_22_pol.fid-703dc0a5_191866d88cb_-a36,3528858,Marapoama - SP,3099,3104,5,3292,94.14,94.29,0.15
sidra_9541_PercMoradDPPOColetTot_munic_22_pol.fid-703dc0a5_191866d88cb_-a35,3528908,Mariápolis - SP,3415,3445,30,3511,97.27,98.12,0.85
sidra_9541_PercMoradDPPOColetTot_munic_22_pol.fid-703dc0a5_191866d88cb_-a34,3529005,Marília - SP,226584,234482,7898,235902,96.05,99.4,3.35
sidra_9541_PercMoradDPPOColetTot_munic_22_pol.fid-703dc0a5_191866d88cb_-a33,3539004,Pirangi - SP,10019,10223,204,10849,92.35,94.23,1.88
sidra_9541_PercMoradDPPOColetTot_munic_22_pol.fid-703dc0a5_191866d88cb_-a32,3539103,Pirapora do Bom Jesus - SP,16371,17934,1563,18328,89.32,97.85,8.53
sidra_9541_PercMoradDPPOColetTot_munic_22_pol.fid-703dc0a5_191866d88cb_-a31,3539202,Pirapozinho - SP,24768,24921,153,25289,97.94,98.54,0.61
sidra_9541_PercMoradDPPOColetTot_munic_22_pol.fid-703dc0a5_191866d88cb_-a30,3539301,Pirassununga - SP,70008,71337,1329,73349,95.45,97.26,1.81
sidra_9541_PercMoradDPPOColetTot_munic_22_pol.fid-703dc0a5_191866d88cb_-a2f,3529104,Marinópolis - SP,1543,1724,181,1860,82.96,92.69,9.73
sidra_9541_PercMoradDPPOColetTot_munic_22_pol.fid-703dc0a5_191866d88cb_-a2e,3529203,Martinópolis - SP,21857,22098,241,23581,92.69,93.71,1.02
sidra_9541_PercMoradDPPOColetTot_munic_22_pol.fid-703dc0a5_191866d88cb_-a2d,3529302,Matão - SP,77612,78758,1146,78945,98.31,99.76,1.45
sidra_9541_PercMoradDPPOColetTot_munic_22_pol.fid-703dc0a5_191866d88cb_-a2c,3529401,Mauá - SP,395494,414742,19248,417269,94.78,99.39,4.61
sidra_9541_PercMoradDPPOColetTot_munic_22_pol.fid-703dc0a5_191866d88cb_-a2b,3529500,Mendonça - SP,5908,5953,45,6159,95.92,96.66,0.73
sidra_9541_PercMoradDPPOColetTot_munic_22_pol.fid-703dc0a5_191866d88cb_-a2a,3529609,Meridiano - SP,3881,4318,437,4572,84.89,94.44,9.56
sidra_9541_PercMoradDPPOColetTot_munic_22_pol.fid-703dc0a5_191866d88cb_-a29,3529658,Mesópolis - SP,1719,1728,9,1951,88.11,88.57,0.46
sidra_9541_PercMoradDPPOColetTot_munic_22_pol.fid-703dc0a5_191866d88cb_-a28,3529708,Miguelópolis - SP,18435,18628,193,19392,95.06,96.06,1
sidra_9541_PercMoradDPPOColetTot_munic_22_pol.fid-703dc0a5_191866d88cb_-a27,3539400,Piratininga - SP,13183,14234,1051,14982,87.99,95.01,7.02
sidra_9541_PercMoradDPPOColetTot_munic_22_pol.fid-703dc0a5_191866d88cb_-a26,3539509,Pitangueiras - SP,32601,33007,406,33639,96.91,98.12,1.21
sidra_9541_PercMoradDPPOColetTot_munic_22_pol.fid-703dc0a5_191866d88cb_-a25,3539608,Planalto - SP,3968,4092,124,4386,90.47,93.3,2.83
sidra_9541_PercMoradDPPOColetTot_munic_22_pol.fid-703dc0a5_191866d88cb_-a24,3539707,Platina - SP,2763,2833,70,3022,91.43,93.75,2.32
sidra_9541_PercMoradDPPOColetTot_munic_22_pol.fid-703dc0a5_191866d88cb_-a23,3539806,Poá - SP,100940,103239,2299,103600,97.43,99.65,2.22
sidra_9541_PercMoradDPPOColetTot_munic_22_pol.fid-703dc0a5_191866d88cb_-a22,3529807,Mineiros do Tietê - SP,10814,11036,222,11200,96.55,98.54,1.98
sidra_9541_PercMoradDPPOColetTot_munic_22_pol.fid-703dc0a5_191866d88cb_-a21,3529906,Miracatu - SP,13936,16034,2098,18503,75.32,86.66,11.34
sidra_9541_PercMoradDPPOColetTot_munic_22_pol.fid-703dc0a5_191866d88cb_-a20,3542008,Quintana - SP,6650,6729,79,7026,94.65,95.77,1.12
sidra_9541_PercMoradDPPOColetTot_munic_22_pol.fid-703dc0a5_191866d88cb_-a1f,3542107,Rafard - SP,8745,8900,155,8964,97.56,99.29,1.73
sidra_9541_PercMoradDPPOColetTot_munic_22_pol.fid-703dc0a5_191866d88cb_-a1e,3530003,Mira Estrela - SP,2701,2833,132,3126,86.4,90.63,4.22
sidra_9541_PercMoradDPPOColetTot_munic_22_pol.fid-703dc0a5_191866d88cb_-a1d,3530102,Mirandópolis - SP,21309,22185,876,23582,90.36,94.08,3.71
sidra_9541_PercMoradDPPOColetTot_munic_22_pol.fid-703dc0a5_191866d88cb_-a1c,3530201,Mirante do Paranapanema - SP,9767,10062,295,15844,61.64,63.51,1.86
sidra_9541_PercMoradDPPOColetTot_munic_22_pol.fid-703dc0a5_191866d88cb_-a1b,3530300,Mirassol - SP,61661,62655,994,63211,97.55,99.12,1.57
sidra_9541_PercMoradDPPOColetTot_munic_22_pol.fid-703dc0a5_191866d88cb_-a1a,3530409,Mirassolândia - SP,4155,4209,54,4664,89.09,90.24,1.16
sidra_9541_PercMoradDPPOColetTot_munic_22_pol.fid-703dc0a5_191866d88cb_-a19,3530508,Mococa - SP,63759,65614,1855,67282,94.76,97.52,2.76
sidra_9541_PercMoradDPPOColetTot_munic_22_pol.fid-703dc0a5_191866d88cb_-a18,3530607,Mogi das Cruzes - SP,423513,445773,22260,450689,93.97,98.91,4.94
sidra_9541_PercMoradDPPOColetTot_munic_22_pol.fid-703dc0a5_191866d88cb_-a17,3530706,Mogi Guaçu - SP,147334,151649,4315,152623,96.53,99.36,2.83
sidra_9541_PercMoradDPPOColetTot_munic_22_pol.fid-703dc0a5_191866d88cb_-a16,3530805,Mogi Mirim - SP,87421,89869,2448,91948,95.08,97.74,2.66
sidra_9541_PercMoradDPPOColetTot_munic_22_pol.fid-703dc0a5_191866d88cb_-a15,3530904,Mombuca - SP,3563,3657,94,3722,95.73,98.25,2.53
sidra_9541_PercMoradDPPOColetTot_munic_22_pol.fid-703dc0a5_191866d88cb_-a14,3531001,Monções - SP,1842,1856,14,1937,95.1,95.82,0.72
sidra_9541_PercMoradDPPOColetTot_munic_22_pol.fid-703dc0a5_191866d88cb_-a13,3532843,Nova Canaã Paulista - SP,1496,1766,270,2028,73.77,87.08,13.31
sidra_9541_PercMoradDPPOColetTot_munic_22_pol.fid-703dc0a5_191866d88cb_-a12,3542206,Rancharia - SP,26391,26727,336,28513,92.56,93.74,1.18
sidra_9541_PercMoradDPPOColetTot_munic_22_pol.fid-703dc0a5_191866d88cb_-a11,3542305,Redenção da Serra - SP,3470,4184,714,4493,77.23,93.12,15.89
sidra_9541_PercMoradDPPOColetTot_munic_22_pol.fid-703dc0a5_191866d88cb_-a10,3542404,Regente Feijó - SP,18999,19617,618,20104,94.5,97.58,3.07
sidra_9541_PercMoradDPPOColetTot_munic_22_pol.fid-703dc0a5_191866d88cb_-a0f,3542503,Reginópolis - SP,5226,5413,187,5649,92.51,95.82,3.31
sidra_9541_PercMoradDPPOColetTot_munic_22_pol.fid-703dc0a5_191866d88cb_-a0e,3542602,Registro - SP,55394,57052,1658,58919,94.02,96.83,2.81
sidra_9541_PercMoradDPPOColetTot_munic_22_pol.fid-703dc0a5_191866d88cb_-a0d,3542701,Restinga - SP,5998,6206,208,6380,94.01,97.27,3.26
sidra_9541_PercMoradDPPOColetTot_munic_22_pol.fid-703dc0a5_191866d88cb_-a0c,3542800,Ribeira - SP,1974,2933,959,3130,63.07,93.71,30.64
sidra_9541_PercMoradDPPOColetTot_munic_22_pol.fid-703dc0a5_191866d88cb_-a0b,3542909,Ribeirão Bonito - SP,10289,10736,447,10957,93.9,97.98,4.08
sidra_9541_PercMoradDPPOColetTot_munic_22_pol.fid-703dc0a5_191866d88cb_-a0a,3543006,Ribeirão Branco - SP,13676,17105,3429,18618,73.46,91.87,18.42
sidra_9541_PercMoradDPPOColetTot_munic_22_pol.fid-703dc0a5_191866d88cb_-a08,3543105,Ribeirão Corrente - SP,3770,4441,671,4604,81.89,96.46,14.57
sidra_9541_PercMoradDPPOColetTot_munic_22_pol.fid-703dc0a5_191866d88cb_-a07,3532868,Nova Castilho - SP,867,971,104,1062,81.64,91.43,9.79
sidra_9541_PercMoradDPPOColetTot_munic_22_pol.fid-703dc0a5_191866d88cb_-a06,3532900,Nova Europa - SP,9138,9169,31,9299,98.27,98.6,0.33
sidra_9541_PercMoradDPPOColetTot_munic_22_pol.fid-703dc0a5_191866d88cb_-a05,3533007,Nova Granada - SP,17942,18592,650,19388,92.54,95.89,3.35
sidra_9541_PercMoradDPPOColetTot_munic_22_pol.fid-703dc0a5_191866d88cb_-a04,3544202,Riolândia - SP,7388,7657,269,7889,93.65,97.06,3.41
sidra_9541_PercMoradDPPOColetTot_munic_22_pol.fid-703dc0a5_191866d88cb_-a03,3533304,Nova Luzitânia - SP,2725,2786,61,2836,96.09,98.24,2.15
sidra_9541_PercMoradDPPOColetTot_munic_22_pol.fid-703dc0a5_191866d88cb_-a02,3533403,Nova Odessa - SP,59878,61810,1932,61903,96.73,99.85,3.12
sidra_9541_PercMoradDPPOColetTot_munic_22_pol.fid-703dc0a5_191866d88cb_-a01,3533502,Novo Horizonte - SP,36305,37244,939,38241,94.94,97.39,2.46
sidra_9541_PercMoradDPPOColetTot_munic_22_pol.fid-703dc0a5_191866d88cb_-a00,3533601,Nuporanga - SP,6883,7251,368,7361,93.51,98.51,5
sidra_9541_PercMoradDPPOColetTot_munic_22_pol.fid-703dc0a5_191866d88cb_-9ff,3533700,Ocauçu - SP,3822,3881,59,4325,88.37,89.73,1.36
sidra_9541_PercMoradDPPOColetTot_munic_22_pol.fid-703dc0a5_191866d88cb_-9fe,3533809,Óleo - SP,2060,2269,209,2512,82.01,90.33,8.32
sidra_9541_PercMoradDPPOColetTot_munic_22_pol.fid-703dc0a5_191866d88cb_-9fd,3533908,Olímpia - SP,53334,53811,477,54984,97,97.87,0.87
sidra_9541_PercMoradDPPOColetTot_munic_22_pol.fid-703dc0a5_191866d88cb_-9fc,3534005,Onda Verde - SP,4411,4593,182,4766,92.55,96.37,3.82
sidra_9541_PercMoradDPPOColetTot_munic_22_pol.fid-703dc0a5_191866d88cb_-9fb,3534104,Oriente - SP,5872,5958,86,6060,96.9,98.32,1.42
sidra_9541_PercMoradDPPOColetTot_munic_22_pol.fid-703dc0a5_191866d88cb_-9fa,3534203,Orindiúva - SP,5608,5875,267,5994,93.56,98.01,4.45
sidra_9541_PercMoradDPPOColetTot_munic_22_pol.fid-703dc0a5_191866d88cb_-9f9,3548906,São Carlos - SP,235898,252587,16689,253692,92.99,99.56,6.58
sidra_9541_PercMoradDPPOColetTot_munic_22_pol.fid-703dc0a5_191866d88cb_-9f8,3534302,Orlândia - SP,31291,37730,6439,38254,81.8,98.63,16.83
sidra_9541_PercMoradDPPOColetTot_munic_22_pol.fid-703dc0a5_191866d88cb_-9f7,3534401,Osasco - SP,651469,721816,70347,725647,89.78,99.47,9.69
sidra_9541_PercMoradDPPOColetTot_munic_22_pol.fid-703dc0a5_191866d88cb_-9f6,3534500,Oscar Bressane - SP,2158,2374,216,2470,87.37,96.11,8.74
sidra_9541_PercMoradDPPOColetTot_munic_22_pol.fid-703dc0a5_191866d88cb_-9f5,3534609,Osvaldo Cruz - SP,28933,29062,129,30025,96.36,96.79,0.43
sidra_9541_PercMoradDPPOColetTot_munic_22_pol.fid-703dc0a5_191866d88cb_-9f4,3534708,Ourinhos - SP,102312,103216,904,103632,98.73,99.6,0.87
sidra_9541_PercMoradDPPOColetTot_munic_22_pol.fid-703dc0a5_191866d88cb_-9f3,3534757,Ouroeste - SP,9475,9886,411,10279,92.18,96.18,4
sidra_9541_PercMoradDPPOColetTot_munic_22_pol.fid-703dc0a5_191866d88cb_-9f2,3534807,Ouro Verde - SP,7372,7499,127,7779,94.77,96.4,1.63
sidra_9541_PercMoradDPPOColetTot_munic_22_pol.fid-703dc0a5_191866d88cb_-9f1,3534906,Pacaembu - SP,8976,9191,215,9787,91.71,93.91,2.2
sidra_9541_PercMoradDPPOColetTot_munic_22_pol.fid-703dc0a5_191866d88cb_-9f0,3535002,Palestina - SP,10118,10543,425,11452,88.35,92.06,3.71
sidra_9541_PercMoradDPPOColetTot_munic_22_pol.fid-703dc0a5_191866d88cb_-9ef,3551306,Sebastianópolis do Sul - SP,2720,2909,189,3130,86.9,92.94,6.04
sidra_9541_PercMoradDPPOColetTot_munic_22_pol.fid-703dc0a5_191866d88cb_-9ee,3551405,Serra Azul - SP,8787,8835,48,9008,97.55,98.08,0.53
sidra_9541_PercMoradDPPOColetTot_munic_22_pol.fid-703dc0a5_191866d88cb_-9ed,3551504,Serrana - SP,42617,43660,1043,43784,97.33,99.72,2.38
sidra_9541_PercMoradDPPOColetTot_munic_22_pol.fid-703dc0a5_191866d88cb_-9ec,3551603,Serra Negra - SP,26439,29502,3063,29823,88.65,98.92,10.27
sidra_9541_PercMoradDPPOColetTot_munic_22_pol.fid-703dc0a5_191866d88cb_-9eb,3551702,Sertãozinho - SP,124847,126329,1482,126731,98.51,99.68,1.17
sidra_9541_PercMoradDPPOColetTot_munic_22_pol.fid-703dc0a5_191866d88cb_-9ea,3551801,Sete Barras - SP,10857,11846,989,12690,85.56,93.35,7.79
sidra_9541_PercMoradDPPOColetTot_munic_22_pol.fid-703dc0a5_191866d88cb_-9e9,3535101,Palmares Paulista - SP,9461,9509,48,9634,98.2,98.7,0.5
sidra_9541_PercMoradDPPOColetTot_munic_22_pol.fid-703dc0a5_191866d88cb_-9e8,3535200,Palmeira d'Oeste - SP,7438,7843,405,8878,83.78,88.34,4.56
sidra_9541_PercMoradDPPOColetTot_munic_22_pol.fid-703dc0a5_191866d88cb_-9e7,3535309,Palmital - SP,18596,18839,243,19565,95.05,96.29,1.24
sidra_9541_PercMoradDPPOColetTot_munic_22_pol.fid-703dc0a5_191866d88cb_-9e6,3535408,Panorama - SP,14554,14672,118,14938,97.43,98.22,0.79
sidra_9541_PercMoradDPPOColetTot_munic_22_pol.fid-703dc0a5_191866d88cb_-9e5,3535507,Paraguaçu Paulista - SP,37684,38189,505,39859,94.54,95.81,1.27
sidra_9541_PercMoradDPPOColetTot_munic_22_pol.fid-703dc0a5_191866d88cb_-9e4,3535606,Paraibuna - SP,11674,16836,5162,17612,66.28,95.59,29.31
sidra_9541_PercMoradDPPOColetTot_munic_22_pol.fid-703dc0a5_191866d88cb_-9e3,3536257,Parisi - SP,2529,2698,169,2890,87.51,93.36,5.85
sidra_9541_PercMoradDPPOColetTot_munic_22_pol.fid-703dc0a5_191866d88cb_-9e2,3536307,Patrocínio Paulista - SP,12419,13380,961,14473,85.81,92.45,6.64
sidra_9541_PercMoradDPPOColetTot_munic_22_pol.fid-703dc0a5_191866d88cb_-9e1,3536406,Paulicéia - SP,7139,7374,235,7923,90.1,93.07,2.97
sidra_9541_PercMoradDPPOColetTot_munic_22_pol.fid-703dc0a5_191866d88cb_-9e0,3536505,Paulínia - SP,95603,110069,14466,110145,86.8,99.93,13.13
sidra_9541_PercMoradDPPOColetTot_munic_22_pol.fid-703dc0a5_191866d88cb_-9df,3536570,Paulistânia - SP,1946,2002,56,2090,93.11,95.79,2.68
sidra_9541_PercMoradDPPOColetTot_munic_22_pol.fid-703dc0a5_191866d88cb_-9de,3536604,Paulo de Faria - SP,6486,6803,317,7176,90.38,94.8,4.42
sidra_9541_PercMoradDPPOColetTot_munic_22_pol.fid-703dc0a5_191866d88cb_-9dd,3536703,Pederneiras - SP,41629,42755,1126,44660,93.21,95.73,2.52
sidra_9541_PercMoradDPPOColetTot_munic_22_pol.fid-703dc0a5_191866d88cb_-9dc,3553401,Tanabi - SP,23037,23710,673,25213,91.37,94.04,2.67
sidra_9541_PercMoradDPPOColetTot_munic_22_pol.fid-703dc0a5_191866d88cb_-9db,3553500,Tapiraí - SP,6440,7572,1132,7978,80.72,94.91,14.19
sidra_9541_PercMoradDPPOColetTot_munic_22_pol.fid-703dc0a5_191866d88cb_-9da,3553609,Tapiratiba - SP,11065,11402,337,11752,94.15,97.02,2.87
sidra_9541_PercMoradDPPOColetTot_munic_22_pol.fid-703dc0a5_191866d88cb_-9d9,3536802,Pedra Bela - SP,4803,6410,1607,6526,73.6,98.22,24.62
sidra_9541_PercMoradDPPOColetTot_munic_22_pol.fid-703dc0a5_191866d88cb_-9d8,3536901,Pedranópolis - SP,2191,2362,171,2737,80.05,86.3,6.25
sidra_9541_PercMoradDPPOColetTot_munic_22_pol.fid-703dc0a5_191866d88cb_-9d7,3537008,Pedregulho - SP,13344,15026,1682,15493,86.13,96.99,10.86
sidra_9541_PercMoradDPPOColetTot_munic_22_pol.fid-703dc0a5_191866d88cb_-9d6,3537107,Pedreira - SP,40903,42804,1901,43020,95.08,99.5,4.42
sidra_9541_PercMoradDPPOColetTot_munic_22_pol.fid-703dc0a5_191866d88cb_-9d5,3537156,Pedrinhas Paulista - SP,2554,2620,66,2801,91.18,93.54,2.36
sidra_9541_PercMoradDPPOColetTot_munic_22_pol.fid-703dc0a5_191866d88cb_-9d4,3537206,Pedro de Toledo - SP,9109,10280,1171,11244,81.01,91.43,10.41
sidra_9541_PercMoradDPPOColetTot_munic_22_pol.fid-703dc0a5_191866d88cb_-9d2,3537305,Penápolis - SP,56075,59795,3720,61406,91.32,97.38,6.06
sidra_9541_PercMoradDPPOColetTot_munic_22_pol.fid-703dc0a5_191866d88cb_-9d1,3537404,Pereira Barreto - SP,22334,22905,571,24025,92.96,95.34,2.38
sidra_9541_PercMoradDPPOColetTot_munic_22_pol.fid-703dc0a5_191866d88cb_-9d0,3537503,Pereiras - SP,4486,8399,3913,8721,51.44,96.31,44.87
sidra_9541_PercMoradDPPOColetTot_munic_22_pol.fid-703dc0a5_191866d88cb_-9cf,3537602,Peruíbe - SP,65148,67073,1925,67893,95.96,98.79,2.84
sidra_9541_PercMoradDPPOColetTot_munic_22_pol.fid-703dc0a5_191866d88cb_-9ce,3537701,Piacatu - SP,5222,5386,164,5490,95.12,98.11,2.99
sidra_9541_PercMoradDPPOColetTot_munic_22_pol.fid-703dc0a5_191866d88cb_-9cd,3537800,Piedade - SP,29919,51136,21217,52819,56.64,96.81,40.17
sidra_9541_PercMoradDPPOColetTot_munic_22_pol.fid-703dc0a5_191866d88cb_-9cc,3537909,Pilar do Sul - SP,22905,26710,3805,27534,83.19,97.01,13.82
sidra_9541_PercMoradDPPOColetTot_munic_22_pol.fid-703dc0a5_191866d88cb_-9cb,3538006,Pindamonhangaba - SP,160165,164329,4164,165068,97.03,99.55,2.52
sidra_9541_PercMoradDPPOColetTot_munic_22_pol.fid-703dc0a5_191866d88cb_-9ca,3538105,Pindorama - SP,13955,14135,180,14473,96.42,97.66,1.24
sidra_9541_PercMoradDPPOColetTot_munic_22_pol.fid-703dc0a5_191866d88cb_-9c9,3538204,Pinhalzinho - SP,11220,14969,3749,15164,73.99,98.71,24.72
sidra_9541_PercMoradDPPOColetTot_munic_22_pol.fid-703dc0a5_191866d88cb_-9c8,3538303,Piquerobi - SP,2746,2789,43,3264,84.13,85.45,1.32
sidra_9541_PercMoradDPPOColetTot_munic_22_pol.fid-703dc0a5_191866d88cb_-9c7,3538501,Piquete - SP,11291,12289,998,12451,90.68,98.7,8.02
sidra_9541_PercMoradDPPOColetTot_munic_22_pol.fid-703dc0a5_191866d88cb_-9c6,3538600,Piracaia - SP,22583,25612,3029,25967,86.97,98.63,11.66
sidra_9541_PercMoradDPPOColetTot_munic_22_pol.fid-703dc0a5_191866d88cb_-9c5,3538709,Piracicaba - SP,394875,418712,23837,419850,94.05,99.73,5.68
sidra_9541_PercMoradDPPOColetTot_munic_22_pol.fid-703dc0a5_191866d88cb_-9c4,3538808,Piraju - SP,27870,28720,850,29348,94.96,97.86,2.9
sidra_9541_PercMoradDPPOColetTot_munic_22_pol.fid-703dc0a5_191866d88cb_-9c3,3538907,Pirajuí - SP,18032,18443,411,19102,94.4,96.55,2.15
sidra_9541_PercMoradDPPOColetTot_munic_22_pol.fid-703dc0a5_191866d88cb_-9c2,3539905,Poloni - SP,5132,5146,14,5583,91.92,92.17,0.25
sidra_9541_PercMoradDPPOColetTot_munic_22_pol.fid-703dc0a5_191866d88cb_-9c1,3540002,Pompéia - SP,19358,19694,336,20163,96.01,97.67,1.67
sidra_9541_PercMoradDPPOColetTot_munic_22_pol.fid-703dc0a5_191866d88cb_-9c0,3540101,Pongaí - SP,2993,3258,265,3393,88.21,96.02,7.81
sidra_9541_PercMoradDPPOColetTot_munic_22_pol.fid-703dc0a5_191866d88cb_-9bf,3540200,Pontal - SP,36518,36901,383,37014,98.66,99.69,1.03
sidra_9541_PercMoradDPPOColetTot_munic_22_pol.fid-703dc0a5_191866d88cb_-9be,3540259,Pontalinda - SP,3725,3806,81,4121,90.39,92.36,1.97
sidra_9541_PercMoradDPPOColetTot_munic_22_pol.fid-703dc0a5_191866d88cb_-9bd,3540309,Pontes Gestal - SP,2194,2272,78,2387,91.91,95.18,3.27
sidra_9541_PercMoradDPPOColetTot_munic_22_pol.fid-703dc0a5_191866d88cb_-9bc,3540408,Populina - SP,3634,3869,235,4111,88.4,94.11,5.72
sidra_9541_PercMoradDPPOColetTot_munic_22_pol.fid-703dc0a5_191866d88cb_-9bb,3540507,Porangaba - SP,5855,10036,4181,10445,56.06,96.08,40.03
sidra_9541_PercMoradDPPOColetTot_munic_22_pol.fid-703dc0a5_191866d88cb_-9b9,3540606,Porto Feliz - SP,41988,54065,12077,55063,76.25,98.19,21.93
sidra_9541_PercMoradDPPOColetTot_munic_22_pol.fid-703dc0a5_191866d88cb_-9b8,3540705,Porto Ferreira - SP,51440,52073,633,52571,97.85,99.05,1.2
sidra_9541_PercMoradDPPOColetTot_munic_22_pol.fid-703dc0a5_191866d88cb_-9b7,3540754,Potim - SP,17368,17478,110,17525,99.1,99.73,0.63
sidra_9541_PercMoradDPPOColetTot_munic_22_pol.fid-703dc0a5_191866d88cb_-9b6,3540804,Potirendaba - SP,17773,18055,282,18464,96.26,97.78,1.53
sidra_9541_PercMoradDPPOColetTot_munic_22_pol.fid-703dc0a5_191866d88cb_-9b5,3540853,Pracinha - SP,1398,1398,,1427,97.97,97.97,
sidra_9541_PercMoradDPPOColetTot_munic_22_pol.fid-703dc0a5_191866d88cb_-9b4,3555307,Turmalina - SP,1439,1535,96,1669,86.22,91.97,5.75
sidra_9541_PercMoradDPPOColetTot_munic_22_pol.fid-703dc0a5_191866d88cb_-9b3,3555356,Ubarana - SP,5190,5271,81,5365,96.74,98.25,1.51
sidra_9541_PercMoradDPPOColetTot_munic_22_pol.fid-703dc0a5_191866d88cb_-9b2,3555406,Ubatuba - SP,80858,92370,11512,92792,87.14,99.55,12.41
sidra_9541_PercMoradDPPOColetTot_munic_22_pol.fid-703dc0a5_191866d88cb_-9b1,3555505,Ubirajara - SP,4477,4700,223,5129,87.29,91.64,4.35
sidra_9541_PercMoradDPPOColetTot_munic_22_pol.fid-703dc0a5_191866d88cb_-9b0,3555604,Uchoa - SP,9779,9799,20,10370,94.3,94.49,0.19
sidra_9541_PercMoradDPPOColetTot_munic_22_pol.fid-703dc0a5_191866d88cb_-9af,3540903,Pradópolis - SP,16075,16081,6,17071,94.17,94.2,0.04
sidra_9541_PercMoradDPPOColetTot_munic_22_pol.fid-703dc0a5_191866d88cb_-9ae,3541000,Praia Grande - SP,337414,347341,9927,348540,96.81,99.66,2.85
sidra_9541_PercMoradDPPOColetTot_munic_22_pol.fid-703dc0a5_191866d88cb_-9ad,3541059,Pratânia - SP,4869,5036,167,5126,94.99,98.24,3.26
sidra_9541_PercMoradDPPOColetTot_munic_22_pol.fid-703dc0a5_191866d88cb_-9ac,3541109,Presidente Alves - SP,3433,3604,171,3800,90.34,94.84,4.5
sidra_9541_PercMoradDPPOColetTot_munic_22_pol.fid-703dc0a5_191866d88cb_-9ab,3541208,Presidente Bernardes - SP,10330,10797,467,12415,83.21,86.97,3.76
sidra_9541_PercMoradDPPOColetTot_munic_22_pol.fid-703dc0a5_191866d88cb_-9a9,3541307,Presidente Epitácio - SP,37044,37693,649,39345,94.15,95.8,1.65
sidra_9541_PercMoradDPPOColetTot_munic_22_pol.fid-703dc0a5_191866d88cb_-9a8,3541406,Presidente Prudente - SP,217234,222137,4903,223789,97.07,99.26,2.19
sidra_9541_PercMoradDPPOColetTot_munic_22_pol.fid-703dc0a5_191866d88cb_-9a7,3541505,Presidente Venceslau - SP,32833,33078,245,34332,95.63,96.35,0.71
sidra_9541_PercMoradDPPOColetTot_munic_22_pol.fid-703dc0a5_191866d88cb_-9a6,3541604,Promissão - SP,30030,31257,1227,35021,85.75,89.25,3.5
sidra_9541_PercMoradDPPOColetTot_munic_22_pol.fid-703dc0a5_191866d88cb_-9a5,3541653,Quadra - SP,2481,3182,701,3376,73.49,94.25,20.76
sidra_9541_PercMoradDPPOColetTot_munic_22_pol.fid-703dc0a5_191866d88cb_-9a4,3541703,Quatá - SP,12684,12803,119,13128,96.62,97.52,0.91
sidra_9541_PercMoradDPPOColetTot_munic_22_pol.fid-703dc0a5_191866d88cb_-9a3,3541802,Queiroz - SP,3000,3190,190,3259,92.05,97.88,5.83
sidra_9541_PercMoradDPPOColetTot_munic_22_pol.fid-703dc0a5_191866d88cb_-9a2,3541901,Queluz - SP,8091,8899,808,9088,89.03,97.92,8.89
sidra_9541_PercMoradDPPOColetTot_munic_22_pol.fid-703dc0a5_191866d88cb_-9a1,3543204,Ribeirão do Sul - SP,4208,4436,228,4677,89.97,94.85,4.87
sidra_9541_PercMoradDPPOColetTot_munic_22_pol.fid-703dc0a5_191866d88cb_-9a0,3543238,Ribeirão dos Índios - SP,1830,1917,87,2025,90.37,94.67,4.3
sidra_9541_PercMoradDPPOColetTot_munic_22_pol.fid-703dc0a5_191866d88cb_-99f,3543253,Ribeirão Grande - SP,6801,7000,199,7450,91.29,93.96,2.67
sidra_9541_PercMoradDPPOColetTot_munic_22_pol.fid-703dc0a5_191866d88cb_-99e,3543303,Ribeirão Pires - SP,113235,114660,1425,115102,98.38,99.62,1.24
sidra_9541_PercMoradDPPOColetTot_munic_22_pol.fid-703dc0a5_191866d88cb_-99d,3543402,Ribeirão Preto - SP,667798,692829,25031,694328,96.18,99.78,3.61
sidra_9541_PercMoradDPPOColetTot_munic_22_pol.fid-703dc0a5_191866d88cb_-99c,3543501,Riversul - SP,4823,5021,198,5593,86.23,89.77,3.54
sidra_9541_PercMoradDPPOColetTot_munic_22_pol.fid-703dc0a5_191866d88cb_-99b,3543600,Rifaina - SP,3564,3970,406,4013,88.81,98.93,10.12
sidra_9541_PercMoradDPPOColetTot_munic_22_pol.fid-703dc0a5_191866d88cb_-99a,3543709,Rincão - SP,8696,8900,204,9077,95.8,98.05,2.25
sidra_9541_PercMoradDPPOColetTot_munic_22_pol.fid-703dc0a5_191866d88cb_-999,3543808,Rinópolis - SP,8376,8465,89,9216,90.89,91.85,0.97
sidra_9541_PercMoradDPPOColetTot_munic_22_pol.fid-703dc0a5_191866d88cb_-998,3543907,Rio Claro - SP,191697,199251,7554,200342,95.68,99.46,3.77
sidra_9541_PercMoradDPPOColetTot_munic_22_pol.fid-703dc0a5_191866d88cb_-997,3544004,Rio das Pedras - SP,29615,30823,1208,31302,94.61,98.47,3.86
sidra_9541_PercMoradDPPOColetTot_munic_22_pol.fid-703dc0a5_191866d88cb_-996,3544103,Rio Grande da Serra - SP,42798,43543,745,44059,97.14,98.83,1.69
sidra_9541_PercMoradDPPOColetTot_munic_22_pol.fid-703dc0a5_191866d88cb_-995,3544251,Rosana - SP,14089,14468,379,17257,81.64,83.84,2.2
sidra_9541_PercMoradDPPOColetTot_munic_22_pol.fid-703dc0a5_191866d88cb_-994,3544301,Roseira - SP,10388,10651,263,10828,95.94,98.37,2.43
sidra_9541_PercMoradDPPOColetTot_munic_22_pol.fid-703dc0a5_191866d88cb_-993,3544400,Rubiácea - SP,2566,2630,64,2699,95.07,97.44,2.37
sidra_9541_PercMoradDPPOColetTot_munic_22_pol.fid-703dc0a5_191866d88cb_-992,3544509,Rubinéia - SP,3668,3753,85,3825,95.9,98.12,2.22
sidra_9541_PercMoradDPPOColetTot_munic_22_pol.fid-703dc0a5_191866d88cb_-991,4312625,Muliterno - RS,1516,1628,112,1712,88.55,95.09,6.54
sidra_9541_PercMoradDPPOColetTot_munic_22_pol.fid-703dc0a5_191866d88cb_-990,3544608,Sabino - SP,4747,4820,73,5112,92.86,94.29,1.43
sidra_9541_PercMoradDPPOColetTot_munic_22_pol.fid-703dc0a5_191866d88cb_-98f,3544707,Sagres - SP,2214,2283,69,2469,89.67,92.47,2.79
sidra_9541_PercMoradDPPOColetTot_munic_22_pol.fid-703dc0a5_191866d88cb_-98e,3544806,Sales - SP,6047,6145,98,6416,94.25,95.78,1.53
sidra_9541_PercMoradDPPOColetTot_munic_22_pol.fid-703dc0a5_191866d88cb_-98d,3544905,Sales Oliveira - SP,10724,11075,351,11380,94.24,97.32,3.08
sidra_9541_PercMoradDPPOColetTot_munic_22_pol.fid-703dc0a5_191866d88cb_-98c,3545001,Salesópolis - SP,9275,13570,4295,15058,61.6,90.12,28.52
sidra_9541_PercMoradDPPOColetTot_munic_22_pol.fid-703dc0a5_191866d88cb_-98b,3545100,Salmourão - SP,4597,4666,69,4788,96.01,97.45,1.44
sidra_9541_PercMoradDPPOColetTot_munic_22_pol.fid-703dc0a5_191866d88cb_-98a,3545159,Saltinho - SP,7879,8131,252,8161,96.54,99.63,3.09
sidra_9541_PercMoradDPPOColetTot_munic_22_pol.fid-703dc0a5_191866d88cb_-989,3545209,Salto - SP,19085,133733,114648,134092,14.23,99.73,85.5
sidra_9541_PercMoradDPPOColetTot_munic_22_pol.fid-703dc0a5_191866d88cb_-988,3545308,Salto de Pirapora - SP,32267,43290,11023,43645,73.93,99.19,25.26
sidra_9541_PercMoradDPPOColetTot_munic_22_pol.fid-703dc0a5_191866d88cb_-987,4313334,Nova Ramada - RS,854,1431,577,2163,39.48,66.16,26.68
sidra_9541_PercMoradDPPOColetTot_munic_22_pol.fid-703dc0a5_191866d88cb_-986,4313359,Nova Roma do Sul - RS,2586,2957,371,3456,74.83,85.56,10.73
sidra_9541_PercMoradDPPOColetTot_munic_22_pol.fid-703dc0a5_191866d88cb_-985,3545407,Salto Grande - SP,8587,8655,68,8994,95.47,96.23,0.76
sidra_9541_PercMoradDPPOColetTot_munic_22_pol.fid-703dc0a5_191866d88cb_-984,3545506,Sandovalina - SP,2780,2874,94,3521,78.95,81.62,2.67
sidra_9541_PercMoradDPPOColetTot_munic_22_pol.fid-703dc0a5_191866d88cb_-983,3545605,Santa Adélia - SP,13482,13634,152,13959,96.58,97.67,1.09
sidra_9541_PercMoradDPPOColetTot_munic_22_pol.fid-703dc0a5_191866d88cb_-982,3545704,Santa Albertina - SP,5586,6077,491,6340,88.11,95.85,7.74
sidra_9541_PercMoradDPPOColetTot_munic_22_pol.fid-703dc0a5_191866d88cb_-981,3545803,Santa Bárbara d'Oeste - SP,173759,182962,9203,183095,94.9,99.93,5.03
sidra_9541_PercMoradDPPOColetTot_munic_22_pol.fid-703dc0a5_191866d88cb_-980,3546009,Santa Branca - SP,12485,13756,1271,13962,89.42,98.52,9.1
sidra_9541_PercMoradDPPOColetTot_munic_22_pol.fid-703dc0a5_191866d88cb_-97e,3546108,Santa Clara d'Oeste - SP,2362,2422,60,2592,91.13,93.44,2.31
sidra_9541_PercMoradDPPOColetTot_munic_22_pol.fid-703dc0a5_191866d88cb_-97d,3556958,Vitória Brasil - SP,1617,1680,63,1794,90.13,93.65,3.51
sidra_9541_PercMoradDPPOColetTot_munic_22_pol.fid-703dc0a5_191866d88cb_-97c,3557006,Votorantim - SP,106814,126546,19732,126910,84.17,99.71,15.55
sidra_9541_PercMoradDPPOColetTot_munic_22_pol.fid-703dc0a5_191866d88cb_-97b,3557105,Votuporanga - SP,94527,95288,761,96527,97.93,98.72,0.79
sidra_9541_PercMoradDPPOColetTot_munic_22_pol.fid-703dc0a5_191866d88cb_-97a,3557154,Zacarias - SP,2210,2272,62,2692,82.1,84.4,2.3
sidra_9541_PercMoradDPPOColetTot_munic_22_pol.fid-703dc0a5_191866d88cb_-979,3557204,Chavantes - SP,11944,12045,101,12164,98.19,99.02,0.83
sidra_9541_PercMoradDPPOColetTot_munic_22_pol.fid-703dc0a5_191866d88cb_-978,3546207,Santa Cruz da Conceição - SP,3958,4022,64,4271,92.67,94.17,1.5
sidra_9541_PercMoradDPPOColetTot_munic_22_pol.fid-703dc0a5_191866d88cb_-977,3546256,Santa Cruz da Esperança - SP,1715,1940,225,2116,81.05,91.68,10.63
sidra_9541_PercMoradDPPOColetTot_munic_22_pol.fid-703dc0a5_191866d88cb_-976,3546306,Santa Cruz das Palmeiras - SP,28154,28369,215,28814,97.71,98.46,0.75
sidra_9541_PercMoradDPPOColetTot_munic_22_pol.fid-703dc0a5_191866d88cb_-975,3546405,Santa Cruz do Rio Pardo - SP,43430,45364,1934,46314,93.77,97.95,4.18
sidra_9541_PercMoradDPPOColetTot_munic_22_pol.fid-703dc0a5_191866d88cb_-974,3546504,Santa Ernestina - SP,6017,6033,16,6116,98.38,98.64,0.26
sidra_9541_PercMoradDPPOColetTot_munic_22_pol.fid-703dc0a5_191866d88cb_-973,3546603,Santa Fé do Sul - SP,33708,33952,244,34655,97.27,97.97,0.7
sidra_9541_PercMoradDPPOColetTot_munic_22_pol.fid-703dc0a5_191866d88cb_-972,4313441,Novo Tiradentes - RS,919,1355,436,2146,42.82,63.14,20.32
sidra_9541_PercMoradDPPOColetTot_munic_22_pol.fid-703dc0a5_191866d88cb_-971,4313466,Novo Xingu - RS,1009,1243,234,1646,61.3,75.52,14.22
sidra_9541_PercMoradDPPOColetTot_munic_22_pol.fid-703dc0a5_191866d88cb_-970,4313490,Novo Barreiro - RS,2312,2916,604,4272,54.12,68.26,14.14
sidra_9541_PercMoradDPPOColetTot_munic_22_pol.fid-703dc0a5_191866d88cb_-96f,3546702,Santa Gertrudes - SP,5189,23376,18187,23487,22.09,99.53,77.43
sidra_9541_PercMoradDPPOColetTot_munic_22_pol.fid-703dc0a5_191866d88cb_-96e,3546801,Santa Isabel - SP,39553,52156,12603,53027,74.59,98.36,23.77
sidra_9541_PercMoradDPPOColetTot_munic_22_pol.fid-703dc0a5_191866d88cb_-96d,4313508,Osório - RS,43503,45622,2119,45955,94.66,99.28,4.61
sidra_9541_PercMoradDPPOColetTot_munic_22_pol.fid-703dc0a5_191866d88cb_-96c,4313607,Paim Filho - RS,1623,2970,1347,3629,44.72,81.84,37.12
sidra_9541_PercMoradDPPOColetTot_munic_22_pol.fid-703dc0a5_191866d88cb_-96b,4313656,Palmares do Sul - RS,12276,12622,346,12815,95.79,98.49,2.7
sidra_9541_PercMoradDPPOColetTot_munic_22_pol.fid-703dc0a5_191866d88cb_-96a,4313706,Palmeira das Missões - RS,29103,30201,1098,32931,88.38,91.71,3.33
sidra_9541_PercMoradDPPOColetTot_munic_22_pol.fid-703dc0a5_191866d88cb_-969,4313805,Palmitinho - RS,5249,6084,835,7817,67.15,77.83,10.68
sidra_9541_PercMoradDPPOColetTot_munic_22_pol.fid-703dc0a5_191866d88cb_-968,4313904,Panambi - RS,27049,42417,15368,43407,62.31,97.72,35.4
sidra_9541_PercMoradDPPOColetTot_munic_22_pol.fid-703dc0a5_191866d88cb_-967,3546900,Santa Lúcia - SP,6932,6986,54,7141,97.07,97.83,0.76
sidra_9541_PercMoradDPPOColetTot_munic_22_pol.fid-703dc0a5_191866d88cb_-966,3547007,Santa Maria da Serra - SP,4886,5110,224,5239,93.26,97.54,4.28
sidra_9541_PercMoradDPPOColetTot_munic_22_pol.fid-703dc0a5_191866d88cb_-965,4314076,Passo do Sobrado - RS,5335,5445,110,5993,89.02,90.86,1.84
sidra_9541_PercMoradDPPOColetTot_munic_22_pol.fid-703dc0a5_191866d88cb_-964,4314100,Passo Fundo - RS,184226,203074,18848,204815,89.95,99.15,9.2
sidra_9541_PercMoradDPPOColetTot_munic_22_pol.fid-703dc0a5_191866d88cb_-963,4314134,Paulo Bento - RS,1609,1673,64,2144,75.05,78.03,2.99
sidra_9541_PercMoradDPPOColetTot_munic_22_pol.fid-703dc0a5_191866d88cb_-962,3547106,Santa Mercedes - SP,2746,2848,102,2956,92.9,96.35,3.45
sidra_9541_PercMoradDPPOColetTot_munic_22_pol.fid-703dc0a5_191866d88cb_-961,3547205,Santana da Ponte Pensa - SP,1293,1427,134,1670,77.43,85.45,8.02
sidra_9541_PercMoradDPPOColetTot_munic_22_pol.fid-703dc0a5_191866d88cb_-960,3547304,Santana de Parnaíba - SP,145630,153803,8173,154053,94.53,99.84,5.31
sidra_9541_PercMoradDPPOColetTot_munic_22_pol.fid-703dc0a5_191866d88cb_-95f,3557303,Estiva Gerbi - SP,10909,11057,148,11236,97.09,98.41,1.32
sidra_9541_PercMoradDPPOColetTot_munic_22_pol.fid-703dc0a5_191866d88cb_-95e,3547403,Santa Rita d'Oeste - SP,2319,2391,72,2733,84.85,87.49,2.63
sidra_9541_PercMoradDPPOColetTot_munic_22_pol.fid-703dc0a5_191866d88cb_-95d,3547502,Santa Rita do Passa Quatro - SP,23187,23835,648,24691,93.91,96.53,2.62
sidra_9541_PercMoradDPPOColetTot_munic_22_pol.fid-703dc0a5_191866d88cb_-95c,3547601,Santa Rosa de Viterbo - SP,22648,23087,439,23369,96.91,98.79,1.88
sidra_9541_PercMoradDPPOColetTot_munic_22_pol.fid-703dc0a5_191866d88cb_-95b,4100103,Abatiá - PR,5685,6101,416,7202,78.94,84.71,5.78
sidra_9541_PercMoradDPPOColetTot_munic_22_pol.fid-703dc0a5_191866d88cb_-95a,4100202,Adrianópolis - PR,4478,5075,597,6248,71.67,81.23,9.56
sidra_9541_PercMoradDPPOColetTot_munic_22_pol.fid-703dc0a5_191866d88cb_-959,4100301,Agudos do Sul - PR,7398,9093,1695,10169,72.75,89.42,16.67
sidra_9541_PercMoradDPPOColetTot_munic_22_pol.fid-703dc0a5_191866d88cb_-958,4100400,Almirante Tamandaré - PR,116448,118695,2247,119406,97.52,99.4,1.88
sidra_9541_PercMoradDPPOColetTot_munic_22_pol.fid-703dc0a5_191866d88cb_-957,4100459,Altamira do Paraná - PR,2192,2619,427,3586,61.13,73.03,11.91
sidra_9541_PercMoradDPPOColetTot_munic_22_pol.fid-703dc0a5_191866d88cb_-956,3547650,Santa Salete - SP,1339,1493,154,1643,81.5,90.87,9.37
sidra_9541_PercMoradDPPOColetTot_munic_22_pol.fid-703dc0a5_191866d88cb_-955,3547700,Santo Anastácio - SP,16830,17149,319,17908,93.98,95.76,1.78
sidra_9541_PercMoradDPPOColetTot_munic_22_pol.fid-703dc0a5_191866d88cb_-954,3547809,Santo André - SP,704983,744986,40003,745671,94.54,99.91,5.36
sidra_9541_PercMoradDPPOColetTot_munic_22_pol.fid-703dc0a5_191866d88cb_-953,3547908,Santo Antônio da Alegria - SP,5523,6551,1028,6756,81.75,96.97,15.22
sidra_9541_PercMoradDPPOColetTot_munic_22_pol.fid-703dc0a5_191866d88cb_-952,3548005,Santo Antônio de Posse - SP,21842,22944,1102,23161,94.31,99.06,4.76
sidra_9541_PercMoradDPPOColetTot_munic_22_pol.fid-703dc0a5_191866d88cb_-951,3548054,Santo Antônio do Aracanguá - SP,7183,7660,477,8374,85.78,91.47,5.7
sidra_9541_PercMoradDPPOColetTot_munic_22_pol.fid-703dc0a5_191866d88cb_-950,4103024,Boa Esperança do Iguaçu - PR,1263,1898,635,2442,51.72,77.72,26
sidra_9541_PercMoradDPPOColetTot_munic_22_pol.fid-703dc0a5_191866d88cb_-94f,4103040,Boa Ventura de São Roque - PR,1576,3789,2213,6302,25.01,60.12,35.12
sidra_9541_PercMoradDPPOColetTot_munic_22_pol.fid-703dc0a5_191866d88cb_-94e,3548104,Santo Antônio do Jardim - SP,4457,5800,1343,6126,72.76,94.68,21.92
sidra_9541_PercMoradDPPOColetTot_munic_22_pol.fid-703dc0a5_191866d88cb_-94d,4103370,Brasilândia do Sul - PR,3390,3392,2,3705,91.5,91.55,0.05
sidra_9541_PercMoradDPPOColetTot_munic_22_pol.fid-703dc0a5_191866d88cb_-94c,3548203,Santo Antônio do Pinhal - SP,5890,6939,1049,7120,82.72,97.46,14.73
sidra_9541_PercMoradDPPOColetTot_munic_22_pol.fid-703dc0a5_191866d88cb_-94b,3548302,Santo Expedito - SP,2920,2938,18,3000,97.33,97.93,0.6
sidra_9541_PercMoradDPPOColetTot_munic_22_pol.fid-703dc0a5_191866d88cb_-94a,3548401,Santópolis do Aguapeí - SP,3777,3779,2,3899,96.87,96.92,0.05
sidra_9541_PercMoradDPPOColetTot_munic_22_pol.fid-703dc0a5_191866d88cb_-949,3548500,Santos - SP,284813,414538,129725,416817,68.33,99.45,31.12
sidra_9541_PercMoradDPPOColetTot_munic_22_pol.fid-703dc0a5_191866d88cb_-948,3548609,São Bento do Sapucaí - SP,9947,11442,1495,11626,85.56,98.42,12.86
sidra_9541_PercMoradDPPOColetTot_munic_22_pol.fid-703dc0a5_191866d88cb_-947,3548708,São Bernardo do Campo - SP,699315,807969,108654,809708,86.37,99.79,13.42
sidra_9541_PercMoradDPPOColetTot_munic_22_pol.fid-703dc0a5_191866d88cb_-945,3548807,São Caetano do Sul - SP,158184,164928,6744,164949,95.9,99.99,4.09
sidra_9541_PercMoradDPPOColetTot_munic_22_pol.fid-703dc0a5_191866d88cb_-944,3549003,São Francisco - SP,2119,2228,109,2602,81.44,85.63,4.19
sidra_9541_PercMoradDPPOColetTot_munic_22_pol.fid-703dc0a5_191866d88cb_-943,3549102,São João da Boa Vista - SP,87923,90957,3034,92281,95.28,98.57,3.29
sidra_9541_PercMoradDPPOColetTot_munic_22_pol.fid-703dc0a5_191866d88cb_-942,3549201,São João das Duas Pontes - SP,2275,2401,126,2575,88.35,93.24,4.89
sidra_9541_PercMoradDPPOColetTot_munic_22_pol.fid-703dc0a5_191866d88cb_-941,3549250,São João de Iracema - SP,1779,1783,4,1845,96.42,96.64,0.22
sidra_9541_PercMoradDPPOColetTot_munic_22_pol.fid-703dc0a5_191866d88cb_-940,3549300,São João do Pau d'Alho - SP,2022,2107,85,2229,90.71,94.53,3.81
sidra_9541_PercMoradDPPOColetTot_munic_22_pol.fid-703dc0a5_191866d88cb_-93f,3549409,São Joaquim da Barra - SP,47074,48046,972,48453,97.15,99.16,2.01
sidra_9541_PercMoradDPPOColetTot_munic_22_pol.fid-703dc0a5_191866d88cb_-93e,3549508,São José da Bela Vista - SP,6977,7352,375,7597,91.84,96.78,4.94
sidra_9541_PercMoradDPPOColetTot_munic_22_pol.fid-703dc0a5_191866d88cb_-93d,3549607,São José do Barreiro - SP,3089,3553,464,3840,80.44,92.53,12.08
sidra_9541_PercMoradDPPOColetTot_munic_22_pol.fid-703dc0a5_191866d88cb_-93c,3549706,São José do Rio Pardo - SP,47944,49549,1605,51955,92.28,95.37,3.09
sidra_9541_PercMoradDPPOColetTot_munic_22_pol.fid-703dc0a5_191866d88cb_-93b,3549805,São José do Rio Preto - SP,460030,476761,16731,477426,96.36,99.86,3.5
sidra_9541_PercMoradDPPOColetTot_munic_22_pol.fid-703dc0a5_191866d88cb_-93a,3549904,São José dos Campos - SP,648872,693699,44827,695312,93.32,99.77,6.45
sidra_9541_PercMoradDPPOColetTot_munic_22_pol.fid-703dc0a5_191866d88cb_-939,3549953,São Lourenço da Serra - SP,11938,15586,3648,15997,74.63,97.43,22.8
sidra_9541_PercMoradDPPOColetTot_munic_22_pol.fid-703dc0a5_191866d88cb_-938,3550001,São Luiz do Paraitinga - SP,7843,9989,2146,10305,76.11,96.93,20.82
sidra_9541_PercMoradDPPOColetTot_munic_22_pol.fid-703dc0a5_191866d88cb_-937,3550100,São Manuel - SP,35957,36635,678,37231,96.58,98.4,1.82
sidra_9541_PercMoradDPPOColetTot_munic_22_pol.fid-703dc0a5_191866d88cb_-936,3550209,São Miguel Arcanjo - SP,26783,30125,3342,31958,83.81,94.26,10.46
sidra_9541_PercMoradDPPOColetTot_munic_22_pol.fid-703dc0a5_191866d88cb_-935,3550308,São Paulo - SP,10434175,11360720,926545,11395157,91.57,99.7,8.13
sidra_9541_PercMoradDPPOColetTot_munic_22_pol.fid-703dc0a5_191866d88cb_-933,3550407,São Pedro - SP,36883,37505,622,38103,96.8,98.43,1.63
sidra_9541_PercMoradDPPOColetTot_munic_22_pol.fid-703dc0a5_191866d88cb_-932,3550506,São Pedro do Turvo - SP,6012,6470,458,7210,83.38,89.74,6.35
sidra_9541_PercMoradDPPOColetTot_munic_22_pol.fid-703dc0a5_191866d88cb_-931,3550605,São Roque - SP,67811,78487,10676,79298,85.51,98.98,13.46
sidra_9541_PercMoradDPPOColetTot_munic_22_pol.fid-703dc0a5_191866d88cb_-930,3550704,São Sebastião - SP,62991,79983,16992,81435,77.35,98.22,20.87
sidra_9541_PercMoradDPPOColetTot_munic_22_pol.fid-703dc0a5_191866d88cb_-92f,3550803,São Sebastião da Grama - SP,9224,10115,891,10399,88.7,97.27,8.57
sidra_9541_PercMoradDPPOColetTot_munic_22_pol.fid-703dc0a5_191866d88cb_-92d,3550902,São Simão - SP,12413,12680,267,13406,92.59,94.58,1.99
sidra_9541_PercMoradDPPOColetTot_munic_22_pol.fid-703dc0a5_191866d88cb_-92c,3551009,São Vicente - SP,288316,323252,34936,324205,88.93,99.71,10.78
sidra_9541_PercMoradDPPOColetTot_munic_22_pol.fid-703dc0a5_191866d88cb_-92b,3551108,Sarapuí - SP,5763,10028,4265,10302,55.94,97.34,41.4
sidra_9541_PercMoradDPPOColetTot_munic_22_pol.fid-703dc0a5_191866d88cb_-92a,3551207,Sarutaiá - SP,3546,3594,48,3660,96.89,98.2,1.31
sidra_9541_PercMoradDPPOColetTot_munic_22_pol.fid-703dc0a5_191866d88cb_-929,3551900,Severínia - SP,14215,14328,113,14534,97.81,98.58,0.78
sidra_9541_PercMoradDPPOColetTot_munic_22_pol.fid-703dc0a5_191866d88cb_-928,3552007,Silveiras - SP,4616,5599,983,6174,74.77,90.69,15.92
sidra_9541_PercMoradDPPOColetTot_munic_22_pol.fid-703dc0a5_191866d88cb_-927,3552106,Socorro - SP,30078,38990,8912,39995,75.2,97.49,22.28
sidra_9541_PercMoradDPPOColetTot_munic_22_pol.fid-703dc0a5_191866d88cb_-926,3552205,Sorocaba - SP,217139,718250,501111,719534,30.18,99.82,69.64
sidra_9541_PercMoradDPPOColetTot_munic_22_pol.fid-703dc0a5_191866d88cb_-925,3552304,Sud Mennucci - SP,6670,6977,307,7351,90.74,94.91,4.18
sidra_9541_PercMoradDPPOColetTot_munic_22_pol.fid-703dc0a5_191866d88cb_-924,3552403,Sumaré - SP,263528,278425,14897,279328,94.34,99.68,5.33
sidra_9541_PercMoradDPPOColetTot_munic_22_pol.fid-703dc0a5_191866d88cb_-923,3552502,Suzano - SP,290094,305292,15198,306859,94.54,99.49,4.95
sidra_9541_PercMoradDPPOColetTot_munic_22_pol.fid-703dc0a5_191866d88cb_-922,3552551,Suzanápolis - SP,2804,2921,117,3407,82.3,85.74,3.43
sidra_9541_PercMoradDPPOColetTot_munic_22_pol.fid-703dc0a5_191866d88cb_-921,3552601,Tabapuã - SP,10468,10775,307,11267,92.91,95.63,2.72
sidra_9541_PercMoradDPPOColetTot_munic_22_pol.fid-703dc0a5_191866d88cb_-920,3552700,Tabatinga - SP,13503,13955,452,14748,91.56,94.62,3.06
sidra_9541_PercMoradDPPOColetTot_munic_22_pol.fid-703dc0a5_191866d88cb_-91f,3552809,Taboão da Serra - SP,243553,271585,28032,273322,89.11,99.36,10.26
sidra_9541_PercMoradDPPOColetTot_munic_22_pol.fid-703dc0a5_191866d88cb_-91e,3552908,Taciba - SP,5626,5768,142,6257,89.92,92.18,2.27
sidra_9541_PercMoradDPPOColetTot_munic_22_pol.fid-703dc0a5_191866d88cb_-91d,3553005,Taguaí - SP,12088,12312,224,12657,95.5,97.27,1.77
sidra_9541_PercMoradDPPOColetTot_munic_22_pol.fid-703dc0a5_191866d88cb_-91c,3553104,Taiaçu - SP,5385,5437,52,5677,94.86,95.77,0.92
sidra_9541_PercMoradDPPOColetTot_munic_22_pol.fid-703dc0a5_191866d88cb_-91b,3553203,Taiúva - SP,5220,5319,99,5523,94.51,96.31,1.79
sidra_9541_PercMoradDPPOColetTot_munic_22_pol.fid-703dc0a5_191866d88cb_-919,3553302,Tambaú - SP,20055,20404,349,21371,93.84,95.48,1.63
sidra_9541_PercMoradDPPOColetTot_munic_22_pol.fid-703dc0a5_191866d88cb_-918,3553658,Taquaral - SP,2587,2587,,2619,98.78,98.78,
sidra_9541_PercMoradDPPOColetTot_munic_22_pol.fid-703dc0a5_191866d88cb_-917,3553708,Taquaritinga - SP,49996,50502,506,52105,95.95,96.92,0.97
sidra_9541_PercMoradDPPOColetTot_munic_22_pol.fid-703dc0a5_191866d88cb_-916,3553807,Taquarituba - SP,21064,21673,609,23148,91,93.63,2.63
sidra_9541_PercMoradDPPOColetTot_munic_22_pol.fid-703dc0a5_191866d88cb_-8b8,3553856,Taquarivaí - SP,5538,6665,1127,6872,80.59,96.99,16.4
sidra_9541_PercMoradDPPOColetTot_munic_22_pol.fid-703dc0a5_191866d88cb_-8b7,3553906,Tarabai - SP,6110,6169,59,6518,93.74,94.65,0.91
sidra_9541_PercMoradDPPOColetTot_munic_22_pol.fid-703dc0a5_191866d88cb_-8b6,3553955,Tarumã - SP,14349,14562,213,14875,96.46,97.9,1.43
sidra_9541_PercMoradDPPOColetTot_munic_22_pol.fid-703dc0a5_191866d88cb_-8b5,3554003,Tatuí - SP,115124,123002,7878,123694,93.07,99.44,6.37
sidra_9541_PercMoradDPPOColetTot_munic_22_pol.fid-703dc0a5_191866d88cb_-8b4,3554102,Taubaté - SP,282100,309248,27148,309666,91.1,99.87,8.77
sidra_9541_PercMoradDPPOColetTot_munic_22_pol.fid-703dc0a5_191866d88cb_-8b3,3554201,Tejupá - SP,3002,3470,468,4127,72.74,84.08,11.34
sidra_9541_PercMoradDPPOColetTot_munic_22_pol.fid-703dc0a5_191866d88cb_-8b2,3554300,Teodoro Sampaio - SP,18665,19046,381,22118,84.39,86.11,1.72
sidra_9541_PercMoradDPPOColetTot_munic_22_pol.fid-703dc0a5_191866d88cb_-8b1,3554409,Terra Roxa - SP,7691,7760,69,7871,97.71,98.59,0.88
sidra_9541_PercMoradDPPOColetTot_munic_22_pol.fid-703dc0a5_191866d88cb_-8b0,3554508,Tietê - SP,35710,37183,1473,37543,95.12,99.04,3.92
sidra_9541_PercMoradDPPOColetTot_munic_22_pol.fid-703dc0a5_191866d88cb_-8af,3554607,Timburi - SP,2225,2382,157,2451,90.78,97.18,6.41
sidra_9541_PercMoradDPPOColetTot_munic_22_pol.fid-703dc0a5_191866d88cb_-8ae,3554656,Torre de Pedra - SP,1827,2039,212,2046,89.3,99.66,10.36
sidra_9541_PercMoradDPPOColetTot_munic_22_pol.fid-703dc0a5_191866d88cb_-8ad,3554706,Torrinha - SP,8194,8861,667,9275,88.35,95.54,7.19
sidra_9541_PercMoradDPPOColetTot_munic_22_pol.fid-703dc0a5_191866d88cb_-8ab,3554755,Trabiju - SP,1565,1603,38,1680,93.15,95.42,2.26
sidra_9541_PercMoradDPPOColetTot_munic_22_pol.fid-703dc0a5_191866d88cb_-8aa,3554805,Tremembé - SP,42415,43850,1435,44390,95.55,98.78,3.23
sidra_9541_PercMoradDPPOColetTot_munic_22_pol.fid-703dc0a5_191866d88cb_-8a9,3554904,Três Fronteiras - SP,6225,6344,119,6800,91.54,93.29,1.75
sidra_9541_PercMoradDPPOColetTot_munic_22_pol.fid-703dc0a5_191866d88cb_-8a8,3554953,Tuiuti - SP,5810,6532,722,6778,85.72,96.37,10.65
sidra_9541_PercMoradDPPOColetTot_munic_22_pol.fid-703dc0a5_191866d88cb_-8a7,3555000,Tupã - SP,60284,61618,1334,63336,95.18,97.29,2.11
sidra_9541_PercMoradDPPOColetTot_munic_22_pol.fid-703dc0a5_191866d88cb_-8a6,3555109,Tupi Paulista - SP,12509,13171,662,14024,89.2,93.92,4.72
sidra_9541_PercMoradDPPOColetTot_munic_22_pol.fid-703dc0a5_191866d88cb_-8a5,3555208,Turiúba - SP,1544,1632,88,1818,84.93,89.77,4.84
sidra_9541_PercMoradDPPOColetTot_munic_22_pol.fid-703dc0a5_191866d88cb_-8a4,3555703,União Paulista - SP,1391,1444,53,1603,86.77,90.08,3.31
sidra_9541_PercMoradDPPOColetTot_munic_22_pol.fid-703dc0a5_191866d88cb_-8a3,3555802,Urânia - SP,7769,7925,156,8808,88.2,89.98,1.77
sidra_9541_PercMoradDPPOColetTot_munic_22_pol.fid-703dc0a5_191866d88cb_-8a2,3555901,Uru - SP,1180,1335,155,1385,85.2,96.39,11.19
sidra_9541_PercMoradDPPOColetTot_munic_22_pol.fid-703dc0a5_191866d88cb_-8a1,3556008,Urupês - SP,12886,13150,264,13714,93.96,95.89,1.93
sidra_9541_PercMoradDPPOColetTot_munic_22_pol.fid-703dc0a5_191866d88cb_-8a0,3556107,Valentim Gentil - SP,13348,13697,349,14067,94.89,97.37,2.48
sidra_9541_PercMoradDPPOColetTot_munic_22_pol.fid-703dc0a5_191866d88cb_-89f,3556206,Valinhos - SP,119239,125931,6692,126088,94.57,99.88,5.31
sidra_9541_PercMoradDPPOColetTot_munic_22_pol.fid-703dc0a5_191866d88cb_-89e,3556305,Valparaíso - SP,20938,21000,62,21291,98.34,98.63,0.29
sidra_9541_PercMoradDPPOColetTot_munic_22_pol.fid-703dc0a5_191866d88cb_-89d,3556354,Vargem - SP,8690,10382,1692,10498,82.78,98.9,16.12
sidra_9541_PercMoradDPPOColetTot_munic_22_pol.fid-703dc0a5_191866d88cb_-89c,3556404,Vargem Grande do Sul - SP,38288,38733,445,40020,95.67,96.78,1.11
sidra_9541_PercMoradDPPOColetTot_munic_22_pol.fid-703dc0a5_191866d88cb_-89b,3556453,Vargem Grande Paulista - SP,49204,50084,880,50340,97.74,99.49,1.75
sidra_9541_PercMoradDPPOColetTot_munic_22_pol.fid-703dc0a5_191866d88cb_-89a,3556503,Várzea Paulista - SP,113001,115531,2530,115557,97.79,99.98,2.19
sidra_9541_PercMoradDPPOColetTot_munic_22_pol.fid-703dc0a5_191866d88cb_-899,3556602,Vera Cruz - SP,9185,9486,301,10137,90.61,93.58,2.97
sidra_9541_PercMoradDPPOColetTot_munic_22_pol.fid-703dc0a5_191866d88cb_-898,3556701,Vinhedo - SP,72200,76138,3938,76282,94.65,99.81,5.16
sidra_9541_PercMoradDPPOColetTot_munic_22_pol.fid-703dc0a5_191866d88cb_-897,3556800,Viradouro - SP,16988,17168,180,17382,97.73,98.77,1.04
sidra_9541_PercMoradDPPOColetTot_munic_22_pol.fid-703dc0a5_191866d88cb_-896,4103404,Cafeara - PR,2280,2287,7,2627,86.79,87.06,0.27
sidra_9541_PercMoradDPPOColetTot_munic_22_pol.fid-703dc0a5_191866d88cb_-895,4103453,Cafelândia - PR,17359,18177,818,18994,91.39,95.7,4.31
sidra_9541_PercMoradDPPOColetTot_munic_22_pol.fid-703dc0a5_191866d88cb_-894,4103479,Cafezal do Sul - PR,3869,3922,53,4464,86.67,87.86,1.19
sidra_9541_PercMoradDPPOColetTot_munic_22_pol.fid-703dc0a5_191866d88cb_-893,4103503,Califórnia - PR,7644,7835,191,8667,88.2,90.4,2.2
sidra_9541_PercMoradDPPOColetTot_munic_22_pol.fid-703dc0a5_191866d88cb_-892,3556909,Vista Alegre do Alto - SP,7701,7842,141,8109,94.97,96.71,1.74
sidra_9541_PercMoradDPPOColetTot_munic_22_pol.fid-703dc0a5_191866d88cb_-891,4100509,Altônia - PR,15598,15763,165,18663,83.58,84.46,0.88
sidra_9541_PercMoradDPPOColetTot_munic_22_pol.fid-703dc0a5_191866d88cb_-890,4107108,Diamante do Norte - PR,4664,4772,108,5140,90.74,92.84,2.1
sidra_9541_PercMoradDPPOColetTot_munic_22_pol.fid-703dc0a5_191866d88cb_-88f,4107124,Diamante do Sul - PR,1461,1705,244,3171,46.07,53.77,7.69
sidra_9541_PercMoradDPPOColetTot_munic_22_pol.fid-703dc0a5_191866d88cb_-88d,4100608,Alto Paraná - PR,12544,12604,60,13866,90.47,90.9,0.43
sidra_9541_PercMoradDPPOColetTot_munic_22_pol.fid-703dc0a5_191866d88cb_-88c,4100707,Alto Piquiri - PR,9018,9055,37,9689,93.07,93.46,0.38
sidra_9541_PercMoradDPPOColetTot_munic_22_pol.fid-703dc0a5_191866d88cb_-88b,4100806,Alvorada do Sul - PR,9490,9558,68,10199,93.05,93.72,0.67
sidra_9541_PercMoradDPPOColetTot_munic_22_pol.fid-703dc0a5_191866d88cb_-88a,4100905,Amaporã - PR,4142,4145,3,4760,87.02,87.08,0.06
sidra_9541_PercMoradDPPOColetTot_munic_22_pol.fid-703dc0a5_191866d88cb_-889,4101002,Ampére - PR,15769,16017,248,19603,80.44,81.71,1.27
sidra_9541_PercMoradDPPOColetTot_munic_22_pol.fid-703dc0a5_191866d88cb_-888,4101051,Anahy - PR,2485,2529,44,2918,85.16,86.67,1.51
sidra_9541_PercMoradDPPOColetTot_munic_22_pol.fid-703dc0a5_191866d88cb_-887,4101101,Andirá - PR,19104,19205,101,19784,96.56,97.07,0.51
sidra_9541_PercMoradDPPOColetTot_munic_22_pol.fid-703dc0a5_191866d88cb_-886,4101150,Ângulo - PR,3002,3002,,3233,92.85,92.85,
sidra_9541_PercMoradDPPOColetTot_munic_22_pol.fid-703dc0a5_191866d88cb_-885,4101200,Antonina - PR,16634,17164,530,18030,92.26,95.2,2.94
sidra_9541_PercMoradDPPOColetTot_munic_22_pol.fid-703dc0a5_191866d88cb_-884,4101309,Antônio Olinto - PR,3265,4270,1005,7013,46.56,60.89,14.33
sidra_9541_PercMoradDPPOColetTot_munic_22_pol.fid-703dc0a5_191866d88cb_-883,4101408,Apucarana - PR,126027,127273,1246,129577,97.26,98.22,0.96
sidra_9541_PercMoradDPPOColetTot_munic_22_pol.fid-703dc0a5_191866d88cb_-882,4101507,Arapongas - PR,115719,117768,2049,118945,97.29,99.01,1.72
sidra_9541_PercMoradDPPOColetTot_munic_22_pol.fid-703dc0a5_191866d88cb_-881,4101606,Arapoti - PR,23052,24024,972,25689,89.73,93.52,3.78
sidra_9541_PercMoradDPPOColetTot_munic_22_pol.fid-703dc0a5_191866d88cb_-880,4101655,Arapuã - PR,2620,2634,14,3527,74.28,74.68,0.4
sidra_9541_PercMoradDPPOColetTot_munic_22_pol.fid-703dc0a5_191866d88cb_-87f,4101705,Araruna - PR,12693,13050,357,14480,87.66,90.12,2.47
sidra_9541_PercMoradDPPOColetTot_munic_22_pol.fid-703dc0a5_191866d88cb_-87e,4101804,Araucária - PR,137863,151046,13183,151559,90.96,99.66,8.7
sidra_9541_PercMoradDPPOColetTot_munic_22_pol.fid-703dc0a5_191866d88cb_-87d,4101853,Ariranha do Ivaí - PR,1374,1399,25,2329,59,60.07,1.07
sidra_9541_PercMoradDPPOColetTot_munic_22_pol.fid-703dc0a5_191866d88cb_-87c,4101903,Assaí - PR,12395,12479,84,13673,90.65,91.27,0.61
sidra_9541_PercMoradDPPOColetTot_munic_22_pol.fid-703dc0a5_191866d88cb_-87b,4102000,Assis Chateaubriand - PR,34178,34295,117,36732,93.05,93.37,0.32
sidra_9541_PercMoradDPPOColetTot_munic_22_pol.fid-703dc0a5_191866d88cb_-87a,4102109,Astorga - PR,23861,23918,57,25405,93.92,94.15,0.22
sidra_9541_PercMoradDPPOColetTot_munic_22_pol.fid-703dc0a5_191866d88cb_-879,4102208,Atalaia - PR,3636,3636,,3839,94.71,94.71,
sidra_9541_PercMoradDPPOColetTot_munic_22_pol.fid-703dc0a5_191866d88cb_-878,4102307,Balsa Nova - PR,11928,13117,1189,13387,89.1,97.98,8.88
sidra_9541_PercMoradDPPOColetTot_munic_22_pol.fid-703dc0a5_191866d88cb_-877,4102406,Bandeirantes - PR,29041,29145,104,31139,93.26,93.6,0.33
sidra_9541_PercMoradDPPOColetTot_munic_22_pol.fid-703dc0a5_191866d88cb_-876,4102505,Barbosa Ferraz - PR,9285,9394,109,10753,86.35,87.36,1.01
sidra_9541_PercMoradDPPOColetTot_munic_22_pol.fid-703dc0a5_191866d88cb_-875,4102604,Barracão - PR,7790,7886,96,9692,80.38,81.37,0.99
sidra_9541_PercMoradDPPOColetTot_munic_22_pol.fid-703dc0a5_191866d88cb_-874,4102703,Barra do Jacaré - PR,2247,2261,14,2813,79.88,80.38,0.5
sidra_9541_PercMoradDPPOColetTot_munic_22_pol.fid-703dc0a5_191866d88cb_-873,4102752,Bela Vista da Caroba - PR,2140,2200,60,4031,53.09,54.58,1.49
sidra_9541_PercMoradDPPOColetTot_munic_22_pol.fid-703dc0a5_191866d88cb_-872,4108106,Flórida - PR,2573,2575,2,2651,97.06,97.13,0.08
sidra_9541_PercMoradDPPOColetTot_munic_22_pol.fid-703dc0a5_191866d88cb_-871,4102802,Bela Vista do Paraíso - PR,14162,14362,200,14774,95.86,97.21,1.35
sidra_9541_PercMoradDPPOColetTot_munic_22_pol.fid-703dc0a5_191866d88cb_-870,4102901,Bituruna - PR,10540,11565,1025,15523,67.9,74.5,6.6
sidra_9541_PercMoradDPPOColetTot_munic_22_pol.fid-703dc0a5_191866d88cb_-86f,4103008,Boa Esperança - PR,4034,4076,42,4556,88.54,89.46,0.92
sidra_9541_PercMoradDPPOColetTot_munic_22_pol.fid-703dc0a5_191866d88cb_-86e,4103057,Boa Vista da Aparecida - PR,5978,6875,897,7920,75.48,86.81,11.33
sidra_9541_PercMoradDPPOColetTot_munic_22_pol.fid-703dc0a5_191866d88cb_-86d,4103107,Bocaiúva do Sul - PR,11866,12517,651,13256,89.51,94.43,4.91
sidra_9541_PercMoradDPPOColetTot_munic_22_pol.fid-703dc0a5_191866d88cb_-86c,4108205,Formosa do Oeste - PR,5940,6026,86,7635,77.8,78.93,1.13
sidra_9541_PercMoradDPPOColetTot_munic_22_pol.fid-703dc0a5_191866d88cb_-86b,4108304,Foz do Iguaçu - PR,269947,281094,11147,282282,95.63,99.58,3.95
sidra_9541_PercMoradDPPOColetTot_munic_22_pol.fid-703dc0a5_191866d88cb_-86a,4103156,Bom Jesus do Sul - PR,2469,2487,18,3980,62.04,62.49,0.45
sidra_9541_PercMoradDPPOColetTot_munic_22_pol.fid-703dc0a5_191866d88cb_-869,4103206,Bom Sucesso - PR,6116,6163,47,6576,93,93.72,0.71
sidra_9541_PercMoradDPPOColetTot_munic_22_pol.fid-703dc0a5_191866d88cb_-868,4103222,Bom Sucesso do Sul - PR,1494,1968,474,3202,46.66,61.46,14.8
sidra_9541_PercMoradDPPOColetTot_munic_22_pol.fid-703dc0a5_191866d88cb_-867,4103305,Borrazópolis - PR,6660,6667,7,7734,86.11,86.2,0.09
sidra_9541_PercMoradDPPOColetTot_munic_22_pol.fid-703dc0a5_191866d88cb_-866,4103354,Braganey - PR,3960,4250,290,4853,81.6,87.57,5.98
sidra_9541_PercMoradDPPOColetTot_munic_22_pol.fid-703dc0a5_191866d88cb_-865,4103602,Cambará - PR,21980,22112,132,23069,95.28,95.85,0.57
sidra_9541_PercMoradDPPOColetTot_munic_22_pol.fid-703dc0a5_191866d88cb_-864,4103701,Cambé - PR,103098,105395,2297,106961,96.39,98.54,2.15
sidra_9541_PercMoradDPPOColetTot_munic_22_pol.fid-703dc0a5_191866d88cb_-863,4103800,Cambira - PR,7699,8452,753,9448,81.49,89.46,7.97
sidra_9541_PercMoradDPPOColetTot_munic_22_pol.fid-703dc0a5_191866d88cb_-862,4103909,Campina da Lagoa - PR,13864,14117,253,15680,88.42,90.03,1.61
sidra_9541_PercMoradDPPOColetTot_munic_22_pol.fid-703dc0a5_191866d88cb_-861,4103958,Campina do Simão - PR,2403,2424,21,3936,61.05,61.59,0.53
sidra_9541_PercMoradDPPOColetTot_munic_22_pol.fid-703dc0a5_191866d88cb_-860,4104006,Campina Grande do Sul - PR,45647,47055,1408,47706,95.68,98.64,2.95
sidra_9541_PercMoradDPPOColetTot_munic_22_pol.fid-703dc0a5_191866d88cb_-85f,4104055,Campo Bonito - PR,2776,2972,196,4024,68.99,73.86,4.87
sidra_9541_PercMoradDPPOColetTot_munic_22_pol.fid-703dc0a5_191866d88cb_-85e,4104105,Campo do Tenente - PR,6592,7224,632,7499,87.91,96.33,8.43
sidra_9541_PercMoradDPPOColetTot_munic_22_pol.fid-703dc0a5_191866d88cb_-85d,4104204,Campo Largo - PR,123078,131576,8498,136064,90.46,96.7,6.25
sidra_9541_PercMoradDPPOColetTot_munic_22_pol.fid-703dc0a5_191866d88cb_-85c,4104253,Campo Magro - PR,24407,28179,3772,30136,80.99,93.51,12.52
sidra_9541_PercMoradDPPOColetTot_munic_22_pol.fid-703dc0a5_191866d88cb_-85b,4104303,Campo Mourão - PR,95284,96586,1302,98782,96.46,97.78,1.32
sidra_9541_PercMoradDPPOColetTot_munic_22_pol.fid-703dc0a5_191866d88cb_-85a,4104402,Cândido de Abreu - PR,6495,6566,71,15233,42.64,43.1,0.47
sidra_9541_PercMoradDPPOColetTot_munic_22_pol.fid-703dc0a5_191866d88cb_-859,4104428,Candói - PR,11341,11596,255,14959,75.81,77.52,1.7
sidra_9541_PercMoradDPPOColetTot_munic_22_pol.fid-703dc0a5_191866d88cb_-857,4104451,Cantagalo - PR,8979,9306,327,10907,82.32,85.32,3
sidra_9541_PercMoradDPPOColetTot_munic_22_pol.fid-703dc0a5_191866d88cb_-856,4104501,Capanema - PR,15093,16527,1434,20424,73.9,80.92,7.02
sidra_9541_PercMoradDPPOColetTot_munic_22_pol.fid-703dc0a5_191866d88cb_-855,4104600,Capitão Leônidas Marques - PR,12529,14125,1596,14639,85.59,96.49,10.9
sidra_9541_PercMoradDPPOColetTot_munic_22_pol.fid-703dc0a5_191866d88cb_-854,4104659,Carambeí - PR,20113,22898,2785,23240,86.54,98.53,11.98
sidra_9541_PercMoradDPPOColetTot_munic_22_pol.fid-703dc0a5_191866d88cb_-853,4314159,Paverama - RS,6744,7602,858,7923,85.12,95.95,10.83
sidra_9541_PercMoradDPPOColetTot_munic_22_pol.fid-703dc0a5_191866d88cb_-852,4314175,Pedras Altas - RS,762,891,129,2059,37.01,43.27,6.27
sidra_9541_PercMoradDPPOColetTot_munic_22_pol.fid-703dc0a5_191866d88cb_-850,4314209,Pedro Osório - RS,6438,7304,866,7449,86.43,98.05,11.63
sidra_9541_PercMoradDPPOColetTot_munic_22_pol.fid-703dc0a5_191866d88cb_-84f,4314308,Pejuçara - RS,3366,3388,22,3742,89.95,90.54,0.59
sidra_9541_PercMoradDPPOColetTot_munic_22_pol.fid-703dc0a5_191866d88cb_-84e,4104709,Carlópolis - PR,11973,15810,3837,16814,71.21,94.03,22.82
sidra_9541_PercMoradDPPOColetTot_munic_22_pol.fid-703dc0a5_191866d88cb_-84d,4104808,Cascavel - PR,328115,339685,11570,345798,94.89,98.23,3.35
sidra_9541_PercMoradDPPOColetTot_munic_22_pol.fid-703dc0a5_191866d88cb_-84c,4104907,Castro - PR,59638,63377,3739,72921,81.78,86.91,5.13
sidra_9541_PercMoradDPPOColetTot_munic_22_pol.fid-703dc0a5_191866d88cb_-84b,4105003,Catanduvas - PR,7634,8372,738,10288,74.2,81.38,7.17
sidra_9541_PercMoradDPPOColetTot_munic_22_pol.fid-703dc0a5_191866d88cb_-84a,4314407,Pelotas - RS,255159,318960,63801,323618,78.85,98.56,19.71
sidra_9541_PercMoradDPPOColetTot_munic_22_pol.fid-703dc0a5_191866d88cb_-848,4105102,Centenário do Sul - PR,10144,10324,180,10789,94.02,95.69,1.67
sidra_9541_PercMoradDPPOColetTot_munic_22_pol.fid-703dc0a5_191866d88cb_-847,4105201,Cerro Azul - PR,8586,9333,747,16126,53.24,57.88,4.63
sidra_9541_PercMoradDPPOColetTot_munic_22_pol.fid-703dc0a5_191866d88cb_-846,4105300,Céu Azul - PR,9253,9771,518,11060,83.66,88.35,4.68
sidra_9541_PercMoradDPPOColetTot_munic_22_pol.fid-703dc0a5_191866d88cb_-845,4105409,Chopinzinho - PR,15161,16058,897,21049,72.03,76.29,4.26
sidra_9541_PercMoradDPPOColetTot_munic_22_pol.fid-703dc0a5_191866d88cb_-844,4105508,Cianorte - PR,74850,77380,2530,79318,94.37,97.56,3.19
sidra_9541_PercMoradDPPOColetTot_munic_22_pol.fid-703dc0a5_191866d88cb_-843,4105607,Cidade Gaúcha - PR,10930,11075,145,11405,95.84,97.11,1.27
sidra_9541_PercMoradDPPOColetTot_munic_22_pol.fid-703dc0a5_191866d88cb_-842,4105706,Clevelândia - PR,13378,13674,296,14978,89.32,91.29,1.98
sidra_9541_PercMoradDPPOColetTot_munic_22_pol.fid-703dc0a5_191866d88cb_-841,4105805,Colombo - PR,227658,231376,3718,231946,98.15,99.75,1.6
sidra_9541_PercMoradDPPOColetTot_munic_22_pol.fid-703dc0a5_191866d88cb_-840,4105904,Colorado - PR,21724,21817,93,22735,95.55,95.96,0.41
sidra_9541_PercMoradDPPOColetTot_munic_22_pol.fid-703dc0a5_191866d88cb_-83f,4106001,Congonhinhas - PR,5644,5812,168,8293,68.06,70.08,2.03
sidra_9541_PercMoradDPPOColetTot_munic_22_pol.fid-703dc0a5_191866d88cb_-83e,4106100,Conselheiro Mairinck - PR,2962,3261,299,3461,85.58,94.22,8.64
sidra_9541_PercMoradDPPOColetTot_munic_22_pol.fid-703dc0a5_191866d88cb_-83d,4106209,Contenda - PR,15095,17993,2898,19117,78.96,94.12,15.16
sidra_9541_PercMoradDPPOColetTot_munic_22_pol.fid-703dc0a5_191866d88cb_-83c,4106308,Corbélia - PR,16095,16549,454,17363,92.7,95.31,2.61
sidra_9541_PercMoradDPPOColetTot_munic_22_pol.fid-703dc0a5_191866d88cb_-83b,4106407,Cornélio Procópio - PR,43235,43696,461,44849,96.4,97.43,1.03
sidra_9541_PercMoradDPPOColetTot_munic_22_pol.fid-703dc0a5_191866d88cb_-839,4106456,Coronel Domingos Soares - PR,2897,2997,100,5634,51.42,53.19,1.77
sidra_9541_PercMoradDPPOColetTot_munic_22_pol.fid-703dc0a5_191866d88cb_-838,4106506,Coronel Vivida - PR,17849,19378,1529,23317,76.55,83.11,6.56
sidra_9541_PercMoradDPPOColetTot_munic_22_pol.fid-703dc0a5_191866d88cb_-837,4108809,Guaíra - PR,29307,29692,385,31892,91.89,93.1,1.21
sidra_9541_PercMoradDPPOColetTot_munic_22_pol.fid-703dc0a5_191866d88cb_-836,4106555,Corumbataí do Sul - PR,2690,2723,33,3757,71.6,72.48,0.88
sidra_9541_PercMoradDPPOColetTot_munic_22_pol.fid-703dc0a5_191866d88cb_-835,4106571,Cruzeiro do Iguaçu - PR,2852,3637,785,4131,69.04,88.04,19
sidra_9541_PercMoradDPPOColetTot_munic_22_pol.fid-703dc0a5_191866d88cb_-834,4106605,Cruzeiro do Oeste - PR,20544,20689,145,22512,91.26,91.9,0.64
sidra_9541_PercMoradDPPOColetTot_munic_22_pol.fid-703dc0a5_191866d88cb_-833,4106704,Cruzeiro do Sul - PR,3823,3825,2,4490,85.14,85.19,0.04
sidra_9541_PercMoradDPPOColetTot_munic_22_pol.fid-703dc0a5_191866d88cb_-832,4106803,Cruz Machado - PR,7022,8315,1293,15945,44.04,52.15,8.11
sidra_9541_PercMoradDPPOColetTot_munic_22_pol.fid-703dc0a5_191866d88cb_-831,4314423,Picada Café - RS,5094,5337,243,5351,95.2,99.74,4.54
sidra_9541_PercMoradDPPOColetTot_munic_22_pol.fid-703dc0a5_191866d88cb_-830,4106852,Cruzmaltina - PR,2086,2133,47,2892,72.13,73.76,1.63
sidra_9541_PercMoradDPPOColetTot_munic_22_pol.fid-703dc0a5_191866d88cb_-82f,4106902,Curitiba - PR,1681439,1763986,82547,1766225,95.2,99.87,4.67
sidra_9541_PercMoradDPPOColetTot_munic_22_pol.fid-703dc0a5_191866d88cb_-82e,4107009,Curiúva - PR,11897,12211,314,13626,87.31,89.62,2.3
sidra_9541_PercMoradDPPOColetTot_munic_22_pol.fid-703dc0a5_191866d88cb_-82d,4107157,Diamante D'Oeste - PR,3201,3456,255,4546,70.41,76.02,5.61
sidra_9541_PercMoradDPPOColetTot_munic_22_pol.fid-703dc0a5_191866d88cb_-82c,4107207,Dois Vizinhos - PR,38103,40620,2517,44760,85.13,90.75,5.62
sidra_9541_PercMoradDPPOColetTot_munic_22_pol.fid-703dc0a5_191866d88cb_-82b,4107256,Douradina - PR,8320,8376,56,9161,90.82,91.43,0.61
sidra_9541_PercMoradDPPOColetTot_munic_22_pol.fid-703dc0a5_191866d88cb_-82a,4107306,Doutor Camargo - PR,5877,5906,29,6326,92.9,93.36,0.46
sidra_9541_PercMoradDPPOColetTot_munic_22_pol.fid-703dc0a5_191866d88cb_-829,4107405,Enéas Marques - PR,2762,3458,696,5980,46.19,57.83,11.64
sidra_9541_PercMoradDPPOColetTot_munic_22_pol.fid-703dc0a5_191866d88cb_-828,4107504,Engenheiro Beltrão - PR,11421,11733,312,12423,91.93,94.45,2.51
sidra_9541_PercMoradDPPOColetTot_munic_22_pol.fid-703dc0a5_191866d88cb_-827,4107520,Esperança Nova - PR,1493,1493,,1849,80.75,80.75,
sidra_9541_PercMoradDPPOColetTot_munic_22_pol.fid-703dc0a5_191866d88cb_-826,4107538,Entre Rios do Oeste - PR,3613,4064,451,4572,79.02,88.89,9.86
sidra_9541_PercMoradDPPOColetTot_munic_22_pol.fid-703dc0a5_191866d88cb_-825,4107546,Espigão Alto do Iguaçu - PR,2878,2993,115,4793,60.05,62.45,2.4
sidra_9541_PercMoradDPPOColetTot_munic_22_pol.fid-703dc0a5_191866d88cb_-824,4107553,Farol - PR,2376,2388,12,3038,78.21,78.6,0.4
sidra_9541_PercMoradDPPOColetTot_munic_22_pol.fid-703dc0a5_191866d88cb_-823,4107603,Faxinal - PR,14654,14880,226,16279,90.02,91.41,1.39
sidra_9541_PercMoradDPPOColetTot_munic_22_pol.fid-703dc0a5_191866d88cb_-822,4107652,Fazenda Rio Grande - PR,138571,148133,9562,148712,93.18,99.61,6.43
sidra_9541_PercMoradDPPOColetTot_munic_22_pol.fid-703dc0a5_191866d88cb_-820,4124053,Santa Terezinha de Itaipu - PR,22584,23172,588,24258,93.1,95.52,2.42
sidra_9541_PercMoradDPPOColetTot_munic_22_pol.fid-703dc0a5_191866d88cb_-81f,4124103,Santo Antônio da Platina - PR,39929,41899,1970,44193,90.35,94.81,4.46
sidra_9541_PercMoradDPPOColetTot_munic_22_pol.fid-703dc0a5_191866d88cb_-81e,4107702,Fênix - PR,4101,4107,6,4471,91.72,91.86,0.13
sidra_9541_PercMoradDPPOColetTot_munic_22_pol.fid-703dc0a5_191866d88cb_-81d,4107736,Fernandes Pinheiro - PR,4163,5214,1051,6255,66.55,83.36,16.8
sidra_9541_PercMoradDPPOColetTot_munic_22_pol.fid-703dc0a5_191866d88cb_-81c,4107751,Figueira - PR,7646,7829,183,8058,94.89,97.16,2.27
sidra_9541_PercMoradDPPOColetTot_munic_22_pol.fid-703dc0a5_191866d88cb_-81b,4107801,Floraí - PR,4643,4645,2,4774,97.26,97.3,0.04
sidra_9541_PercMoradDPPOColetTot_munic_22_pol.fid-703dc0a5_191866d88cb_-81a,4107850,Flor da Serra do Sul - PR,2381,2750,369,4357,54.65,63.12,8.47
sidra_9541_PercMoradDPPOColetTot_munic_22_pol.fid-703dc0a5_191866d88cb_-819,4107900,Floresta - PR,8991,10310,1319,10454,86.01,98.62,12.62
sidra_9541_PercMoradDPPOColetTot_munic_22_pol.fid-703dc0a5_191866d88cb_-818,4108007,Florestópolis - PR,10962,11087,125,11442,95.8,96.9,1.09
sidra_9541_PercMoradDPPOColetTot_munic_22_pol.fid-703dc0a5_191866d88cb_-817,4108320,Francisco Alves - PR,7242,7354,112,8111,89.29,90.67,1.38
sidra_9541_PercMoradDPPOColetTot_munic_22_pol.fid-703dc0a5_191866d88cb_-816,4108403,Francisco Beltrão - PR,79316,92805,13489,95376,83.16,97.3,14.14
sidra_9541_PercMoradDPPOColetTot_munic_22_pol.fid-703dc0a5_191866d88cb_-815,4108452,Foz do Jordão - PR,4717,4745,28,4926,95.76,96.33,0.57
sidra_9541_PercMoradDPPOColetTot_munic_22_pol.fid-703dc0a5_191866d88cb_-814,4108502,General Carneiro - PR,9552,9810,258,11015,86.72,89.06,2.34
sidra_9541_PercMoradDPPOColetTot_munic_22_pol.fid-703dc0a5_191866d88cb_-813,4124202,Santo Antônio do Caiuá - PR,2265,2274,9,2493,90.85,91.22,0.36
sidra_9541_PercMoradDPPOColetTot_munic_22_pol.fid-703dc0a5_191866d88cb_-812,4124301,Santo Antônio do Paraíso - PR,1901,1911,10,2125,89.46,89.93,0.47
sidra_9541_PercMoradDPPOColetTot_munic_22_pol.fid-703dc0a5_191866d88cb_-811,4124400,Santo Antônio do Sudoeste - PR,19386,19490,104,23511,82.46,82.9,0.44
sidra_9541_PercMoradDPPOColetTot_munic_22_pol.fid-703dc0a5_191866d88cb_-810,4108551,Godoy Moreira - PR,2045,2363,318,2977,68.69,79.38,10.68
sidra_9541_PercMoradDPPOColetTot_munic_22_pol.fid-703dc0a5_191866d88cb_-80f,4108601,Goioerê - PR,26664,26791,127,28386,93.93,94.38,0.45
sidra_9541_PercMoradDPPOColetTot_munic_22_pol.fid-703dc0a5_191866d88cb_-80e,4108650,Goioxim - PR,3226,3359,133,6563,49.15,51.18,2.03
sidra_9541_PercMoradDPPOColetTot_munic_22_pol.fid-703dc0a5_191866d88cb_-80d,4108700,Grandes Rios - PR,4462,4724,262,5606,79.59,84.27,4.67
sidra_9541_PercMoradDPPOColetTot_munic_22_pol.fid-703dc0a5_191866d88cb_-80c,4124509,Santo Inácio - PR,5685,5809,124,6171,92.12,94.13,2.01
sidra_9541_PercMoradDPPOColetTot_munic_22_pol.fid-703dc0a5_191866d88cb_-80b,4108908,Guairaçá - PR,6012,6095,83,6582,91.34,92.6,1.26
sidra_9541_PercMoradDPPOColetTot_munic_22_pol.fid-703dc0a5_191866d88cb_-80a,4108957,Guamiranga - PR,5407,5810,403,7817,69.17,74.33,5.16
sidra_9541_PercMoradDPPOColetTot_munic_22_pol.fid-703dc0a5_191866d88cb_-809,4109005,Guapirama - PR,3920,4359,439,4624,84.78,94.27,9.49
sidra_9541_PercMoradDPPOColetTot_munic_22_pol.fid-703dc0a5_191866d88cb_-808,4109757,Ibema - PR,5428,5719,291,6218,87.29,91.97,4.68
sidra_9541_PercMoradDPPOColetTot_munic_22_pol.fid-703dc0a5_191866d88cb_-807,4109807,Ibiporã - PR,50271,50909,638,51355,97.89,99.13,1.24
sidra_9541_PercMoradDPPOColetTot_munic_22_pol.fid-703dc0a5_191866d88cb_-806,4109104,Guaporema - PR,2022,2046,24,2181,92.71,93.81,1.1
sidra_9541_PercMoradDPPOColetTot_munic_22_pol.fid-703dc0a5_191866d88cb_-805,4110300,Inajá - PR,2432,2438,6,2536,95.9,96.14,0.24
sidra_9541_PercMoradDPPOColetTot_munic_22_pol.fid-703dc0a5_191866d88cb_-804,4109203,Guaraci - PR,4112,4171,59,4728,86.97,88.22,1.25
sidra_9541_PercMoradDPPOColetTot_munic_22_pol.fid-703dc0a5_191866d88cb_-803,4109302,Guaraniaçu - PR,8587,10024,1437,13689,62.73,73.23,10.5
sidra_9541_PercMoradDPPOColetTot_munic_22_pol.fid-703dc0a5_191866d88cb_-802,4109401,Guarapuava - PR,164846,172774,7928,180659,91.25,95.64,4.39
sidra_9541_PercMoradDPPOColetTot_munic_22_pol.fid-703dc0a5_191866d88cb_-801,4109500,Guaraqueçaba - PR,4978,5107,129,7383,67.43,69.17,1.75
sidra_9541_PercMoradDPPOColetTot_munic_22_pol.fid-703dc0a5_191866d88cb_-800,4109609,Guaratuba - PR,39515,40901,1386,41971,94.15,97.45,3.3
sidra_9541_PercMoradDPPOColetTot_munic_22_pol.fid-703dc0a5_191866d88cb_-7ff,4109658,Honório Serpa - PR,2428,2675,247,4935,49.2,54.2,5.01
sidra_9541_PercMoradDPPOColetTot_munic_22_pol.fid-703dc0a5_191866d88cb_-7fe,4109708,Ibaiti - PR,25028,26322,1294,28693,87.23,91.74,4.51
sidra_9541_PercMoradDPPOColetTot_munic_22_pol.fid-703dc0a5_191866d88cb_-7fc,4109906,Icaraíma - PR,7301,7869,568,8939,81.68,88.03,6.35
sidra_9541_PercMoradDPPOColetTot_munic_22_pol.fid-703dc0a5_191866d88cb_-7fb,4110003,Iguaraçu - PR,5095,5131,36,5328,95.63,96.3,0.68
sidra_9541_PercMoradDPPOColetTot_munic_22_pol.fid-703dc0a5_191866d88cb_-7fa,4110052,Iguatu - PR,1634,1728,94,2140,76.36,80.75,4.39
sidra_9541_PercMoradDPPOColetTot_munic_22_pol.fid-703dc0a5_191866d88cb_-7f9,4110078,Imbaú - PR,12452,13346,894,14238,87.46,93.74,6.28
sidra_9541_PercMoradDPPOColetTot_munic_22_pol.fid-703dc0a5_191866d88cb_-7f8,4110102,Imbituva - PR,24155,26621,2466,29821,81,89.27,8.27
sidra_9541_PercMoradDPPOColetTot_munic_22_pol.fid-703dc0a5_191866d88cb_-7f7,4110201,Inácio Martins - PR,7311,7605,294,9660,75.68,78.73,3.04
sidra_9541_PercMoradDPPOColetTot_munic_22_pol.fid-703dc0a5_191866d88cb_-7f6,4110409,Indianópolis - PR,3853,3973,120,4444,86.7,89.4,2.7
sidra_9541_PercMoradDPPOColetTot_munic_22_pol.fid-703dc0a5_191866d88cb_-7f5,4110508,Ipiranga - PR,7264,10436,3172,14137,51.38,73.82,22.44
sidra_9541_PercMoradDPPOColetTot_munic_22_pol.fid-703dc0a5_191866d88cb_-7f4,4110607,Iporã - PR,13710,13891,181,15658,87.56,88.72,1.16
sidra_9541_PercMoradDPPOColetTot_munic_22_pol.fid-703dc0a5_191866d88cb_-7f3,4111308,Itaúna do Sul - PR,3385,3403,18,3572,94.76,95.27,0.5
sidra_9541_PercMoradDPPOColetTot_munic_22_pol.fid-703dc0a5_191866d88cb_-7f2,4111407,Ivaí - PR,7853,8280,427,13186,59.56,62.79,3.24
sidra_9541_PercMoradDPPOColetTot_munic_22_pol.fid-703dc0a5_191866d88cb_-7f1,4111506,Ivaiporã - PR,30046,30262,216,32598,92.17,92.83,0.66
sidra_9541_PercMoradDPPOColetTot_munic_22_pol.fid-703dc0a5_191866d88cb_-7f0,4111555,Ivaté - PR,5772,5994,222,6818,84.66,87.91,3.26
sidra_9541_PercMoradDPPOColetTot_munic_22_pol.fid-703dc0a5_191866d88cb_-7ef,4110656,Iracema do Oeste - PR,2197,2216,19,2343,93.77,94.58,0.81
sidra_9541_PercMoradDPPOColetTot_munic_22_pol.fid-703dc0a5_191866d88cb_-7ee,4110706,Irati - PR,49694,51439,1745,59056,84.15,87.1,2.95
sidra_9541_PercMoradDPPOColetTot_munic_22_pol.fid-703dc0a5_191866d88cb_-7ed,4110805,Iretama - PR,8091,8286,195,10590,76.4,78.24,1.84
sidra_9541_PercMoradDPPOColetTot_munic_22_pol.fid-703dc0a5_191866d88cb_-7ec,4113700,Londrina - PR,519587,544697,25110,552090,94.11,98.66,4.55
sidra_9541_PercMoradDPPOColetTot_munic_22_pol.fid-703dc0a5_191866d88cb_-7eb,4113734,Luiziana - PR,5418,5628,210,6688,81.01,84.15,3.14
sidra_9541_PercMoradDPPOColetTot_munic_22_pol.fid-703dc0a5_191866d88cb_-7ea,4314456,Pinhal - RS,994,2650,1656,2958,33.6,89.59,55.98
sidra_9541_PercMoradDPPOColetTot_munic_22_pol.fid-703dc0a5_191866d88cb_-7e9,4314464,Pinhal da Serra - RS,1418,2096,678,2244,63.19,93.4,30.21
sidra_9541_PercMoradDPPOColetTot_munic_22_pol.fid-703dc0a5_191866d88cb_-7e8,4314472,Pinhal Grande - RS,2074,2314,240,3803,54.54,60.85,6.31
sidra_9541_PercMoradDPPOColetTot_munic_22_pol.fid-703dc0a5_191866d88cb_-7e7,4314498,Pinheirinho do Vale - RS,3678,3718,40,4535,81.1,81.98,0.88
sidra_9541_PercMoradDPPOColetTot_munic_22_pol.fid-703dc0a5_191866d88cb_-7e6,4314506,Pinheiro Machado - RS,9209,9596,387,11194,82.27,85.72,3.46
sidra_9541_PercMoradDPPOColetTot_munic_22_pol.fid-703dc0a5_191866d88cb_-7e4,4110904,Itaguajé - PR,3693,3822,129,4470,82.62,85.5,2.89
sidra_9541_PercMoradDPPOColetTot_munic_22_pol.fid-703dc0a5_191866d88cb_-7e3,4110953,Itaipulândia - PR,11228,11296,68,11479,97.81,98.41,0.59
sidra_9541_PercMoradDPPOColetTot_munic_22_pol.fid-703dc0a5_191866d88cb_-7e2,4111001,Itambaracá - PR,5256,5317,61,5851,89.83,90.87,1.04
sidra_9541_PercMoradDPPOColetTot_munic_22_pol.fid-703dc0a5_191866d88cb_-7e1,4111100,Itambé - PR,5865,5923,58,6110,95.99,96.94,0.95
sidra_9541_PercMoradDPPOColetTot_munic_22_pol.fid-703dc0a5_191866d88cb_-7e0,4111209,Itapejara d'Oeste - PR,4165,10265,6100,12305,33.85,83.42,49.57
sidra_9541_PercMoradDPPOColetTot_munic_22_pol.fid-703dc0a5_191866d88cb_-7df,4111258,Itaperuçu - PR,27539,28069,530,31203,88.26,89.96,1.7
sidra_9541_PercMoradDPPOColetTot_munic_22_pol.fid-703dc0a5_191866d88cb_-7de,4111605,Ivatuba - PR,2354,2593,239,2690,87.51,96.39,8.88
sidra_9541_PercMoradDPPOColetTot_munic_22_pol.fid-703dc0a5_191866d88cb_-7dd,4111704,Jaboti - PR,4059,4796,737,5419,74.9,88.5,13.6
sidra_9541_PercMoradDPPOColetTot_munic_22_pol.fid-703dc0a5_191866d88cb_-7dc,4111803,Jacarezinho - PR,38013,38775,762,40212,94.53,96.43,1.89
sidra_9541_PercMoradDPPOColetTot_munic_22_pol.fid-703dc0a5_191866d88cb_-7db,4111902,Jaguapitã - PR,13927,14152,225,15022,92.71,94.21,1.5
sidra_9541_PercMoradDPPOColetTot_munic_22_pol.fid-703dc0a5_191866d88cb_-7da,4112009,Jaguariaíva - PR,31485,32299,814,34951,90.08,92.41,2.33
sidra_9541_PercMoradDPPOColetTot_munic_22_pol.fid-703dc0a5_191866d88cb_-7d9,4112108,Jandaia do Sul - PR,19697,20365,668,21271,92.6,95.74,3.14
sidra_9541_PercMoradDPPOColetTot_munic_22_pol.fid-703dc0a5_191866d88cb_-7d8,4112207,Janiópolis - PR,4902,4912,10,5856,83.71,83.88,0.17
sidra_9541_PercMoradDPPOColetTot_munic_22_pol.fid-703dc0a5_191866d88cb_-7d7,4112306,Japira - PR,4224,4784,560,4970,84.99,96.26,11.27
sidra_9541_PercMoradDPPOColetTot_munic_22_pol.fid-703dc0a5_191866d88cb_-7d6,4112405,Japurá - PR,8839,8853,14,9144,96.66,96.82,0.15
sidra_9541_PercMoradDPPOColetTot_munic_22_pol.fid-703dc0a5_191866d88cb_-7d4,4112504,Jardim Alegre - PR,8820,8912,92,11999,73.51,74.27,0.77
sidra_9541_PercMoradDPPOColetTot_munic_22_pol.fid-703dc0a5_191866d88cb_-7d3,4112603,Jardim Olinda - PR,1239,1241,2,1343,92.26,92.41,0.15
sidra_9541_PercMoradDPPOColetTot_munic_22_pol.fid-703dc0a5_191866d88cb_-7d2,4303558,Camargo - RS,2862,2882,20,2981,96.01,96.68,0.67
sidra_9541_PercMoradDPPOColetTot_munic_22_pol.fid-703dc0a5_191866d88cb_-7d1,4303608,Cambará do Sul - RS,5626,6171,545,6328,88.91,97.52,8.61
sidra_9541_PercMoradDPPOColetTot_munic_22_pol.fid-703dc0a5_191866d88cb_-7d0,4303673,Campestre da Serra - RS,1179,3046,1867,3235,36.45,94.16,57.71
sidra_9541_PercMoradDPPOColetTot_munic_22_pol.fid-703dc0a5_191866d88cb_-7cf,4112702,Jataizinho - PR,11276,11416,140,11760,95.88,97.07,1.19
sidra_9541_PercMoradDPPOColetTot_munic_22_pol.fid-703dc0a5_191866d88cb_-7ce,4112751,Jesuítas - PR,8711,8921,210,10496,82.99,84.99,2
sidra_9541_PercMoradDPPOColetTot_munic_22_pol.fid-703dc0a5_191866d88cb_-7cd,4112801,Joaquim Távora - PR,10237,11675,1438,11858,86.33,98.46,12.13
sidra_9541_PercMoradDPPOColetTot_munic_22_pol.fid-703dc0a5_191866d88cb_-7cc,4112900,Jundiaí do Sul - PR,2439,2591,152,3333,73.18,77.74,4.56
sidra_9541_PercMoradDPPOColetTot_munic_22_pol.fid-703dc0a5_191866d88cb_-7cb,4112959,Juranda - PR,6941,6943,2,7770,89.33,89.36,0.03
sidra_9541_PercMoradDPPOColetTot_munic_22_pol.fid-703dc0a5_191866d88cb_-7ca,4124608,São Carlos do Ivaí - PR,6355,6382,27,6547,97.07,97.48,0.41
sidra_9541_PercMoradDPPOColetTot_munic_22_pol.fid-703dc0a5_191866d88cb_-7c9,4124707,São Jerônimo da Serra - PR,7348,7446,98,10797,68.06,68.96,0.91
sidra_9541_PercMoradDPPOColetTot_munic_22_pol.fid-703dc0a5_191866d88cb_-7c8,4124806,São João - PR,8021,9601,1580,11879,67.52,80.82,13.3
sidra_9541_PercMoradDPPOColetTot_munic_22_pol.fid-703dc0a5_191866d88cb_-7c7,4113007,Jussara - PR,6479,6492,13,6688,96.88,97.07,0.19
sidra_9541_PercMoradDPPOColetTot_munic_22_pol.fid-703dc0a5_191866d88cb_-7c6,4125902,São Pedro do Paraná - PR,2076,2085,9,2657,78.13,78.47,0.34
sidra_9541_PercMoradDPPOColetTot_munic_22_pol.fid-703dc0a5_191866d88cb_-7c5,4303707,Campina das Missões - RS,5282,5370,88,5882,89.8,91.3,1.5
sidra_9541_PercMoradDPPOColetTot_munic_22_pol.fid-703dc0a5_191866d88cb_-7c4,4113106,Kaloré - PR,3996,4000,4,4535,88.11,88.2,0.09
sidra_9541_PercMoradDPPOColetTot_munic_22_pol.fid-703dc0a5_191866d88cb_-7c3,4113205,Lapa - PR,30528,36782,6254,44932,67.94,81.86,13.92
sidra_9541_PercMoradDPPOColetTot_munic_22_pol.fid-703dc0a5_191866d88cb_-7c1,4113254,Laranjal - PR,2857,2983,126,5597,51.05,53.3,2.25
sidra_9541_PercMoradDPPOColetTot_munic_22_pol.fid-703dc0a5_191866d88cb_-7c0,4113304,Laranjeiras do Sul - PR,27526,28150,624,31950,86.15,88.11,1.95
sidra_9541_PercMoradDPPOColetTot_munic_22_pol.fid-703dc0a5_191866d88cb_-7bf,4304309,Cândido Godói - RS,4282,4441,159,6293,68.04,70.57,2.53
sidra_9541_PercMoradDPPOColetTot_munic_22_pol.fid-703dc0a5_191866d88cb_-7be,4304358,Candiota - RS,8253,9009,756,10624,77.68,84.8,7.12
sidra_9541_PercMoradDPPOColetTot_munic_22_pol.fid-703dc0a5_191866d88cb_-7bd,4304408,Canela - RS,46159,48482,2323,48644,94.89,99.67,4.78
sidra_9541_PercMoradDPPOColetTot_munic_22_pol.fid-703dc0a5_191866d88cb_-7bc,4304507,Canguçu - RS,19643,25226,5583,49565,39.63,50.89,11.26
sidra_9541_PercMoradDPPOColetTot_munic_22_pol.fid-703dc0a5_191866d88cb_-7bb,4113403,Leópolis - PR,3296,3410,114,3750,87.89,90.93,3.04
sidra_9541_PercMoradDPPOColetTot_munic_22_pol.fid-703dc0a5_191866d88cb_-7b9,4113429,Lidianópolis - PR,3029,3084,55,3931,77.05,78.45,1.4
sidra_9541_PercMoradDPPOColetTot_munic_22_pol.fid-703dc0a5_191866d88cb_-7b8,4113452,Lindoeste - PR,3258,3768,510,5168,63.04,72.91,9.87
sidra_9541_PercMoradDPPOColetTot_munic_22_pol.fid-703dc0a5_191866d88cb_-7b7,4114708,Maria Helena - PR,4668,4722,54,5859,79.67,80.59,0.92
sidra_9541_PercMoradDPPOColetTot_munic_22_pol.fid-703dc0a5_191866d88cb_-7b6,4113502,Loanda - PR,21815,21930,115,23055,94.62,95.12,0.5
sidra_9541_PercMoradDPPOColetTot_munic_22_pol.fid-703dc0a5_191866d88cb_-7b5,4114807,Marialva - PR,37530,40196,2666,41729,89.94,96.33,6.39
sidra_9541_PercMoradDPPOColetTot_munic_22_pol.fid-703dc0a5_191866d88cb_-7b4,4114906,Marilândia do Sul - PR,7157,7234,77,8621,83.02,83.91,0.89
sidra_9541_PercMoradDPPOColetTot_munic_22_pol.fid-703dc0a5_191866d88cb_-7b3,4115002,Marilena - PR,6566,6757,191,7251,90.55,93.19,2.63
sidra_9541_PercMoradDPPOColetTot_munic_22_pol.fid-703dc0a5_191866d88cb_-7b2,4115101,Mariluz - PR,8330,8470,140,9825,84.78,86.21,1.42
sidra_9541_PercMoradDPPOColetTot_munic_22_pol.fid-703dc0a5_191866d88cb_-7b1,4115200,Maringá - PR,379678,405917,26239,407209,93.24,99.68,6.44
sidra_9541_PercMoradDPPOColetTot_munic_22_pol.fid-703dc0a5_191866d88cb_-7b0,4113601,Lobato - PR,4283,4289,6,4599,93.13,93.26,0.13
sidra_9541_PercMoradDPPOColetTot_munic_22_pol.fid-703dc0a5_191866d88cb_-7af,4113759,Lunardelli - PR,3994,4039,45,4872,81.98,82.9,0.92
sidra_9541_PercMoradDPPOColetTot_munic_22_pol.fid-703dc0a5_191866d88cb_-7ae,4113809,Lupionópolis - PR,4555,4634,79,4791,95.07,96.72,1.65
sidra_9541_PercMoradDPPOColetTot_munic_22_pol.fid-703dc0a5_191866d88cb_-7ad,4113908,Mallet - PR,11678,11885,207,13411,87.08,88.62,1.54
sidra_9541_PercMoradDPPOColetTot_munic_22_pol.fid-703dc0a5_191866d88cb_-7ac,4114005,Mamborê - PR,11389,11849,460,13423,84.85,88.27,3.43
sidra_9541_PercMoradDPPOColetTot_munic_22_pol.fid-703dc0a5_191866d88cb_-7ab,4114104,Mandaguaçu - PR,29451,30527,1076,31422,93.73,97.15,3.42
sidra_9541_PercMoradDPPOColetTot_munic_22_pol.fid-703dc0a5_191866d88cb_-7aa,4114203,Mandaguari - PR,35132,35306,174,36601,95.99,96.46,0.48
sidra_9541_PercMoradDPPOColetTot_munic_22_pol.fid-703dc0a5_191866d88cb_-7a9,4114302,Mandirituba - PR,23113,25168,2055,27410,84.32,91.82,7.5
sidra_9541_PercMoradDPPOColetTot_munic_22_pol.fid-703dc0a5_191866d88cb_-7a8,4114351,Manfrinópolis - PR,1176,2006,830,2768,42.49,72.47,29.99
sidra_9541_PercMoradDPPOColetTot_munic_22_pol.fid-703dc0a5_191866d88cb_-7a7,4114401,Mangueirinha - PR,11950,12977,1027,16586,72.05,78.24,6.19
sidra_9541_PercMoradDPPOColetTot_munic_22_pol.fid-703dc0a5_191866d88cb_-7a6,4114500,Manoel Ribas - PR,10398,10961,563,14227,73.09,77.04,3.96
sidra_9541_PercMoradDPPOColetTot_munic_22_pol.fid-703dc0a5_191866d88cb_-7a5,4114609,Marechal Cândido Rondon - PR,48928,49490,562,55633,87.95,88.96,1.01
sidra_9541_PercMoradDPPOColetTot_munic_22_pol.fid-703dc0a5_191866d88cb_-7a4,4115309,Mariópolis - PR,4893,5491,598,6366,76.86,86.26,9.39
sidra_9541_PercMoradDPPOColetTot_munic_22_pol.fid-703dc0a5_191866d88cb_-7a2,4115358,Maripá - PR,4709,5442,733,6554,71.85,83.03,11.18
sidra_9541_PercMoradDPPOColetTot_munic_22_pol.fid-703dc0a5_191866d88cb_-7a1,4115408,Marmeleiro - PR,12512,14142,1630,15892,78.73,88.99,10.26
sidra_9541_PercMoradDPPOColetTot_munic_22_pol.fid-703dc0a5_191866d88cb_-7a0,4115457,Marquinho - PR,2202,2745,543,4503,48.9,60.96,12.06
sidra_9541_PercMoradDPPOColetTot_munic_22_pol.fid-703dc0a5_191866d88cb_-79f,4115507,Marumbi - PR,4361,4366,5,4699,92.81,92.91,0.11
sidra_9541_PercMoradDPPOColetTot_munic_22_pol.fid-703dc0a5_191866d88cb_-79e,4115606,Matelândia - PR,17832,17857,25,18374,97.05,97.19,0.14
sidra_9541_PercMoradDPPOColetTot_munic_22_pol.fid-703dc0a5_191866d88cb_-79d,4115705,Matinhos - PR,37716,38799,1083,39190,96.24,99,2.76
sidra_9541_PercMoradDPPOColetTot_munic_22_pol.fid-703dc0a5_191866d88cb_-79c,4115739,Mato Rico - PR,1838,1945,107,3259,56.4,59.68,3.28
sidra_9541_PercMoradDPPOColetTot_munic_22_pol.fid-703dc0a5_191866d88cb_-79b,4115754,Mauá da Serra - PR,9131,9140,9,9376,97.39,97.48,0.1
sidra_9541_PercMoradDPPOColetTot_munic_22_pol.fid-703dc0a5_191866d88cb_-79a,4314787,Ponte Preta - RS,734,790,56,1575,46.6,50.16,3.56
sidra_9541_PercMoradDPPOColetTot_munic_22_pol.fid-703dc0a5_191866d88cb_-799,4115804,Medianeira - PR,51742,52718,976,54215,95.44,97.24,1.8
sidra_9541_PercMoradDPPOColetTot_munic_22_pol.fid-703dc0a5_191866d88cb_-798,4314803,Portão - RS,32666,33713,1047,33846,96.51,99.61,3.09
sidra_9541_PercMoradDPPOColetTot_munic_22_pol.fid-703dc0a5_191866d88cb_-797,4314902,Porto Alegre - RS,1110966,1313949,202983,1322584,84,99.35,15.35
sidra_9541_PercMoradDPPOColetTot_munic_22_pol.fid-703dc0a5_191866d88cb_-796,4315008,Porto Lucena - RS,2128,3328,1200,4349,48.93,76.52,27.59
sidra_9541_PercMoradDPPOColetTot_munic_22_pol.fid-703dc0a5_191866d88cb_-795,4315057,Porto Mauá - RS,1484,2078,594,2138,69.41,97.19,27.78
sidra_9541_PercMoradDPPOColetTot_munic_22_pol.fid-703dc0a5_191866d88cb_-794,4315073,Porto Vera Cruz - RS,886,1433,547,1560,56.79,91.86,35.06
sidra_9541_PercMoradDPPOColetTot_munic_22_pol.fid-703dc0a5_191866d88cb_-793,4315107,Porto Xavier - RS,7351,8175,824,9922,74.09,82.39,8.3
sidra_9541_PercMoradDPPOColetTot_munic_22_pol.fid-703dc0a5_191866d88cb_-792,4315131,Pouso Novo - RS,1270,1270,,1739,73.03,73.03,
sidra_9541_PercMoradDPPOColetTot_munic_22_pol.fid-703dc0a5_191866d88cb_-791,4115853,Mercedes - PR,4108,5012,904,5926,69.32,84.58,15.25
sidra_9541_PercMoradDPPOColetTot_munic_22_pol.fid-703dc0a5_191866d88cb_-790,4126652,Sulina - PR,2560,2693,133,3438,74.46,78.33,3.87
sidra_9541_PercMoradDPPOColetTot_munic_22_pol.fid-703dc0a5_191866d88cb_-78f,4115903,Mirador - PR,1903,1903,,2236,85.11,85.11,
sidra_9541_PercMoradDPPOColetTot_munic_22_pol.fid-703dc0a5_191866d88cb_-78e,4126678,Tamarana - PR,7753,7942,189,10604,73.11,74.9,1.78
sidra_9541_PercMoradDPPOColetTot_munic_22_pol.fid-703dc0a5_191866d88cb_-78d,4126702,Tamboara - PR,4356,4443,87,4880,89.26,91.05,1.78
sidra_9541_PercMoradDPPOColetTot_munic_22_pol.fid-703dc0a5_191866d88cb_-78c,4126801,Tapejara - PR,14475,14725,250,15861,91.26,92.84,1.58
sidra_9541_PercMoradDPPOColetTot_munic_22_pol.fid-703dc0a5_191866d88cb_-78b,4126900,Tapira - PR,4619,4628,9,5709,80.91,81.06,0.16
sidra_9541_PercMoradDPPOColetTot_munic_22_pol.fid-703dc0a5_191866d88cb_-78a,4127007,Teixeira Soares - PR,7896,8027,131,9513,83,84.38,1.38
sidra_9541_PercMoradDPPOColetTot_munic_22_pol.fid-703dc0a5_191866d88cb_-789,4127106,Telêmaco Borba - PR,73303,74462,1159,74699,98.13,99.68,1.55
sidra_9541_PercMoradDPPOColetTot_munic_22_pol.fid-703dc0a5_191866d88cb_-788,4315552,Rio dos Índios - RS,845,930,85,2833,29.83,32.83,3
sidra_9541_PercMoradDPPOColetTot_munic_22_pol.fid-703dc0a5_191866d88cb_-787,4315602,Rio Grande - RS,140184,189229,49045,190656,73.53,99.25,25.72
sidra_9541_PercMoradDPPOColetTot_munic_22_pol.fid-703dc0a5_191866d88cb_-786,4315701,Rio Pardo - RS,20027,32053,12026,34431,58.17,93.09,34.93
sidra_9541_PercMoradDPPOColetTot_munic_22_pol.fid-703dc0a5_191866d88cb_-785,4315750,Riozinho - RS,4025,4319,294,4423,91,97.65,6.65
sidra_9541_PercMoradDPPOColetTot_munic_22_pol.fid-703dc0a5_191866d88cb_-784,4116000,Miraselva - PR,1760,1764,4,1966,89.52,89.73,0.2
sidra_9541_PercMoradDPPOColetTot_munic_22_pol.fid-703dc0a5_191866d88cb_-783,4116059,Missal - PR,8725,9619,894,11021,79.17,87.28,8.11
sidra_9541_PercMoradDPPOColetTot_munic_22_pol.fid-703dc0a5_191866d88cb_-782,4117206,Nova Olímpia - PR,5395,5450,55,5822,92.67,93.61,0.94
sidra_9541_PercMoradDPPOColetTot_munic_22_pol.fid-703dc0a5_191866d88cb_-781,4316733,Santa Cecília do Sul - RS,731,1529,798,1674,43.67,91.34,47.67
sidra_9541_PercMoradDPPOColetTot_munic_22_pol.fid-703dc0a5_191866d88cb_-780,4316758,Santa Clara do Sul - RS,5505,6681,1176,6830,80.6,97.82,17.22
sidra_9541_PercMoradDPPOColetTot_munic_22_pol.fid-703dc0a5_191866d88cb_-77f,4316808,Santa Cruz do Sul - RS,108642,131343,22701,132215,82.17,99.34,17.17
sidra_9541_PercMoradDPPOColetTot_munic_22_pol.fid-703dc0a5_191866d88cb_-77e,4316907,Santa Maria - RS,207195,265687,58492,268726,77.1,98.87,21.77
sidra_9541_PercMoradDPPOColetTot_munic_22_pol.fid-703dc0a5_191866d88cb_-77d,4116109,Moreira Sales - PR,10049,10066,17,11126,90.32,90.47,0.15
sidra_9541_PercMoradDPPOColetTot_munic_22_pol.fid-703dc0a5_191866d88cb_-77c,4116208,Morretes - PR,14693,17391,2698,18303,80.28,95.02,14.74
sidra_9541_PercMoradDPPOColetTot_munic_22_pol.fid-703dc0a5_191866d88cb_-77b,4316956,Santa Maria do Herval - RS,5841,6139,298,6339,92.14,96.84,4.7
sidra_9541_PercMoradDPPOColetTot_munic_22_pol.fid-703dc0a5_191866d88cb_-77a,4316972,Santa Margarida do Sul - RS,1519,2029,510,2596,58.51,78.16,19.65
sidra_9541_PercMoradDPPOColetTot_munic_22_pol.fid-703dc0a5_191866d88cb_-779,4317004,Santana da Boa Vista - RS,4079,4314,235,7017,58.13,61.48,3.35
sidra_9541_PercMoradDPPOColetTot_munic_22_pol.fid-703dc0a5_191866d88cb_-778,4317103,Sant'Ana do Livramento - RS,74132,78428,4296,83957,88.3,93.41,5.12
sidra_9541_PercMoradDPPOColetTot_munic_22_pol.fid-703dc0a5_191866d88cb_-777,4317202,Santa Rosa - RS,66142,75081,8939,76458,86.51,98.2,11.69
sidra_9541_PercMoradDPPOColetTot_munic_22_pol.fid-703dc0a5_191866d88cb_-776,4116307,Munhoz de Melo - PR,3677,3779,102,3939,93.35,95.94,2.59
sidra_9541_PercMoradDPPOColetTot_munic_22_pol.fid-703dc0a5_191866d88cb_-775,4118451,Pato Bragado - PR,4728,5392,664,5732,82.48,94.07,11.58
sidra_9541_PercMoradDPPOColetTot_munic_22_pol.fid-703dc0a5_191866d88cb_-774,4118501,Pato Branco - PR,86233,89674,3441,91633,94.11,97.86,3.76
sidra_9541_PercMoradDPPOColetTot_munic_22_pol.fid-703dc0a5_191866d88cb_-773,4118600,Paula Freitas - PR,3180,4264,1084,5663,56.15,75.3,19.14
sidra_9541_PercMoradDPPOColetTot_munic_22_pol.fid-703dc0a5_191866d88cb_-772,4118709,Paulo Frontin - PR,3867,4138,271,6320,61.19,65.47,4.29
sidra_9541_PercMoradDPPOColetTot_munic_22_pol.fid-703dc0a5_191866d88cb_-771,4118808,Peabiru - PR,11853,11916,63,13305,89.09,89.56,0.47
sidra_9541_PercMoradDPPOColetTot_munic_22_pol.fid-703dc0a5_191866d88cb_-770,4116406,Nossa Senhora das Graças - PR,3423,3429,6,3666,93.37,93.54,0.16
sidra_9541_PercMoradDPPOColetTot_munic_22_pol.fid-703dc0a5_191866d88cb_-76f,4118857,Perobal - PR,6153,6246,93,7184,85.65,86.94,1.29
sidra_9541_PercMoradDPPOColetTot_munic_22_pol.fid-703dc0a5_191866d88cb_-76e,4118907,Pérola - PR,10832,11010,178,11815,91.68,93.19,1.51
sidra_9541_PercMoradDPPOColetTot_munic_22_pol.fid-703dc0a5_191866d88cb_-76d,4119004,Pérola d'Oeste - PR,4532,4789,257,6210,72.98,77.12,4.14
sidra_9541_PercMoradDPPOColetTot_munic_22_pol.fid-703dc0a5_191866d88cb_-76c,4119103,Piên - PR,9276,12308,3032,13646,67.98,90.19,22.22
sidra_9541_PercMoradDPPOColetTot_munic_22_pol.fid-703dc0a5_191866d88cb_-76b,4119152,Pinhais - PR,125640,126365,725,126413,99.39,99.96,0.57
sidra_9541_PercMoradDPPOColetTot_munic_22_pol.fid-703dc0a5_191866d88cb_-76a,4119202,Pinhalão - PR,4998,5541,543,6538,76.45,84.75,8.31
sidra_9541_PercMoradDPPOColetTot_munic_22_pol.fid-703dc0a5_191866d88cb_-769,4127205,Terra Boa - PR,16289,16584,295,17536,92.89,94.57,1.68
sidra_9541_PercMoradDPPOColetTot_munic_22_pol.fid-703dc0a5_191866d88cb_-768,4116505,Nova Aliança do Ivaí - PR,1090,1093,3,1323,82.39,82.62,0.23
sidra_9541_PercMoradDPPOColetTot_munic_22_pol.fid-703dc0a5_191866d88cb_-767,4116604,Nova América da Colina - PR,2912,2958,46,3280,88.78,90.18,1.4
sidra_9541_PercMoradDPPOColetTot_munic_22_pol.fid-703dc0a5_191866d88cb_-766,4116703,Nova Aurora - PR,11309,11642,333,13738,82.32,84.74,2.42
sidra_9541_PercMoradDPPOColetTot_munic_22_pol.fid-703dc0a5_191866d88cb_-765,4116802,Nova Cantu - PR,4566,4849,283,6785,67.3,71.47,4.17
sidra_9541_PercMoradDPPOColetTot_munic_22_pol.fid-703dc0a5_191866d88cb_-763,4116901,Nova Esperança - PR,24493,24769,276,26538,92.29,93.33,1.04
sidra_9541_PercMoradDPPOColetTot_munic_22_pol.fid-703dc0a5_191866d88cb_-762,4116950,Nova Esperança do Sudoeste - PR,2874,3364,490,5597,51.35,60.1,8.75
sidra_9541_PercMoradDPPOColetTot_munic_22_pol.fid-703dc0a5_191866d88cb_-761,4117008,Nova Fátima - PR,6622,6641,19,7223,91.68,91.94,0.26
sidra_9541_PercMoradDPPOColetTot_munic_22_pol.fid-703dc0a5_191866d88cb_-760,4117057,Nova Laranjeiras - PR,3629,3892,263,12047,30.12,32.31,2.18
sidra_9541_PercMoradDPPOColetTot_munic_22_pol.fid-703dc0a5_191866d88cb_-75f,4117107,Nova Londrina - PR,12203,12255,52,12876,94.77,95.18,0.4
sidra_9541_PercMoradDPPOColetTot_munic_22_pol.fid-703dc0a5_191866d88cb_-75e,4119608,Pitanga - PR,22616,24178,1562,33491,67.53,72.19,4.66
sidra_9541_PercMoradDPPOColetTot_munic_22_pol.fid-703dc0a5_191866d88cb_-75d,4117214,Nova Santa Bárbara - PR,3704,3704,,4184,88.53,88.53,
sidra_9541_PercMoradDPPOColetTot_munic_22_pol.fid-703dc0a5_191866d88cb_-75c,4117222,Nova Santa Rosa - PR,6630,6772,142,8284,80.03,81.75,1.71
sidra_9541_PercMoradDPPOColetTot_munic_22_pol.fid-703dc0a5_191866d88cb_-75b,4117255,Nova Prata do Iguaçu - PR,8719,9900,1181,12691,68.7,78.01,9.31
sidra_9541_PercMoradDPPOColetTot_munic_22_pol.fid-703dc0a5_191866d88cb_-75a,4117271,Nova Tebas - PR,5110,5145,35,6830,74.82,75.33,0.51
sidra_9541_PercMoradDPPOColetTot_munic_22_pol.fid-703dc0a5_191866d88cb_-759,4117297,Novo Itacolomi - PR,2221,2284,63,3124,71.09,73.11,2.02
sidra_9541_PercMoradDPPOColetTot_munic_22_pol.fid-703dc0a5_191866d88cb_-758,4117305,Ortigueira - PR,16745,17476,731,24074,69.56,72.59,3.04
sidra_9541_PercMoradDPPOColetTot_munic_22_pol.fid-703dc0a5_191866d88cb_-757,4117404,Ourizona - PR,3061,3063,2,3187,96.05,96.11,0.06
sidra_9541_PercMoradDPPOColetTot_munic_22_pol.fid-703dc0a5_191866d88cb_-756,4117453,Ouro Verde do Oeste - PR,5389,5507,118,6748,79.86,81.61,1.75
sidra_9541_PercMoradDPPOColetTot_munic_22_pol.fid-703dc0a5_191866d88cb_-755,4119806,Planalto - PR,9069,9525,456,14329,63.29,66.47,3.18
sidra_9541_PercMoradDPPOColetTot_munic_22_pol.fid-703dc0a5_191866d88cb_-754,4119905,Ponta Grossa - PR,340565,353739,13174,356311,95.58,99.28,3.7
sidra_9541_PercMoradDPPOColetTot_munic_22_pol.fid-703dc0a5_191866d88cb_-753,4119954,Pontal do Paraná - PR,28880,30281,1401,30403,94.99,99.6,4.61
sidra_9541_PercMoradDPPOColetTot_munic_22_pol.fid-703dc0a5_191866d88cb_-752,4117503,Paiçandu - PR,45366,45469,103,45932,98.77,98.99,0.22
sidra_9541_PercMoradDPPOColetTot_munic_22_pol.fid-703dc0a5_191866d88cb_-751,4117602,Palmas - PR,44742,45261,519,48101,93.02,94.1,1.08
sidra_9541_PercMoradDPPOColetTot_munic_22_pol.fid-703dc0a5_191866d88cb_-750,4117701,Palmeira - PR,24745,26249,1504,33794,73.22,77.67,4.45
sidra_9541_PercMoradDPPOColetTot_munic_22_pol.fid-703dc0a5_191866d88cb_-74f,4117800,Palmital - PR,8190,8692,502,13024,62.88,66.74,3.85
sidra_9541_PercMoradDPPOColetTot_munic_22_pol.fid-703dc0a5_191866d88cb_-74d,4317251,Santa Tereza - RS,1347,1466,119,1503,89.62,97.54,7.92
sidra_9541_PercMoradDPPOColetTot_munic_22_pol.fid-703dc0a5_191866d88cb_-74c,4117909,Palotina - PR,32341,32799,458,34930,92.59,93.9,1.31
sidra_9541_PercMoradDPPOColetTot_munic_22_pol.fid-703dc0a5_191866d88cb_-74b,4317301,Santa Vitória do Palmar - RS,27618,29544,1926,30778,89.73,95.99,6.26
sidra_9541_PercMoradDPPOColetTot_munic_22_pol.fid-703dc0a5_191866d88cb_-74a,4317400,Santiago - RS,44046,46951,2905,48669,90.5,96.47,5.97
sidra_9541_PercMoradDPPOColetTot_munic_22_pol.fid-703dc0a5_191866d88cb_-749,4317509,Santo Ângelo - RS,73237,74414,1177,76182,96.13,97.68,1.54
sidra_9541_PercMoradDPPOColetTot_munic_22_pol.fid-703dc0a5_191866d88cb_-748,4118006,Paraíso do Norte - PR,12788,12789,1,13223,96.71,96.72,0.01
sidra_9541_PercMoradDPPOColetTot_munic_22_pol.fid-703dc0a5_191866d88cb_-747,4317558,Santo Antônio do Palma - RS,2032,2032,,2091,97.18,97.18,
sidra_9541_PercMoradDPPOColetTot_munic_22_pol.fid-703dc0a5_191866d88cb_-746,4317608,Santo Antônio da Patrulha - RS,40001,41073,1072,42637,93.82,96.33,2.51
sidra_9541_PercMoradDPPOColetTot_munic_22_pol.fid-703dc0a5_191866d88cb_-745,4317707,Santo Antônio das Missões - RS,7245,7601,356,10238,70.77,74.24,3.48
sidra_9541_PercMoradDPPOColetTot_munic_22_pol.fid-703dc0a5_191866d88cb_-744,4118105,Paranacity - PR,9162,9166,4,9497,96.47,96.51,0.04
sidra_9541_PercMoradDPPOColetTot_munic_22_pol.fid-703dc0a5_191866d88cb_-743,4118204,Paranaguá - PR,137344,143569,6225,145425,94.44,98.72,4.28
sidra_9541_PercMoradDPPOColetTot_munic_22_pol.fid-703dc0a5_191866d88cb_-742,4118303,Paranapoema - PR,2340,2340,,2394,97.74,97.74,
sidra_9541_PercMoradDPPOColetTot_munic_22_pol.fid-703dc0a5_191866d88cb_-741,4118402,Paranavaí - PR,88110,89626,1516,91659,96.13,97.78,1.65
sidra_9541_PercMoradDPPOColetTot_munic_22_pol.fid-703dc0a5_191866d88cb_-740,4119251,Pinhal de São Bento - PR,2118,2129,11,2761,76.71,77.11,0.4
sidra_9541_PercMoradDPPOColetTot_munic_22_pol.fid-703dc0a5_191866d88cb_-73f,4119301,Pinhão - PR,19724,20697,973,29832,66.12,69.38,3.26
sidra_9541_PercMoradDPPOColetTot_munic_22_pol.fid-703dc0a5_191866d88cb_-73e,4119400,Piraí do Sul - PR,17371,20183,2812,23605,73.59,85.5,11.91
sidra_9541_PercMoradDPPOColetTot_munic_22_pol.fid-703dc0a5_191866d88cb_-73d,4119509,Piraquara - PR,108906,111602,2696,111964,97.27,99.68,2.41
sidra_9541_PercMoradDPPOColetTot_munic_22_pol.fid-703dc0a5_191866d88cb_-73c,4119657,Pitangueiras - PR,2732,2732,,3042,89.81,89.81,
sidra_9541_PercMoradDPPOColetTot_munic_22_pol.fid-703dc0a5_191866d88cb_-73b,4310363,Imigrante - RS,2952,2985,33,3067,96.25,97.33,1.08
sidra_9541_PercMoradDPPOColetTot_munic_22_pol.fid-703dc0a5_191866d88cb_-73a,4310405,Independência - RS,4531,5017,486,6423,70.54,78.11,7.57
sidra_9541_PercMoradDPPOColetTot_munic_22_pol.fid-703dc0a5_191866d88cb_-739,4310413,Inhacorá - RS,1633,1638,5,2014,81.08,81.33,0.25
sidra_9541_PercMoradDPPOColetTot_munic_22_pol.fid-703dc0a5_191866d88cb_-738,4310439,Ipê - RS,4120,5206,1086,5394,76.38,96.51,20.13
sidra_9541_PercMoradDPPOColetTot_munic_22_pol.fid-703dc0a5_191866d88cb_-736,4310462,Ipiranga do Sul - RS,975,1124,149,1717,56.79,65.46,8.68
sidra_9541_PercMoradDPPOColetTot_munic_22_pol.fid-703dc0a5_191866d88cb_-735,4119707,Planaltina do Paraná - PR,3202,3202,,4061,78.85,78.85,
sidra_9541_PercMoradDPPOColetTot_munic_22_pol.fid-703dc0a5_191866d88cb_-734,4120002,Porecatu - PR,11071,11209,138,11484,96.4,97.61,1.2
sidra_9541_PercMoradDPPOColetTot_munic_22_pol.fid-703dc0a5_191866d88cb_-733,4120101,Porto Amazonas - PR,3962,4003,41,4089,96.89,97.9,1
sidra_9541_PercMoradDPPOColetTot_munic_22_pol.fid-703dc0a5_191866d88cb_-731,4120150,Porto Barreiro - PR,1169,1388,219,3110,37.59,44.63,7.04
sidra_9541_PercMoradDPPOColetTot_munic_22_pol.fid-703dc0a5_191866d88cb_-730,4120200,Porto Rico - PR,2743,2759,16,3181,86.23,86.73,0.5
sidra_9541_PercMoradDPPOColetTot_munic_22_pol.fid-703dc0a5_191866d88cb_-72f,4310504,Iraí - RS,4945,5807,862,7338,67.39,79.14,11.75
sidra_9541_PercMoradDPPOColetTot_munic_22_pol.fid-703dc0a5_191866d88cb_-72d,4120309,Porto Vitória - PR,2518,2600,82,3533,71.27,73.59,2.32
sidra_9541_PercMoradDPPOColetTot_munic_22_pol.fid-703dc0a5_191866d88cb_-72c,4120333,Prado Ferreira - PR,3488,3494,6,3703,94.19,94.36,0.16
sidra_9541_PercMoradDPPOColetTot_munic_22_pol.fid-703dc0a5_191866d88cb_-72b,4120358,Pranchita - PR,4504,4518,14,5737,78.51,78.75,0.24
sidra_9541_PercMoradDPPOColetTot_munic_22_pol.fid-703dc0a5_191866d88cb_-72a,4120408,Presidente Castelo Branco - PR,4202,4238,36,4325,97.16,97.99,0.83
sidra_9541_PercMoradDPPOColetTot_munic_22_pol.fid-703dc0a5_191866d88cb_-729,4121000,Querência do Norte - PR,7733,7852,119,10666,72.5,73.62,1.12
sidra_9541_PercMoradDPPOColetTot_munic_22_pol.fid-703dc0a5_191866d88cb_-728,4120507,Primeiro de Maio - PR,9464,9466,2,10062,94.06,94.08,0.02
sidra_9541_PercMoradDPPOColetTot_munic_22_pol.fid-703dc0a5_191866d88cb_-727,4120606,Prudentópolis - PR,36925,37394,469,49033,75.31,76.26,0.96
sidra_9541_PercMoradDPPOColetTot_munic_22_pol.fid-703dc0a5_191866d88cb_-726,4120655,Quarto Centenário - PR,3613,3643,30,4201,86,86.72,0.71
sidra_9541_PercMoradDPPOColetTot_munic_22_pol.fid-703dc0a5_191866d88cb_-725,4120705,Quatiguá - PR,7705,7880,175,8070,95.48,97.65,2.17
sidra_9541_PercMoradDPPOColetTot_munic_22_pol.fid-703dc0a5_191866d88cb_-724,4121257,Ramilândia - PR,2688,3328,640,4210,63.85,79.05,15.2
sidra_9541_PercMoradDPPOColetTot_munic_22_pol.fid-703dc0a5_191866d88cb_-723,4120804,Quatro Barras - PR,23424,23951,527,24151,96.99,99.17,2.18
sidra_9541_PercMoradDPPOColetTot_munic_22_pol.fid-703dc0a5_191866d88cb_-722,4120853,Quatro Pontes - PR,3172,3190,18,4480,70.8,71.21,0.4
sidra_9541_PercMoradDPPOColetTot_munic_22_pol.fid-703dc0a5_191866d88cb_-721,4120903,Quedas do Iguaçu - PR,21627,22010,383,30610,70.65,71.9,1.25
sidra_9541_PercMoradDPPOColetTot_munic_22_pol.fid-703dc0a5_191866d88cb_-720,4121109,Quinta do Sol - PR,4058,4140,82,4901,82.8,84.47,1.67
sidra_9541_PercMoradDPPOColetTot_munic_22_pol.fid-703dc0a5_191866d88cb_-71f,4121208,Quitandinha - PR,8488,16275,7787,18377,46.19,88.56,42.37
sidra_9541_PercMoradDPPOColetTot_munic_22_pol.fid-703dc0a5_191866d88cb_-71e,4122602,Rondon - PR,8426,8594,168,9092,92.67,94.52,1.85
sidra_9541_PercMoradDPPOColetTot_munic_22_pol.fid-703dc0a5_191866d88cb_-71d,4122651,Rosário do Ivaí - PR,3789,4353,564,5409,70.05,80.48,10.43
sidra_9541_PercMoradDPPOColetTot_munic_22_pol.fid-703dc0a5_191866d88cb_-71c,4122701,Sabáudia - PR,8074,8164,90,8822,91.52,92.54,1.02
sidra_9541_PercMoradDPPOColetTot_munic_22_pol.fid-703dc0a5_191866d88cb_-71b,4122800,Salgado Filho - PR,3077,3334,257,4060,75.79,82.12,6.33
sidra_9541_PercMoradDPPOColetTot_munic_22_pol.fid-703dc0a5_191866d88cb_-71a,4310801,Ivoti - RS,22751,22830,79,22840,99.61,99.96,0.35
sidra_9541_PercMoradDPPOColetTot_munic_22_pol.fid-703dc0a5_191866d88cb_-719,4310850,Jaboticaba - RS,620,2419,1799,3769,16.45,64.18,47.73
sidra_9541_PercMoradDPPOColetTot_munic_22_pol.fid-703dc0a5_191866d88cb_-718,4310876,Jacuizinho - RS,691,733,42,2040,33.87,35.93,2.06
sidra_9541_PercMoradDPPOColetTot_munic_22_pol.fid-703dc0a5_191866d88cb_-717,4310900,Jacutinga - RS,3142,3162,20,3313,94.84,95.44,0.6
sidra_9541_PercMoradDPPOColetTot_munic_22_pol.fid-703dc0a5_191866d88cb_-716,4311007,Jaguarão - RS,24676,25373,697,26443,93.32,95.95,2.64
sidra_9541_PercMoradDPPOColetTot_munic_22_pol.fid-703dc0a5_191866d88cb_-715,4122909,Salto do Itararé - PR,4207,4407,200,5189,81.08,84.93,3.85
sidra_9541_PercMoradDPPOColetTot_munic_22_pol.fid-703dc0a5_191866d88cb_-714,4123006,Salto do Lontra - PR,10052,10867,815,15207,66.1,71.46,5.36
sidra_9541_PercMoradDPPOColetTot_munic_22_pol.fid-703dc0a5_191866d88cb_-713,4311106,Jaguari - RS,6609,8432,1823,10475,63.09,80.5,17.4
sidra_9541_PercMoradDPPOColetTot_munic_22_pol.fid-703dc0a5_191866d88cb_-712,4311122,Jaquirana - RS,3388,3489,101,3686,91.92,94.66,2.74
sidra_9541_PercMoradDPPOColetTot_munic_22_pol.fid-703dc0a5_191866d88cb_-711,4123105,Santa Amélia - PR,3123,3205,82,3382,92.34,94.77,2.42
sidra_9541_PercMoradDPPOColetTot_munic_22_pol.fid-703dc0a5_191866d88cb_-710,4123204,Santa Cecília do Pavão - PR,3009,3020,11,3343,90.01,90.34,0.33
sidra_9541_PercMoradDPPOColetTot_munic_22_pol.fid-703dc0a5_191866d88cb_-70f,4123303,Santa Cruz de Monte Castelo - PR,7171,7230,59,8572,83.66,84.34,0.69
sidra_9541_PercMoradDPPOColetTot_munic_22_pol.fid-703dc0a5_191866d88cb_-70e,4123402,Santa Fé - PR,10633,10663,30,11347,93.71,93.97,0.26
sidra_9541_PercMoradDPPOColetTot_munic_22_pol.fid-703dc0a5_191866d88cb_-70c,4123501,Santa Helena - PR,22981,23486,505,25472,90.22,92.2,1.98
sidra_9541_PercMoradDPPOColetTot_munic_22_pol.fid-703dc0a5_191866d88cb_-70b,4123600,Santa Inês - PR,1513,1531,18,1748,86.56,87.59,1.03
sidra_9541_PercMoradDPPOColetTot_munic_22_pol.fid-703dc0a5_191866d88cb_-70a,4123709,Santa Isabel do Ivaí - PR,7987,8058,71,8906,89.68,90.48,0.8
sidra_9541_PercMoradDPPOColetTot_munic_22_pol.fid-703dc0a5_191866d88cb_-709,4123808,Santa Izabel do Oeste - PR,10330,10830,500,14048,73.53,77.09,3.56
sidra_9541_PercMoradDPPOColetTot_munic_22_pol.fid-703dc0a5_191866d88cb_-708,4123824,Santa Lúcia - PR,2618,3367,749,3644,71.84,92.4,20.55
sidra_9541_PercMoradDPPOColetTot_munic_22_pol.fid-703dc0a5_191866d88cb_-707,4123857,Santa Maria do Oeste - PR,4839,5500,661,9923,48.77,55.43,6.66
sidra_9541_PercMoradDPPOColetTot_munic_22_pol.fid-703dc0a5_191866d88cb_-706,4123907,Santa Mariana - PR,10323,10496,173,11051,93.41,94.98,1.57
sidra_9541_PercMoradDPPOColetTot_munic_22_pol.fid-703dc0a5_191866d88cb_-705,4311643,Linha Nova - RS,1587,1609,22,1683,94.3,95.6,1.31
sidra_9541_PercMoradDPPOColetTot_munic_22_pol.fid-703dc0a5_191866d88cb_-704,4311700,Machadinho - RS,3655,5429,1774,5734,63.74,94.68,30.94
sidra_9541_PercMoradDPPOColetTot_munic_22_pol.fid-703dc0a5_191866d88cb_-703,4123956,Santa Mônica - PR,3043,3045,2,3356,90.67,90.73,0.06
sidra_9541_PercMoradDPPOColetTot_munic_22_pol.fid-703dc0a5_191866d88cb_-702,4311759,Manoel Viana - RS,5392,5451,59,6791,79.4,80.27,0.87
sidra_9541_PercMoradDPPOColetTot_munic_22_pol.fid-703dc0a5_191866d88cb_-701,4311775,Maquiné - RS,5025,7128,2103,7402,67.89,96.3,28.41
sidra_9541_PercMoradDPPOColetTot_munic_22_pol.fid-703dc0a5_191866d88cb_-700,4311791,Maratá - RS,2078,2389,311,2462,84.4,97.03,12.63
sidra_9541_PercMoradDPPOColetTot_munic_22_pol.fid-703dc0a5_191866d88cb_-6ff,4311809,Marau - RS,39671,44105,4434,44995,88.17,98.02,9.85
sidra_9541_PercMoradDPPOColetTot_munic_22_pol.fid-703dc0a5_191866d88cb_-6fe,4124004,Santana do Itararé - PR,4382,4691,309,5482,79.93,85.57,5.64
sidra_9541_PercMoradDPPOColetTot_munic_22_pol.fid-703dc0a5_191866d88cb_-6fd,4124020,Santa Tereza do Oeste - PR,12324,12669,345,13173,93.56,96.17,2.62
sidra_9541_PercMoradDPPOColetTot_munic_22_pol.fid-703dc0a5_191866d88cb_-6fc,4124905,São João do Caiuá - PR,5134,5180,46,5571,92.16,92.98,0.83
sidra_9541_PercMoradDPPOColetTot_munic_22_pol.fid-703dc0a5_191866d88cb_-6fb,4127403,Terra Roxa - PR,15347,16409,1062,18112,84.73,90.6,5.86
sidra_9541_PercMoradDPPOColetTot_munic_22_pol.fid-703dc0a5_191866d88cb_-6fa,4125001,São João do Ivaí - PR,9490,9524,34,10596,89.56,89.88,0.32
sidra_9541_PercMoradDPPOColetTot_munic_22_pol.fid-703dc0a5_191866d88cb_-6f9,4125100,São João do Triunfo - PR,4692,11467,6775,13707,34.23,83.66,49.43
sidra_9541_PercMoradDPPOColetTot_munic_22_pol.fid-703dc0a5_191866d88cb_-6f8,4125209,São Jorge d'Oeste - PR,6507,7771,1264,9371,69.44,82.93,13.49
sidra_9541_PercMoradDPPOColetTot_munic_22_pol.fid-703dc0a5_191866d88cb_-6f7,4125308,São Jorge do Ivaí - PR,4815,4934,119,5163,93.26,95.56,2.3
sidra_9541_PercMoradDPPOColetTot_munic_22_pol.fid-703dc0a5_191866d88cb_-6f6,4127502,Tibagi - PR,16665,17812,1147,19922,83.65,89.41,5.76
sidra_9541_PercMoradDPPOColetTot_munic_22_pol.fid-703dc0a5_191866d88cb_-6f5,4127601,Tijucas do Sul - PR,14324,16504,2180,17576,81.5,93.9,12.4
sidra_9541_PercMoradDPPOColetTot_munic_22_pol.fid-703dc0a5_191866d88cb_-6f4,4127700,Toledo - PR,136990,140835,3845,150024,91.31,93.87,2.56
sidra_9541_PercMoradDPPOColetTot_munic_22_pol.fid-703dc0a5_191866d88cb_-6f3,4127809,Tomazina - PR,5604,6764,1160,8421,66.55,80.32,13.78
sidra_9541_PercMoradDPPOColetTot_munic_22_pol.fid-703dc0a5_191866d88cb_-6f2,4127858,Três Barras do Paraná - PR,7624,9459,1835,11128,68.51,85,16.49
sidra_9541_PercMoradDPPOColetTot_munic_22_pol.fid-703dc0a5_191866d88cb_-6f1,4127882,Tunas do Paraná - PR,5505,5909,404,6215,88.58,95.08,6.5
sidra_9541_PercMoradDPPOColetTot_munic_22_pol.fid-703dc0a5_191866d88cb_-6f0,4127908,Tuneiras do Oeste - PR,6942,7009,67,8067,86.05,86.88,0.83
sidra_9541_PercMoradDPPOColetTot_munic_22_pol.fid-703dc0a5_191866d88cb_-6ef,4125357,São Jorge do Patrocínio - PR,5312,5385,73,6493,81.81,82.94,1.12
sidra_9541_PercMoradDPPOColetTot_munic_22_pol.fid-703dc0a5_191866d88cb_-6ed,4128534,Ventania - PR,8032,8285,253,9664,83.11,85.73,2.62
sidra_9541_PercMoradDPPOColetTot_munic_22_pol.fid-703dc0a5_191866d88cb_-6ec,4125407,São José da Boa Vista - PR,4095,4784,689,6018,68.05,79.49,11.45
sidra_9541_PercMoradDPPOColetTot_munic_22_pol.fid-703dc0a5_191866d88cb_-6eb,4125456,São José das Palmeiras - PR,3050,3079,29,3956,77.1,77.83,0.73
sidra_9541_PercMoradDPPOColetTot_munic_22_pol.fid-703dc0a5_191866d88cb_-6ea,4125506,São José dos Pinhais - PR,309836,325533,15697,327721,94.54,99.33,4.79
sidra_9541_PercMoradDPPOColetTot_munic_22_pol.fid-703dc0a5_191866d88cb_-6e9,4125555,São Manoel do Paraná - PR,1891,1899,8,2138,88.45,88.82,0.37
sidra_9541_PercMoradDPPOColetTot_munic_22_pol.fid-703dc0a5_191866d88cb_-6e8,4125605,São Mateus do Sul - PR,29316,32887,3571,42327,69.26,77.7,8.44
sidra_9541_PercMoradDPPOColetTot_munic_22_pol.fid-703dc0a5_191866d88cb_-6e7,4125704,São Miguel do Iguaçu - PR,24345,25928,1583,29083,83.71,89.15,5.44
sidra_9541_PercMoradDPPOColetTot_munic_22_pol.fid-703dc0a5_191866d88cb_-6e6,4125753,São Pedro do Iguaçu - PR,4349,4535,186,5738,75.79,79.03,3.24
sidra_9541_PercMoradDPPOColetTot_munic_22_pol.fid-703dc0a5_191866d88cb_-6e4,4201257,Apiúna - SC,8062,9544,1482,9811,82.17,97.28,15.11
sidra_9541_PercMoradDPPOColetTot_munic_22_pol.fid-703dc0a5_191866d88cb_-6e3,4201273,Arabutã - SC,3840,4286,446,4377,87.73,97.92,10.19
sidra_9541_PercMoradDPPOColetTot_munic_22_pol.fid-703dc0a5_191866d88cb_-6e2,4125803,São Pedro do Ivaí - PR,8229,8231,2,8688,94.72,94.74,0.02
sidra_9541_PercMoradDPPOColetTot_munic_22_pol.fid-703dc0a5_191866d88cb_-6e1,4126009,São Sebastião da Amoreira - PR,7520,7548,28,8058,93.32,93.67,0.35
sidra_9541_PercMoradDPPOColetTot_munic_22_pol.fid-703dc0a5_191866d88cb_-6e0,4201307,Araquari - SC,44048,45090,1042,45214,97.42,99.73,2.3
sidra_9541_PercMoradDPPOColetTot_munic_22_pol.fid-703dc0a5_191866d88cb_-6de,4201406,Araranguá - SC,70156,70885,729,71511,98.11,99.12,1.02
sidra_9541_PercMoradDPPOColetTot_munic_22_pol.fid-703dc0a5_191866d88cb_-6dd,4201505,Armazém - SC,7745,8215,470,8829,87.72,93.05,5.32
sidra_9541_PercMoradDPPOColetTot_munic_22_pol.fid-703dc0a5_191866d88cb_-6dc,4126108,São Tomé - PR,5009,5039,30,5231,95.76,96.33,0.57
sidra_9541_PercMoradDPPOColetTot_munic_22_pol.fid-703dc0a5_191866d88cb_-6db,4126207,Sapopema - PR,5109,5327,218,6652,76.8,80.08,3.28
sidra_9541_PercMoradDPPOColetTot_munic_22_pol.fid-703dc0a5_191866d88cb_-6da,4126256,Sarandi - PR,117098,117884,786,118310,98.98,99.64,0.66
sidra_9541_PercMoradDPPOColetTot_munic_22_pol.fid-703dc0a5_191866d88cb_-6d9,4201604,Arroio Trinta - SC,3352,3384,32,3556,94.26,95.16,0.9
sidra_9541_PercMoradDPPOColetTot_munic_22_pol.fid-703dc0a5_191866d88cb_-6d8,4201653,Arvoredo - SC,1964,2165,201,2507,78.34,86.36,8.02
sidra_9541_PercMoradDPPOColetTot_munic_22_pol.fid-703dc0a5_191866d88cb_-6d7,4201703,Ascurra - SC,8174,8268,94,8316,98.29,99.42,1.13
sidra_9541_PercMoradDPPOColetTot_munic_22_pol.fid-703dc0a5_191866d88cb_-6d6,4201802,Atalanta - SC,2834,2945,111,3223,87.93,91.37,3.44
sidra_9541_PercMoradDPPOColetTot_munic_22_pol.fid-703dc0a5_191866d88cb_-6d5,4201901,Aurora - SC,4620,5782,1162,6767,68.27,85.44,17.17
sidra_9541_PercMoradDPPOColetTot_munic_22_pol.fid-703dc0a5_191866d88cb_-6d3,4201950,Balneário Arroio do Silva - SC,15695,15712,17,15759,99.59,99.7,0.11
sidra_9541_PercMoradDPPOColetTot_munic_22_pol.fid-703dc0a5_191866d88cb_-6d2,4202008,Balneário Camboriú - SC,126892,138503,11611,138701,91.49,99.86,8.37
sidra_9541_PercMoradDPPOColetTot_munic_22_pol.fid-703dc0a5_191866d88cb_-6d1,4202057,Balneário Barra do Sul - SC,14690,14867,177,14899,98.6,99.79,1.19
sidra_9541_PercMoradDPPOColetTot_munic_22_pol.fid-703dc0a5_191866d88cb_-6d0,4202073,Balneário Gaivota - SC,15560,15620,60,15640,99.49,99.87,0.38
sidra_9541_PercMoradDPPOColetTot_munic_22_pol.fid-703dc0a5_191866d88cb_-6ce,4202081,Bandeirante - SC,1270,2200,930,3143,40.41,70,29.59
sidra_9541_PercMoradDPPOColetTot_munic_22_pol.fid-703dc0a5_191866d88cb_-6cd,4202099,Barra Bonita - SC,670,1047,377,1661,40.34,63.03,22.7
sidra_9541_PercMoradDPPOColetTot_munic_22_pol.fid-703dc0a5_191866d88cb_-6cc,4202107,Barra Velha - SC,44659,44888,229,45139,98.94,99.44,0.51
sidra_9541_PercMoradDPPOColetTot_munic_22_pol.fid-703dc0a5_191866d88cb_-6cb,4202131,Bela Vista do Toldo - SC,3720,3765,45,5854,63.55,64.32,0.77
sidra_9541_PercMoradDPPOColetTot_munic_22_pol.fid-703dc0a5_191866d88cb_-6ca,4202156,Belmonte - SC,1664,1833,169,2657,62.63,68.99,6.36
sidra_9541_PercMoradDPPOColetTot_munic_22_pol.fid-703dc0a5_191866d88cb_-6c9,4202206,Benedito Novo - SC,9077,10383,1306,10508,86.38,98.81,12.43
sidra_9541_PercMoradDPPOColetTot_munic_22_pol.fid-703dc0a5_191866d88cb_-6c8,4202305,Biguaçu - SC,68522,76168,7646,76506,89.56,99.56,9.99
sidra_9541_PercMoradDPPOColetTot_munic_22_pol.fid-703dc0a5_191866d88cb_-6c7,4202404,Blumenau - SC,328812,358120,29308,358552,91.71,99.88,8.17
sidra_9541_PercMoradDPPOColetTot_munic_22_pol.fid-703dc0a5_191866d88cb_-6c6,4202438,Bocaina do Sul - SC,2346,3051,705,3512,66.8,86.87,20.07
sidra_9541_PercMoradDPPOColetTot_munic_22_pol.fid-703dc0a5_191866d88cb_-6c5,4202453,Bombinhas - SC,24389,24865,476,24875,98.05,99.96,1.91
sidra_9541_PercMoradDPPOColetTot_munic_22_pol.fid-703dc0a5_191866d88cb_-6c4,4202503,Bom Jardim da Serra - SC,2725,3648,923,4023,67.74,90.68,22.94
sidra_9541_PercMoradDPPOColetTot_munic_22_pol.fid-703dc0a5_191866d88cb_-6c2,4202537,Bom Jesus - SC,1941,2027,86,2775,69.95,73.05,3.1
sidra_9541_PercMoradDPPOColetTot_munic_22_pol.fid-703dc0a5_191866d88cb_-6c1,4202578,Bom Jesus do Oeste - SC,2123,2133,10,2181,97.34,97.8,0.46
sidra_9541_PercMoradDPPOColetTot_munic_22_pol.fid-703dc0a5_191866d88cb_-6c0,4202602,Bom Retiro - SC,7025,8154,1129,8408,83.55,96.98,13.43
sidra_9541_PercMoradDPPOColetTot_munic_22_pol.fid-703dc0a5_191866d88cb_-6be,4202701,Botuverá - SC,4552,5316,764,5363,84.88,99.12,14.25
sidra_9541_PercMoradDPPOColetTot_munic_22_pol.fid-703dc0a5_191866d88cb_-6bd,4202800,Braço do Norte - SC,28453,32004,3551,33733,84.35,94.87,10.53
sidra_9541_PercMoradDPPOColetTot_munic_22_pol.fid-703dc0a5_191866d88cb_-6bc,4202859,Braço do Trombudo - SC,3557,3936,379,3976,89.46,98.99,9.53
sidra_9541_PercMoradDPPOColetTot_munic_22_pol.fid-703dc0a5_191866d88cb_-6bb,4202875,Brunópolis - SC,1256,1907,651,2486,50.52,76.71,26.19
sidra_9541_PercMoradDPPOColetTot_munic_22_pol.fid-703dc0a5_191866d88cb_-6ba,4202909,Brusque - SC,135265,140638,5373,140884,96.01,99.83,3.81
sidra_9541_PercMoradDPPOColetTot_munic_22_pol.fid-703dc0a5_191866d88cb_-6b9,4203006,Caçador - SC,69656,71935,2279,73606,94.63,97.73,3.1
sidra_9541_PercMoradDPPOColetTot_munic_22_pol.fid-703dc0a5_191866d88cb_-6b8,4203105,Caibi - SC,4705,4789,84,6295,74.74,76.08,1.33
sidra_9541_PercMoradDPPOColetTot_munic_22_pol.fid-703dc0a5_191866d88cb_-6b6,4203154,Calmon - SC,2354,2387,33,3439,68.45,69.41,0.96
sidra_9541_PercMoradDPPOColetTot_munic_22_pol.fid-703dc0a5_191866d88cb_-6b5,4203204,Camboriú - SC,102011,102833,822,102994,99.05,99.84,0.8
sidra_9541_PercMoradDPPOColetTot_munic_22_pol.fid-703dc0a5_191866d88cb_-6b4,4126272,Saudade do Iguaçu - PR,4991,5156,165,6108,81.71,84.41,2.7
sidra_9541_PercMoradDPPOColetTot_munic_22_pol.fid-703dc0a5_191866d88cb_-6b3,4126306,Sengés - PR,15202,15809,607,17247,88.14,91.66,3.52
sidra_9541_PercMoradDPPOColetTot_munic_22_pol.fid-703dc0a5_191866d88cb_-6b2,4126355,Serranópolis do Iguaçu - PR,4076,4612,536,5007,81.41,92.11,10.71
sidra_9541_PercMoradDPPOColetTot_munic_22_pol.fid-703dc0a5_191866d88cb_-6b1,4203253,Capão Alto - SC,1232,2009,777,2625,46.93,76.53,29.6
sidra_9541_PercMoradDPPOColetTot_munic_22_pol.fid-703dc0a5_191866d88cb_-6af,4203303,Campo Alegre - SC,11084,11911,827,12443,89.08,95.72,6.65
sidra_9541_PercMoradDPPOColetTot_munic_22_pol.fid-703dc0a5_191866d88cb_-6ae,4203402,Campo Belo do Sul - SC,5040,5659,619,7246,69.56,78.1,8.54
sidra_9541_PercMoradDPPOColetTot_munic_22_pol.fid-703dc0a5_191866d88cb_-6ac,4203501,Campo Erê - SC,5877,8327,2450,9575,61.38,86.97,25.59
sidra_9541_PercMoradDPPOColetTot_munic_22_pol.fid-703dc0a5_191866d88cb_-6aa,4203600,Campos Novos - SC,32097,33545,1448,36790,87.24,91.18,3.94
sidra_9541_PercMoradDPPOColetTot_munic_22_pol.fid-703dc0a5_191866d88cb_-6a8,4203709,Canelinha - SC,12004,12375,371,12816,93.66,96.56,2.89
sidra_9541_PercMoradDPPOColetTot_munic_22_pol.fid-703dc0a5_191866d88cb_-6a7,4203808,Canoinhas - SC,48557,49473,916,54737,88.71,90.38,1.67
sidra_9541_PercMoradDPPOColetTot_munic_22_pol.fid-703dc0a5_191866d88cb_-6a5,4203907,Capinzal - SC,22700,22976,276,23288,97.48,98.66,1.19
sidra_9541_PercMoradDPPOColetTot_munic_22_pol.fid-703dc0a5_191866d88cb_-6a4,4203956,Capivari de Baixo - SC,23812,23905,93,23930,99.51,99.9,0.39
sidra_9541_PercMoradDPPOColetTot_munic_22_pol.fid-703dc0a5_191866d88cb_-6a3,4204004,Catanduvas - SC,9974,10244,270,10566,94.4,96.95,2.56
sidra_9541_PercMoradDPPOColetTot_munic_22_pol.fid-703dc0a5_191866d88cb_-6a2,4204103,Caxambu do Sul - SC,3015,3120,105,4612,65.37,67.65,2.28
sidra_9541_PercMoradDPPOColetTot_munic_22_pol.fid-703dc0a5_191866d88cb_-6a1,4204152,Celso Ramos - SC,2142,2540,398,2805,76.36,90.55,14.19
sidra_9541_PercMoradDPPOColetTot_munic_22_pol.fid-703dc0a5_191866d88cb_-6a0,4204178,Cerro Negro - SC,1589,1793,204,3317,47.9,54.05,6.15
sidra_9541_PercMoradDPPOColetTot_munic_22_pol.fid-703dc0a5_191866d88cb_-69e,4204194,Chapadão do Lageado - SC,2504,2789,285,2946,85,94.67,9.67
sidra_9541_PercMoradDPPOColetTot_munic_22_pol.fid-703dc0a5_191866d88cb_-69d,4204202,Chapecó - SC,181851,244576,62725,251866,72.2,97.11,24.9
sidra_9541_PercMoradDPPOColetTot_munic_22_pol.fid-703dc0a5_191866d88cb_-69c,4204251,Cocal do Sul - SC,17127,17166,39,17212,99.51,99.73,0.23
sidra_9541_PercMoradDPPOColetTot_munic_22_pol.fid-703dc0a5_191866d88cb_-69b,4204301,Concórdia - SC,71745,78269,6524,81423,88.11,96.13,8.01
sidra_9541_PercMoradDPPOColetTot_munic_22_pol.fid-703dc0a5_191866d88cb_-699,4204350,Cordilheira Alta - SC,2518,3545,1027,4781,52.67,74.15,21.48
sidra_9541_PercMoradDPPOColetTot_munic_22_pol.fid-703dc0a5_191866d88cb_-698,4204400,Coronel Freitas - SC,6804,7622,818,10359,65.68,73.58,7.9
sidra_9541_PercMoradDPPOColetTot_munic_22_pol.fid-703dc0a5_191866d88cb_-697,4204459,Coronel Martins - SC,1178,1242,64,2060,57.18,60.29,3.11
sidra_9541_PercMoradDPPOColetTot_munic_22_pol.fid-703dc0a5_191866d88cb_-695,4204509,Corupá - SC,14892,15077,185,15228,97.79,99.01,1.21
sidra_9541_PercMoradDPPOColetTot_munic_22_pol.fid-703dc0a5_191866d88cb_-694,4204558,Correia Pinto - SC,13769,14705,936,15700,87.7,93.66,5.96
sidra_9541_PercMoradDPPOColetTot_munic_22_pol.fid-703dc0a5_191866d88cb_-692,4204608,Criciúma - SC,210250,211888,1638,212213,99.07,99.85,0.77
sidra_9541_PercMoradDPPOColetTot_munic_22_pol.fid-703dc0a5_191866d88cb_-691,4204707,Cunha Porã - SC,7023,9018,1995,10864,64.64,83.01,18.36
sidra_9541_PercMoradDPPOColetTot_munic_22_pol.fid-703dc0a5_191866d88cb_-690,4204756,Cunhataí - SC,1329,1363,34,1964,67.67,69.4,1.73
sidra_9541_PercMoradDPPOColetTot_munic_22_pol.fid-703dc0a5_191866d88cb_-68e,4204806,Curitibanos - SC,37020,39264,2244,39975,92.61,98.22,5.61
sidra_9541_PercMoradDPPOColetTot_munic_22_pol.fid-703dc0a5_191866d88cb_-68c,4204905,Descanso - SC,4830,6707,1877,8505,56.79,78.86,22.07
sidra_9541_PercMoradDPPOColetTot_munic_22_pol.fid-703dc0a5_191866d88cb_-68a,4205001,Dionísio Cerqueira - SC,11651,11860,209,14977,77.79,79.19,1.4
sidra_9541_PercMoradDPPOColetTot_munic_22_pol.fid-703dc0a5_191866d88cb_-689,4205100,Dona Emma - SC,2788,3862,1074,4206,66.29,91.82,25.53
sidra_9541_PercMoradDPPOColetTot_munic_22_pol.fid-703dc0a5_191866d88cb_-688,4205159,Doutor Pedrinho - SC,3481,3522,41,3637,95.71,96.84,1.13
sidra_9541_PercMoradDPPOColetTot_munic_22_pol.fid-703dc0a5_191866d88cb_-687,4205175,Entre Rios - SC,1363,1397,34,3402,40.06,41.06,1
sidra_9541_PercMoradDPPOColetTot_munic_22_pol.fid-703dc0a5_191866d88cb_-686,4205191,Ermo - SC,949,2151,1202,2252,42.14,95.52,53.37
sidra_9541_PercMoradDPPOColetTot_munic_22_pol.fid-703dc0a5_191866d88cb_-685,4205209,Erval Velho - SC,3395,4512,1117,4826,70.35,93.49,23.15
sidra_9541_PercMoradDPPOColetTot_munic_22_pol.fid-703dc0a5_191866d88cb_-684,4205308,Faxinal dos Guedes - SC,9882,10262,380,11189,88.32,91.72,3.4
sidra_9541_PercMoradDPPOColetTot_munic_22_pol.fid-703dc0a5_191866d88cb_-682,4205357,Flor do Sertão - SC,427,910,483,1783,23.95,51.04,27.09
sidra_9541_PercMoradDPPOColetTot_munic_22_pol.fid-703dc0a5_191866d88cb_-680,4205407,Florianópolis - SC,486999,531886,44887,532907,91.39,99.81,8.42
sidra_9541_PercMoradDPPOColetTot_munic_22_pol.fid-703dc0a5_191866d88cb_-67f,4205431,Formosa do Sul - SC,859,2322,1463,2675,32.11,86.8,54.69
sidra_9541_PercMoradDPPOColetTot_munic_22_pol.fid-703dc0a5_191866d88cb_-67e,4205456,Forquilhinha - SC,29184,30782,1598,31336,93.13,98.23,5.1
sidra_9541_PercMoradDPPOColetTot_munic_22_pol.fid-703dc0a5_191866d88cb_-67d,4126405,Sertaneja - PR,5250,5390,140,5616,93.48,95.98,2.49
sidra_9541_PercMoradDPPOColetTot_munic_22_pol.fid-703dc0a5_191866d88cb_-67c,4205506,Fraiburgo - SC,29782,31013,1231,33463,89,92.68,3.68
sidra_9541_PercMoradDPPOColetTot_munic_22_pol.fid-703dc0a5_191866d88cb_-679,4205555,Frei Rogério - SC,1138,2073,935,2411,47.2,85.98,38.78
sidra_9541_PercMoradDPPOColetTot_munic_22_pol.fid-703dc0a5_191866d88cb_-678,4205605,Galvão - SC,2301,2332,31,3167,72.66,73.63,0.98
sidra_9541_PercMoradDPPOColetTot_munic_22_pol.fid-703dc0a5_191866d88cb_-676,4205704,Garopaba - SC,26398,29716,3318,29798,88.59,99.72,11.13
sidra_9541_PercMoradDPPOColetTot_munic_22_pol.fid-703dc0a5_191866d88cb_-675,4205803,Garuva - SC,17873,18349,476,18486,96.68,99.26,2.57
sidra_9541_PercMoradDPPOColetTot_munic_22_pol.fid-703dc0a5_191866d88cb_-674,4205902,Gaspar - SC,70209,72353,2144,72469,96.88,99.84,2.96
sidra_9541_PercMoradDPPOColetTot_munic_22_pol.fid-703dc0a5_191866d88cb_-672,4206009,Governador Celso Ramos - SC,15911,16848,937,16906,94.11,99.66,5.54
sidra_9541_PercMoradDPPOColetTot_munic_22_pol.fid-703dc0a5_191866d88cb_-671,4206108,Grão-Pará - SC,4084,4286,202,6277,65.06,68.28,3.22
sidra_9541_PercMoradDPPOColetTot_munic_22_pol.fid-703dc0a5_191866d88cb_-66f,4206207,Gravatal - SC,11047,12119,1072,12359,89.38,98.06,8.67
sidra_9541_PercMoradDPPOColetTot_munic_22_pol.fid-703dc0a5_191866d88cb_-66e,4206306,Guabiruba - SC,23140,24450,1310,24543,94.28,99.62,5.34
sidra_9541_PercMoradDPPOColetTot_munic_22_pol.fid-703dc0a5_191866d88cb_-66c,4206405,Guaraciaba - SC,5993,8712,2719,10790,55.54,80.74,25.2
sidra_9541_PercMoradDPPOColetTot_munic_22_pol.fid-703dc0a5_191866d88cb_-66b,4206504,Guaramirim - SC,44978,46482,1504,46625,96.47,99.69,3.23
sidra_9541_PercMoradDPPOColetTot_munic_22_pol.fid-703dc0a5_191866d88cb_-66a,4206603,Guarujá do Sul - SC,3528,4090,562,4827,73.09,84.73,11.64
sidra_9541_PercMoradDPPOColetTot_munic_22_pol.fid-703dc0a5_191866d88cb_-669,4206652,Guatambú - SC,5358,6271,913,8425,63.6,74.43,10.84
sidra_9541_PercMoradDPPOColetTot_munic_22_pol.fid-703dc0a5_191866d88cb_-668,4206702,Herval d'Oeste - SC,19478,20778,1300,21707,89.73,95.72,5.99
sidra_9541_PercMoradDPPOColetTot_munic_22_pol.fid-703dc0a5_191866d88cb_-667,4206751,Ibiam - SC,840,1421,581,2003,41.94,70.94,29.01
sidra_9541_PercMoradDPPOColetTot_munic_22_pol.fid-703dc0a5_191866d88cb_-666,4206801,Ibicaré - SC,2176,2795,619,3267,66.61,85.55,18.95
sidra_9541_PercMoradDPPOColetTot_munic_22_pol.fid-703dc0a5_191866d88cb_-665,4206900,Ibirama - SC,18949,19578,629,19846,95.48,98.65,3.17
sidra_9541_PercMoradDPPOColetTot_munic_22_pol.fid-703dc0a5_191866d88cb_-663,4207007,Içara - SC,55035,58058,3023,58938,93.38,98.51,5.13
sidra_9541_PercMoradDPPOColetTot_munic_22_pol.fid-703dc0a5_191866d88cb_-662,4207106,Ilhota - SC,16269,16870,601,17033,95.51,99.04,3.53
sidra_9541_PercMoradDPPOColetTot_munic_22_pol.fid-703dc0a5_191866d88cb_-661,4207205,Imaruí - SC,10365,11195,830,11878,87.26,94.25,6.99
sidra_9541_PercMoradDPPOColetTot_munic_22_pol.fid-703dc0a5_191866d88cb_-660,4207304,Imbituba - SC,49791,51837,2046,52212,95.36,99.28,3.92
sidra_9541_PercMoradDPPOColetTot_munic_22_pol.fid-703dc0a5_191866d88cb_-65f,4207403,Imbuia - SC,5148,5277,129,5965,86.3,88.47,2.16
sidra_9541_PercMoradDPPOColetTot_munic_22_pol.fid-703dc0a5_191866d88cb_-65d,4207502,Indaial - SC,70940,71194,254,71407,99.35,99.7,0.36
sidra_9541_PercMoradDPPOColetTot_munic_22_pol.fid-703dc0a5_191866d88cb_-65c,4207577,Iomerê - SC,1978,2825,847,2877,68.75,98.19,29.44
sidra_9541_PercMoradDPPOColetTot_munic_22_pol.fid-703dc0a5_191866d88cb_-65b,4207601,Ipira - SC,4267,4411,144,4575,93.27,96.42,3.15
sidra_9541_PercMoradDPPOColetTot_munic_22_pol.fid-703dc0a5_191866d88cb_-659,4207650,Iporã do Oeste - SC,8096,8357,261,9263,87.4,90.22,2.82
sidra_9541_PercMoradDPPOColetTot_munic_22_pol.fid-703dc0a5_191866d88cb_-658,4207684,Ipuaçu - SC,3210,3480,270,7728,41.54,45.03,3.49
sidra_9541_PercMoradDPPOColetTot_munic_22_pol.fid-703dc0a5_191866d88cb_-656,4207700,Ipumirim - SC,7454,7592,138,7816,95.37,97.13,1.77
sidra_9541_PercMoradDPPOColetTot_munic_22_pol.fid-703dc0a5_191866d88cb_-655,4207759,Iraceminha - SC,1837,2142,305,3984,46.11,53.77,7.66
sidra_9541_PercMoradDPPOColetTot_munic_22_pol.fid-703dc0a5_191866d88cb_-654,4207809,Irani - SC,8867,9532,665,10187,87.04,93.57,6.53
sidra_9541_PercMoradDPPOColetTot_munic_22_pol.fid-703dc0a5_191866d88cb_-64f,4207858,Irati - SC,1966,1966,,2069,95.02,95.02,
sidra_9541_PercMoradDPPOColetTot_munic_22_pol.fid-703dc0a5_191866d88cb_-64e,4207908,Irineópolis - SC,5896,8272,2376,10246,57.54,80.73,23.19
sidra_9541_PercMoradDPPOColetTot_munic_22_pol.fid-703dc0a5_191866d88cb_-64c,4208005,Itá - SC,5927,6583,656,7051,84.06,93.36,9.3
sidra_9541_PercMoradDPPOColetTot_munic_22_pol.fid-703dc0a5_191866d88cb_-64b,4208104,Itaiópolis - SC,14686,18073,3387,22011,66.72,82.11,15.39
sidra_9541_PercMoradDPPOColetTot_munic_22_pol.fid-703dc0a5_191866d88cb_-64a,4208203,Itajaí - SC,257868,262373,4505,262626,98.19,99.9,1.72
sidra_9541_PercMoradDPPOColetTot_munic_22_pol.fid-703dc0a5_191866d88cb_-648,4208302,Itapema - SC,75309,75619,310,75690,99.5,99.91,0.41
sidra_9541_PercMoradDPPOColetTot_munic_22_pol.fid-703dc0a5_191866d88cb_-647,4126504,Sertanópolis - PR,15012,15134,122,15915,94.33,95.09,0.77
sidra_9541_PercMoradDPPOColetTot_munic_22_pol.fid-703dc0a5_191866d88cb_-646,4126603,Siqueira Campos - PR,20019,21938,1919,22720,88.11,96.56,8.45
sidra_9541_PercMoradDPPOColetTot_munic_22_pol.fid-703dc0a5_191866d88cb_-644,4208401,Itapiranga - SC,12055,14273,2218,16621,72.53,85.87,13.34
sidra_9541_PercMoradDPPOColetTot_munic_22_pol.fid-703dc0a5_191866d88cb_-643,4208450,Itapoá - SC,29887,30537,650,30664,97.47,99.59,2.12
sidra_9541_PercMoradDPPOColetTot_munic_22_pol.fid-703dc0a5_191866d88cb_-641,4208500,Ituporanga - SC,23224,25764,2540,26365,88.09,97.72,9.63
sidra_9541_PercMoradDPPOColetTot_munic_22_pol.fid-703dc0a5_191866d88cb_-640,4208609,Jaborá - SC,3245,3767,522,4302,75.43,87.56,12.13
sidra_9541_PercMoradDPPOColetTot_munic_22_pol.fid-703dc0a5_191866d88cb_-63f,4208708,Jacinto Machado - SC,8534,9230,696,10620,80.36,86.91,6.55
sidra_9541_PercMoradDPPOColetTot_munic_22_pol.fid-703dc0a5_191866d88cb_-63e,4208807,Jaguaruna - SC,20166,20245,79,20371,98.99,99.38,0.39
sidra_9541_PercMoradDPPOColetTot_munic_22_pol.fid-703dc0a5_191866d88cb_-63d,4208906,Jaraguá do Sul - SC,178947,181312,2365,181976,98.34,99.64,1.3
sidra_9541_PercMoradDPPOColetTot_munic_22_pol.fid-703dc0a5_191866d88cb_-63c,4208955,Jardinópolis - SC,43,1402,1359,1776,2.42,78.94,76.52
sidra_9541_PercMoradDPPOColetTot_munic_22_pol.fid-703dc0a5_191866d88cb_-63b,4209003,Joaçaba - SC,18127,28938,10811,29998,60.43,96.47,36.04
sidra_9541_PercMoradDPPOColetTot_munic_22_pol.fid-703dc0a5_191866d88cb_-639,4209102,Joinville - SC,607778,611933,4155,612356,99.25,99.93,0.68
sidra_9541_PercMoradDPPOColetTot_munic_22_pol.fid-703dc0a5_191866d88cb_-636,4209151,José Boiteux - SC,4720,4768,48,5984,78.88,79.68,0.8
sidra_9541_PercMoradDPPOColetTot_munic_22_pol.fid-703dc0a5_191866d88cb_-635,4209177,Jupiá - SC,1908,1950,42,2551,74.79,76.44,1.65
sidra_9541_PercMoradDPPOColetTot_munic_22_pol.fid-703dc0a5_191866d88cb_-634,4209201,Lacerdópolis - SC,2088,2199,111,2245,93.01,97.95,4.94
sidra_9541_PercMoradDPPOColetTot_munic_22_pol.fid-703dc0a5_191866d88cb_-632,4209300,Lages - SC,157313,163134,5821,164210,95.8,99.34,3.54
sidra_9541_PercMoradDPPOColetTot_munic_22_pol.fid-703dc0a5_191866d88cb_-630,4209409,Laguna - SC,41176,42472,1296,42582,96.7,99.74,3.04
sidra_9541_PercMoradDPPOColetTot_munic_22_pol.fid-703dc0a5_191866d88cb_-62e,4209458,Lajeado Grande - SC,1580,1583,3,1699,93,93.17,0.18
sidra_9541_PercMoradDPPOColetTot_munic_22_pol.fid-703dc0a5_191866d88cb_-62d,4209508,Laurentino - SC,6847,7486,639,7906,86.61,94.69,8.08
sidra_9541_PercMoradDPPOColetTot_munic_22_pol.fid-703dc0a5_191866d88cb_-62c,4209607,Lauro Müller - SC,13764,14203,439,14381,95.71,98.76,3.05
sidra_9541_PercMoradDPPOColetTot_munic_22_pol.fid-703dc0a5_191866d88cb_-62b,4209706,Lebon Régis - SC,8561,8981,420,11449,74.78,78.44,3.67
sidra_9541_PercMoradDPPOColetTot_munic_22_pol.fid-703dc0a5_191866d88cb_-629,4209805,Leoberto Leal - SC,1777,2215,438,3315,53.6,66.82,13.21
sidra_9541_PercMoradDPPOColetTot_munic_22_pol.fid-703dc0a5_191866d88cb_-627,4209854,Lindóia do Sul - SC,4224,4272,48,4525,93.35,94.41,1.06
sidra_9541_PercMoradDPPOColetTot_munic_22_pol.fid-703dc0a5_191866d88cb_-626,4209904,Lontras - SC,11795,12518,723,12851,91.78,97.41,5.63
sidra_9541_PercMoradDPPOColetTot_munic_22_pol.fid-703dc0a5_191866d88cb_-625,4210001,Luiz Alves - SC,11305,11388,83,11680,96.79,97.5,0.71
sidra_9541_PercMoradDPPOColetTot_munic_22_pol.fid-703dc0a5_191866d88cb_-624,4210035,Luzerna - SC,4067,5445,1378,5793,70.21,93.99,23.79
sidra_9541_PercMoradDPPOColetTot_munic_22_pol.fid-703dc0a5_191866d88cb_-623,4210050,Macieira - SC,1386,1425,39,1778,77.95,80.15,2.19
sidra_9541_PercMoradDPPOColetTot_munic_22_pol.fid-703dc0a5_191866d88cb_-621,4210100,Mafra - SC,47231,48700,1469,54988,85.89,88.56,2.67
sidra_9541_PercMoradDPPOColetTot_munic_22_pol.fid-703dc0a5_191866d88cb_-620,4210209,Major Gercino - SC,3079,3188,109,3214,95.8,99.19,3.39
sidra_9541_PercMoradDPPOColetTot_munic_22_pol.fid-703dc0a5_191866d88cb_-61e,4210308,Major Vieira - SC,3969,4663,694,7399,53.64,63.02,9.38
sidra_9541_PercMoradDPPOColetTot_munic_22_pol.fid-703dc0a5_191866d88cb_-61c,4210407,Maracajá - SC,7650,7661,11,7749,98.72,98.86,0.14
sidra_9541_PercMoradDPPOColetTot_munic_22_pol.fid-703dc0a5_191866d88cb_-61b,4210506,Maravilha - SC,20601,25753,5152,28055,73.43,91.79,18.36
sidra_9541_PercMoradDPPOColetTot_munic_22_pol.fid-703dc0a5_191866d88cb_-61a,4210555,Marema - SC,1859,1983,124,2184,85.12,90.8,5.68
sidra_9541_PercMoradDPPOColetTot_munic_22_pol.fid-703dc0a5_191866d88cb_-619,4210605,Massaranduba - SC,16311,16847,536,17147,95.12,98.25,3.13
sidra_9541_PercMoradDPPOColetTot_munic_22_pol.fid-703dc0a5_191866d88cb_-618,4210704,Matos Costa - SC,1565,2021,456,2759,56.72,73.25,16.53
sidra_9541_PercMoradDPPOColetTot_munic_22_pol.fid-703dc0a5_191866d88cb_-617,4127304,Terra Rica - PR,13199,13339,140,14806,89.15,90.09,0.95
sidra_9541_PercMoradDPPOColetTot_munic_22_pol.fid-703dc0a5_191866d88cb_-616,4210803,Meleiro - SC,5818,5969,151,6948,83.74,85.91,2.17
sidra_9541_PercMoradDPPOColetTot_munic_22_pol.fid-703dc0a5_191866d88cb_-615,4210852,Mirim Doce - SC,1165,2258,1093,2508,46.45,90.03,43.58
sidra_9541_PercMoradDPPOColetTot_munic_22_pol.fid-703dc0a5_191866d88cb_-614,4210902,Modelo - SC,2387,3561,1174,4080,58.5,87.28,28.77
sidra_9541_PercMoradDPPOColetTot_munic_22_pol.fid-703dc0a5_191866d88cb_-611,4211009,Mondaí - SC,8813,8875,62,10053,87.67,88.28,0.62
sidra_9541_PercMoradDPPOColetTot_munic_22_pol.fid-703dc0a5_191866d88cb_-60f,4211058,Monte Carlo - SC,8457,8583,126,9107,92.86,94.25,1.38
sidra_9541_PercMoradDPPOColetTot_munic_22_pol.fid-703dc0a5_191866d88cb_-60e,4211108,Monte Castelo - SC,5995,6885,890,7722,77.64,89.16,11.53
sidra_9541_PercMoradDPPOColetTot_munic_22_pol.fid-703dc0a5_191866d88cb_-60c,4211207,Morro da Fumaça - SC,18291,18379,88,18535,98.68,99.16,0.47
sidra_9541_PercMoradDPPOColetTot_munic_22_pol.fid-703dc0a5_191866d88cb_-60b,4211256,Morro Grande - SC,2928,2962,34,3010,97.28,98.41,1.13
sidra_9541_PercMoradDPPOColetTot_munic_22_pol.fid-703dc0a5_191866d88cb_-60a,4211306,Navegantes - SC,85019,85979,960,86202,98.63,99.74,1.11
sidra_9541_PercMoradDPPOColetTot_munic_22_pol.fid-703dc0a5_191866d88cb_-609,4211405,Nova Erechim - SC,4216,4816,600,5155,81.78,93.42,11.64
sidra_9541_PercMoradDPPOColetTot_munic_22_pol.fid-703dc0a5_191866d88cb_-608,4211454,Nova Itaberaba - SC,2498,2921,423,4536,55.07,64.4,9.33
sidra_9541_PercMoradDPPOColetTot_munic_22_pol.fid-703dc0a5_191866d88cb_-607,4211504,Nova Trento - SC,12925,13068,143,13684,94.45,95.5,1.05
sidra_9541_PercMoradDPPOColetTot_munic_22_pol.fid-703dc0a5_191866d88cb_-605,4211603,Nova Veneza - SC,13309,13402,93,13604,97.83,98.52,0.68
sidra_9541_PercMoradDPPOColetTot_munic_22_pol.fid-703dc0a5_191866d88cb_-604,4211652,Novo Horizonte - SC,1383,1397,14,2641,52.37,52.9,0.53
sidra_9541_PercMoradDPPOColetTot_munic_22_pol.fid-703dc0a5_191866d88cb_-603,4211702,Orleans - SC,19451,21143,1692,23651,82.24,89.4,7.15
sidra_9541_PercMoradDPPOColetTot_munic_22_pol.fid-703dc0a5_191866d88cb_-602,4211751,Otacílio Costa - SC,16428,16940,512,17283,95.05,98.02,2.96
sidra_9541_PercMoradDPPOColetTot_munic_22_pol.fid-703dc0a5_191866d88cb_-600,4211801,Ouro - SC,5920,6480,560,7023,84.29,92.27,7.97
sidra_9541_PercMoradDPPOColetTot_munic_22_pol.fid-703dc0a5_191866d88cb_-5fe,4211850,Ouro Verde - SC,1081,1511,430,2180,49.59,69.31,19.72
sidra_9541_PercMoradDPPOColetTot_munic_22_pol.fid-703dc0a5_191866d88cb_-5fd,4211876,Paial - SC,835,1366,531,1927,43.33,70.89,27.56
sidra_9541_PercMoradDPPOColetTot_munic_22_pol.fid-703dc0a5_191866d88cb_-5fc,4211892,Painel - SC,1478,1871,393,2215,66.73,84.47,17.74
sidra_9541_PercMoradDPPOColetTot_munic_22_pol.fid-703dc0a5_191866d88cb_-5fa,4211900,Palhoça - SC,132356,220919,88563,221569,59.74,99.71,39.97
sidra_9541_PercMoradDPPOColetTot_munic_22_pol.fid-703dc0a5_191866d88cb_-5f9,4212007,Palma Sola - SC,6386,6837,451,7596,84.07,90.01,5.94
sidra_9541_PercMoradDPPOColetTot_munic_22_pol.fid-703dc0a5_191866d88cb_-5f7,4212056,Palmeira - SC,1690,2390,700,2559,66.04,93.4,27.35
sidra_9541_PercMoradDPPOColetTot_munic_22_pol.fid-703dc0a5_191866d88cb_-5f6,4127957,Tupãssi - PR,6902,7085,183,8076,85.46,87.73,2.27
sidra_9541_PercMoradDPPOColetTot_munic_22_pol.fid-703dc0a5_191866d88cb_-5f5,4127965,Turvo - PR,9584,10017,433,14225,67.37,70.42,3.04
sidra_9541_PercMoradDPPOColetTot_munic_22_pol.fid-703dc0a5_191866d88cb_-5f4,4128005,Ubiratã - PR,22982,23282,300,24690,93.08,94.3,1.22
sidra_9541_PercMoradDPPOColetTot_munic_22_pol.fid-703dc0a5_191866d88cb_-5f3,4128104,Umuarama - PR,109651,112405,2754,116703,93.96,96.32,2.36
sidra_9541_PercMoradDPPOColetTot_munic_22_pol.fid-703dc0a5_191866d88cb_-5f2,4128203,União da Vitória - PR,51866,53229,1363,54817,94.62,97.1,2.49
sidra_9541_PercMoradDPPOColetTot_munic_22_pol.fid-703dc0a5_191866d88cb_-5f1,4212106,Palmitos - SC,10710,11849,1139,15568,68.79,76.11,7.32
sidra_9541_PercMoradDPPOColetTot_munic_22_pol.fid-703dc0a5_191866d88cb_-5ef,4212205,Papanduva - SC,13428,15251,1823,19143,70.15,79.67,9.52
sidra_9541_PercMoradDPPOColetTot_munic_22_pol.fid-703dc0a5_191866d88cb_-5ee,4212239,Paraíso - SC,2025,3328,1303,4240,47.76,78.49,30.73
sidra_9541_PercMoradDPPOColetTot_munic_22_pol.fid-703dc0a5_191866d88cb_-5ed,4212254,Passo de Torres - SC,12832,12861,29,12880,99.63,99.85,0.23
sidra_9541_PercMoradDPPOColetTot_munic_22_pol.fid-703dc0a5_191866d88cb_-5eb,4212270,Passos Maia - SC,2190,2594,404,4020,54.48,64.53,10.05
sidra_9541_PercMoradDPPOColetTot_munic_22_pol.fid-703dc0a5_191866d88cb_-5ea,4212304,Paulo Lopes - SC,7599,8911,1312,9050,83.97,98.46,14.5
sidra_9541_PercMoradDPPOColetTot_munic_22_pol.fid-703dc0a5_191866d88cb_-5e9,4212403,Pedras Grandes - SC,3621,3796,175,4242,85.36,89.49,4.13
sidra_9541_PercMoradDPPOColetTot_munic_22_pol.fid-703dc0a5_191866d88cb_-5e7,4212502,Penha - SC,33210,33587,377,33619,98.78,99.9,1.12
sidra_9541_PercMoradDPPOColetTot_munic_22_pol.fid-703dc0a5_191866d88cb_-5e6,4212601,Peritiba - SC,2497,2791,294,2992,83.46,93.28,9.83
sidra_9541_PercMoradDPPOColetTot_munic_22_pol.fid-703dc0a5_191866d88cb_-5e5,4212650,Pescaria Brava - SC,9672,10009,337,10170,95.1,98.42,3.31
sidra_9541_PercMoradDPPOColetTot_munic_22_pol.fid-703dc0a5_191866d88cb_-5e4,4212700,Petrolândia - SC,4784,6439,1655,6715,71.24,95.89,24.65
sidra_9541_PercMoradDPPOColetTot_munic_22_pol.fid-703dc0a5_191866d88cb_-5e3,4212809,Balneário Piçarras - SC,26662,26927,265,27029,98.64,99.62,0.98
sidra_9541_PercMoradDPPOColetTot_munic_22_pol.fid-703dc0a5_191866d88cb_-5e2,4212908,Pinhalzinho - SC,19279,20617,1338,21917,87.96,94.07,6.1
sidra_9541_PercMoradDPPOColetTot_munic_22_pol.fid-703dc0a5_191866d88cb_-5e1,4213005,Pinheiro Preto - SC,3142,3418,276,3473,90.47,98.42,7.95
sidra_9541_PercMoradDPPOColetTot_munic_22_pol.fid-703dc0a5_191866d88cb_-5e0,4213104,Piratuba - SC,4099,5646,1547,5736,71.46,98.43,26.97
sidra_9541_PercMoradDPPOColetTot_munic_22_pol.fid-703dc0a5_191866d88cb_-5df,4213153,Planalto Alegre - SC,1691,2090,399,2942,57.48,71.04,13.56
sidra_9541_PercMoradDPPOColetTot_munic_22_pol.fid-703dc0a5_191866d88cb_-5de,4213203,Pomerode - SC,33713,34108,395,34247,98.44,99.59,1.15
sidra_9541_PercMoradDPPOColetTot_munic_22_pol.fid-703dc0a5_191866d88cb_-5dd,4213302,Ponte Alta - SC,3858,4102,244,4437,86.95,92.45,5.5
sidra_9541_PercMoradDPPOColetTot_munic_22_pol.fid-703dc0a5_191866d88cb_-5db,4213351,Ponte Alta do Norte - SC,3007,3118,111,3205,93.82,97.29,3.46
sidra_9541_PercMoradDPPOColetTot_munic_22_pol.fid-703dc0a5_191866d88cb_-5da,4213401,Ponte Serrada - SC,7547,9884,2337,10617,71.08,93.1,22.01
sidra_9541_PercMoradDPPOColetTot_munic_22_pol.fid-703dc0a5_191866d88cb_-5d8,4213500,Porto Belo - SC,27195,27435,240,27531,98.78,99.65,0.87
sidra_9541_PercMoradDPPOColetTot_munic_22_pol.fid-703dc0a5_191866d88cb_-5d7,4213609,Porto União - SC,29844,31574,1730,32770,91.07,96.35,5.28
sidra_9541_PercMoradDPPOColetTot_munic_22_pol.fid-703dc0a5_191866d88cb_-5d6,4213708,Pouso Redondo - SC,12726,14603,1877,17118,74.34,85.31,10.97
sidra_9541_PercMoradDPPOColetTot_munic_22_pol.fid-703dc0a5_191866d88cb_-5d5,4213807,Praia Grande - SC,7917,7980,63,8247,96,96.76,0.76
sidra_9541_PercMoradDPPOColetTot_munic_22_pol.fid-703dc0a5_191866d88cb_-5d4,4213906,Presidente Castello Branco - SC,1677,1677,,1689,99.29,99.29,
sidra_9541_PercMoradDPPOColetTot_munic_22_pol.fid-703dc0a5_191866d88cb_-5d2,4214003,Presidente Getúlio - SC,19057,19591,534,19993,95.32,97.99,2.67
sidra_9541_PercMoradDPPOColetTot_munic_22_pol.fid-703dc0a5_191866d88cb_-5d1,4214102,Presidente Nereu - SC,2085,2109,24,2287,91.17,92.22,1.05
sidra_9541_PercMoradDPPOColetTot_munic_22_pol.fid-703dc0a5_191866d88cb_-5d0,4214151,Princesa - SC,1789,2133,344,2958,60.48,72.11,11.63
sidra_9541_PercMoradDPPOColetTot_munic_22_pol.fid-703dc0a5_191866d88cb_-5cf,4214201,Quilombo - SC,7076,9707,2631,10987,64.4,88.35,23.95
sidra_9541_PercMoradDPPOColetTot_munic_22_pol.fid-703dc0a5_191866d88cb_-5ce,4214300,Rancho Queimado - SC,1958,3245,1287,3278,59.73,98.99,39.26
sidra_9541_PercMoradDPPOColetTot_munic_22_pol.fid-703dc0a5_191866d88cb_-5cd,4214409,Rio das Antas - SC,5290,5661,371,6253,84.6,90.53,5.93
sidra_9541_PercMoradDPPOColetTot_munic_22_pol.fid-703dc0a5_191866d88cb_-5cc,4214508,Rio do Campo - SC,5515,5971,456,6438,85.66,92.75,7.08
sidra_9541_PercMoradDPPOColetTot_munic_22_pol.fid-703dc0a5_191866d88cb_-5cb,4214607,Rio do Oeste - SC,6501,6572,71,7626,85.25,86.18,0.93
sidra_9541_PercMoradDPPOColetTot_munic_22_pol.fid-703dc0a5_191866d88cb_-5ca,4128302,Uniflor - PR,2007,2007,,2135,94,94,
sidra_9541_PercMoradDPPOColetTot_munic_22_pol.fid-703dc0a5_191866d88cb_-5c9,4214706,Rio dos Cedros - SC,9795,10676,881,10844,90.33,98.45,8.12
sidra_9541_PercMoradDPPOColetTot_munic_22_pol.fid-703dc0a5_191866d88cb_-5c8,4214805,Rio do Sul - SC,69164,71836,2672,72189,95.81,99.51,3.7
sidra_9541_PercMoradDPPOColetTot_munic_22_pol.fid-703dc0a5_191866d88cb_-5c6,4214904,Rio Fortuna - SC,2868,3270,402,4700,61.02,69.57,8.55
sidra_9541_PercMoradDPPOColetTot_munic_22_pol.fid-703dc0a5_191866d88cb_-5c4,4215000,Rio Negrinho - SC,37684,38393,709,39200,96.13,97.94,1.81
sidra_9541_PercMoradDPPOColetTot_munic_22_pol.fid-703dc0a5_191866d88cb_-5c2,4215059,Rio Rufino - SC,2318,2329,11,2396,96.74,97.2,0.46
sidra_9541_PercMoradDPPOColetTot_munic_22_pol.fid-703dc0a5_191866d88cb_-5c1,4215075,Riqueza - SC,2912,3212,300,4766,61.1,67.39,6.29
sidra_9541_PercMoradDPPOColetTot_munic_22_pol.fid-703dc0a5_191866d88cb_-5bf,4215109,Rodeio - SC,12095,12439,344,12689,95.32,98.03,2.71
sidra_9541_PercMoradDPPOColetTot_munic_22_pol.fid-703dc0a5_191866d88cb_-5be,4215208,Romelândia - SC,1623,2559,936,4803,33.79,53.28,19.49
sidra_9541_PercMoradDPPOColetTot_munic_22_pol.fid-703dc0a5_191866d88cb_-5bd,4215307,Salete - SC,5834,6263,429,7481,77.98,83.72,5.73
sidra_9541_PercMoradDPPOColetTot_munic_22_pol.fid-703dc0a5_191866d88cb_-5bb,4215356,Saltinho - SC,1821,2249,428,3628,50.19,61.99,11.8
sidra_9541_PercMoradDPPOColetTot_munic_22_pol.fid-703dc0a5_191866d88cb_-5ba,4215406,Salto Veloso - SC,4074,4227,153,4390,92.8,96.29,3.49
sidra_9541_PercMoradDPPOColetTot_munic_22_pol.fid-703dc0a5_191866d88cb_-5b9,4215455,Sangão - SC,10756,12559,1803,12854,83.68,97.7,14.03
sidra_9541_PercMoradDPPOColetTot_munic_22_pol.fid-703dc0a5_191866d88cb_-5b8,4215505,Santa Cecília - SC,14159,14840,681,15535,91.14,95.53,4.38
sidra_9541_PercMoradDPPOColetTot_munic_22_pol.fid-703dc0a5_191866d88cb_-5b6,4215554,Santa Helena - SC,1592,1611,19,2423,65.7,66.49,0.78
sidra_9541_PercMoradDPPOColetTot_munic_22_pol.fid-703dc0a5_191866d88cb_-5b5,4215604,Santa Rosa de Lima - SC,1402,1926,524,2076,67.53,92.77,25.24
sidra_9541_PercMoradDPPOColetTot_munic_22_pol.fid-703dc0a5_191866d88cb_-5b4,4215653,Santa Rosa do Sul - SC,9195,9588,393,9773,94.09,98.11,4.02
sidra_9541_PercMoradDPPOColetTot_munic_22_pol.fid-703dc0a5_191866d88cb_-5b3,4215679,Santa Terezinha - SC,2969,4186,1217,8065,36.81,51.9,15.09
sidra_9541_PercMoradDPPOColetTot_munic_22_pol.fid-703dc0a5_191866d88cb_-5b2,4215687,Santa Terezinha do Progresso - SC,1635,1776,141,2576,63.47,68.94,5.47
sidra_9541_PercMoradDPPOColetTot_munic_22_pol.fid-703dc0a5_191866d88cb_-5b1,4215695,Santiago do Sul - SC,1351,1393,42,1642,82.28,84.84,2.56
sidra_9541_PercMoradDPPOColetTot_munic_22_pol.fid-703dc0a5_191866d88cb_-5b0,4215703,Santo Amaro da Imperatriz - SC,22887,26849,3962,27034,84.66,99.32,14.66
sidra_9541_PercMoradDPPOColetTot_munic_22_pol.fid-703dc0a5_191866d88cb_-5af,4215752,São Bernardino - SC,1109,1384,275,2683,41.33,51.58,10.25
sidra_9541_PercMoradDPPOColetTot_munic_22_pol.fid-703dc0a5_191866d88cb_-5ae,4215802,São Bento do Sul - SC,82156,82935,779,83257,98.68,99.61,0.94
sidra_9541_PercMoradDPPOColetTot_munic_22_pol.fid-703dc0a5_191866d88cb_-5ad,4215901,São Bonifácio - SC,2540,2634,94,2944,86.28,89.47,3.19
sidra_9541_PercMoradDPPOColetTot_munic_22_pol.fid-703dc0a5_191866d88cb_-5ac,4216008,São Carlos - SC,7234,8297,1063,10269,70.45,80.8,10.35
sidra_9541_PercMoradDPPOColetTot_munic_22_pol.fid-703dc0a5_191866d88cb_-5aa,4216057,São Cristóvão do Sul - SC,3846,3935,89,4289,89.67,91.75,2.08
sidra_9541_PercMoradDPPOColetTot_munic_22_pol.fid-703dc0a5_191866d88cb_-5a9,4216107,São Domingos - SC,6512,7346,834,9201,70.77,79.84,9.06
sidra_9541_PercMoradDPPOColetTot_munic_22_pol.fid-703dc0a5_191866d88cb_-5a8,4216206,São Francisco do Sul - SC,50946,52120,1174,52416,97.2,99.44,2.24
sidra_9541_PercMoradDPPOColetTot_munic_22_pol.fid-703dc0a5_191866d88cb_-5a7,4216255,São João do Oeste - SC,3319,4875,1556,6272,52.92,77.73,24.81
sidra_9541_PercMoradDPPOColetTot_munic_22_pol.fid-703dc0a5_191866d88cb_-5a6,4216305,São João Batista - SC,31955,32519,564,32640,97.9,99.63,1.73
sidra_9541_PercMoradDPPOColetTot_munic_22_pol.fid-703dc0a5_191866d88cb_-5a5,4128401,Uraí - PR,9372,9660,288,10384,90.25,93.03,2.77
sidra_9541_PercMoradDPPOColetTot_munic_22_pol.fid-703dc0a5_191866d88cb_-5a4,4216354,São João do Itaperiú - SC,4371,4394,23,4459,98.03,98.54,0.52
sidra_9541_PercMoradDPPOColetTot_munic_22_pol.fid-703dc0a5_191866d88cb_-5a2,4216404,São João do Sul - SC,8194,8343,149,8641,94.83,96.55,1.72
sidra_9541_PercMoradDPPOColetTot_munic_22_pol.fid-703dc0a5_191866d88cb_-5a1,4216503,São Joaquim - SC,18652,24976,6324,25879,72.07,96.51,24.44
sidra_9541_PercMoradDPPOColetTot_munic_22_pol.fid-703dc0a5_191866d88cb_-5a0,4216602,São José - SC,264634,269084,4450,269468,98.21,99.86,1.65
sidra_9541_PercMoradDPPOColetTot_munic_22_pol.fid-703dc0a5_191866d88cb_-59f,4216701,São José do Cedro - SC,9687,10590,903,14024,69.07,75.51,6.44
sidra_9541_PercMoradDPPOColetTot_munic_22_pol.fid-703dc0a5_191866d88cb_-59c,4216800,São José do Cerrito - SC,3772,5204,1432,8707,43.32,59.77,16.45
sidra_9541_PercMoradDPPOColetTot_munic_22_pol.fid-703dc0a5_191866d88cb_-59a,4216909,São Lourenço do Oeste - SC,19844,20690,846,24662,80.46,83.89,3.43
sidra_9541_PercMoradDPPOColetTot_munic_22_pol.fid-703dc0a5_191866d88cb_-599,4217006,São Ludgero - SC,12783,13285,502,13505,94.65,98.37,3.72
sidra_9541_PercMoradDPPOColetTot_munic_22_pol.fid-703dc0a5_191866d88cb_-598,4217105,São Martinho - SC,3001,3235,234,3403,88.19,95.06,6.88
sidra_9541_PercMoradDPPOColetTot_munic_22_pol.fid-703dc0a5_191866d88cb_-597,4217154,São Miguel da Boa Vista - SC,706,1052,346,1781,39.64,59.07,19.43
sidra_9541_PercMoradDPPOColetTot_munic_22_pol.fid-703dc0a5_191866d88cb_-596,4217204,São Miguel do Oeste - SC,38827,42588,3761,44112,88.02,96.55,8.53
sidra_9541_PercMoradDPPOColetTot_munic_22_pol.fid-703dc0a5_191866d88cb_-594,4128500,Wenceslau Braz - PR,16546,17451,905,19043,86.89,91.64,4.75
sidra_9541_PercMoradDPPOColetTot_munic_22_pol.fid-703dc0a5_191866d88cb_-593,4128559,Vera Cruz do Oeste - PR,6632,6932,300,8213,80.75,84.4,3.65
sidra_9541_PercMoradDPPOColetTot_munic_22_pol.fid-703dc0a5_191866d88cb_-592,4128609,Verê - PR,5495,5546,51,7922,69.36,70.01,0.64
sidra_9541_PercMoradDPPOColetTot_munic_22_pol.fid-703dc0a5_191866d88cb_-591,4128625,Alto Paraíso - PR,2373,2538,165,3001,79.07,84.57,5.5
sidra_9541_PercMoradDPPOColetTot_munic_22_pol.fid-703dc0a5_191866d88cb_-590,4128633,Doutor Ulysses - PR,1448,1876,428,5696,25.42,32.94,7.51
sidra_9541_PercMoradDPPOColetTot_munic_22_pol.fid-703dc0a5_191866d88cb_-58f,4128658,Virmond - PR,2733,3008,275,3809,71.75,78.97,7.22
sidra_9541_PercMoradDPPOColetTot_munic_22_pol.fid-703dc0a5_191866d88cb_-58e,4128708,Vitorino - PR,8037,8664,627,9702,82.84,89.3,6.46
sidra_9541_PercMoradDPPOColetTot_munic_22_pol.fid-703dc0a5_191866d88cb_-58d,4128807,Xambrê - PR,4678,4834,156,5787,80.84,83.53,2.7
sidra_9541_PercMoradDPPOColetTot_munic_22_pol.fid-703dc0a5_191866d88cb_-58c,4200051,Abdon Batista - SC,1697,2080,383,2593,65.45,80.22,14.77
sidra_9541_PercMoradDPPOColetTot_munic_22_pol.fid-703dc0a5_191866d88cb_-58b,4200101,Abelardo Luz - SC,11424,11951,527,17284,66.1,69.14,3.05
sidra_9541_PercMoradDPPOColetTot_munic_22_pol.fid-703dc0a5_191866d88cb_-589,4200200,Agrolândia - SC,9073,10925,1852,10987,82.58,99.44,16.86
sidra_9541_PercMoradDPPOColetTot_munic_22_pol.fid-703dc0a5_191866d88cb_-588,4200309,Agronômica - SC,4649,5127,478,6035,77.03,84.95,7.92
sidra_9541_PercMoradDPPOColetTot_munic_22_pol.fid-703dc0a5_191866d88cb_-587,4200408,Água Doce - SC,3819,5220,1401,6491,58.84,80.42,21.58
sidra_9541_PercMoradDPPOColetTot_munic_22_pol.fid-703dc0a5_191866d88cb_-586,4200507,Águas de Chapecó - SC,3538,3653,115,6034,58.63,60.54,1.91
sidra_9541_PercMoradDPPOColetTot_munic_22_pol.fid-703dc0a5_191866d88cb_-585,4200556,Águas Frias - SC,1451,1897,446,2839,51.11,66.82,15.71
sidra_9541_PercMoradDPPOColetTot_munic_22_pol.fid-703dc0a5_191866d88cb_-584,4200606,Águas Mornas - SC,4071,6595,2524,6743,60.37,97.81,37.43
sidra_9541_PercMoradDPPOColetTot_munic_22_pol.fid-703dc0a5_191866d88cb_-582,4200705,Alfredo Wagner - SC,2897,8184,5287,10465,27.68,78.2,50.52
sidra_9541_PercMoradDPPOColetTot_munic_22_pol.fid-703dc0a5_191866d88cb_-580,4200754,Alto Bela Vista - SC,1427,1737,310,1856,76.89,93.59,16.7
sidra_9541_PercMoradDPPOColetTot_munic_22_pol.fid-703dc0a5_191866d88cb_-57e,4200804,Anchieta - SC,3849,4716,867,5934,64.86,79.47,14.61
sidra_9541_PercMoradDPPOColetTot_munic_22_pol.fid-703dc0a5_191866d88cb_-57d,4200903,Angelina - SC,3476,4940,1464,5330,65.22,92.68,27.47
sidra_9541_PercMoradDPPOColetTot_munic_22_pol.fid-703dc0a5_191866d88cb_-57c,4201000,Anita Garibaldi - SC,6470,6750,280,8281,78.13,81.51,3.38
sidra_9541_PercMoradDPPOColetTot_munic_22_pol.fid-703dc0a5_191866d88cb_-57b,4201109,Anitápolis - SC,2736,3250,514,3578,76.47,90.83,14.37
sidra_9541_PercMoradDPPOColetTot_munic_22_pol.fid-703dc0a5_191866d88cb_-57a,4201208,Antônio Carlos - SC,8829,11013,2184,11199,78.84,98.34,19.5
sidra_9541_PercMoradDPPOColetTot_munic_22_pol.fid-703dc0a5_191866d88cb_-579,4300851,Arambaré - RS,3747,3920,173,4107,91.23,95.45,4.21
sidra_9541_PercMoradDPPOColetTot_munic_22_pol.fid-703dc0a5_191866d88cb_-578,4300877,Araricá - RS,8014,8452,438,8524,94.02,99.16,5.14
sidra_9541_PercMoradDPPOColetTot_munic_22_pol.fid-703dc0a5_191866d88cb_-577,4300901,Aratiba - RS,5825,5902,77,6477,89.93,91.12,1.19
sidra_9541_PercMoradDPPOColetTot_munic_22_pol.fid-703dc0a5_191866d88cb_-576,4309407,Guaporé - RS,24216,24716,500,25123,96.39,98.38,1.99
sidra_9541_PercMoradDPPOColetTot_munic_22_pol.fid-703dc0a5_191866d88cb_-575,4301008,Arroio do Meio - RS,20908,21770,862,21836,95.75,99.7,3.95
sidra_9541_PercMoradDPPOColetTot_munic_22_pol.fid-703dc0a5_191866d88cb_-574,4301057,Arroio do Sal - RS,2677,11002,8325,11031,24.27,99.74,75.47
sidra_9541_PercMoradDPPOColetTot_munic_22_pol.fid-703dc0a5_191866d88cb_-573,4301073,Arroio do Padre - RS,1794,2457,663,2593,69.19,94.76,25.57
sidra_9541_PercMoradDPPOColetTot_munic_22_pol.fid-703dc0a5_191866d88cb_-572,4301636,Balneário Pinhal - RS,14493,14832,339,14887,97.35,99.63,2.28
sidra_9541_PercMoradDPPOColetTot_munic_22_pol.fid-703dc0a5_191866d88cb_-571,4301651,Barão - RS,6006,6370,364,6458,93,98.64,5.64
sidra_9541_PercMoradDPPOColetTot_munic_22_pol.fid-703dc0a5_191866d88cb_-570,4309506,Guarani das Missões - RS,5736,5738,2,7308,78.49,78.52,0.03
sidra_9541_PercMoradDPPOColetTot_munic_22_pol.fid-703dc0a5_191866d88cb_-56f,4309555,Harmonia - RS,4860,5350,490,5378,90.37,99.48,9.11
sidra_9541_PercMoradDPPOColetTot_munic_22_pol.fid-703dc0a5_191866d88cb_-56e,4301701,Barão de Cotegipe - RS,6238,6311,73,7054,88.43,89.47,1.03
sidra_9541_PercMoradDPPOColetTot_munic_22_pol.fid-703dc0a5_191866d88cb_-56d,4301750,Barão do Triunfo - RS,1695,2500,805,5878,28.84,42.53,13.7
sidra_9541_PercMoradDPPOColetTot_munic_22_pol.fid-703dc0a5_191866d88cb_-56c,4301800,Barracão - RS,3336,3499,163,4831,69.05,72.43,3.37
sidra_9541_PercMoradDPPOColetTot_munic_22_pol.fid-703dc0a5_191866d88cb_-56b,5005202,Ladário - MS,20657,20816,159,21485,96.15,96.89,0.74
sidra_9541_PercMoradDPPOColetTot_munic_22_pol.fid-703dc0a5_191866d88cb_-56a,4301859,Barra do Guarita - RS,2558,2589,31,3155,81.08,82.06,0.98
sidra_9541_PercMoradDPPOColetTot_munic_22_pol.fid-703dc0a5_191866d88cb_-569,4301875,Barra do Quaraí - RS,3648,3805,157,4231,86.22,89.93,3.71
sidra_9541_PercMoradDPPOColetTot_munic_22_pol.fid-703dc0a5_191866d88cb_-568,4301909,Barra do Ribeiro - RS,11556,11736,180,12189,94.81,96.28,1.48
sidra_9541_PercMoradDPPOColetTot_munic_22_pol.fid-703dc0a5_191866d88cb_-567,4301925,Barra do Rio Azul - RS,1255,1291,36,1696,74,76.12,2.12
sidra_9541_PercMoradDPPOColetTot_munic_22_pol.fid-703dc0a5_191866d88cb_-566,4301958,Barra Funda - RS,2242,2326,84,2489,90.08,93.45,3.37
sidra_9541_PercMoradDPPOColetTot_munic_22_pol.fid-703dc0a5_191866d88cb_-565,4302006,Barros Cassal - RS,6257,6483,226,9254,67.61,70.06,2.44
sidra_9541_PercMoradDPPOColetTot_munic_22_pol.fid-703dc0a5_191866d88cb_-564,4302055,Benjamin Constant do Sul - RS,1387,1421,34,2082,66.62,68.25,1.63
sidra_9541_PercMoradDPPOColetTot_munic_22_pol.fid-703dc0a5_191866d88cb_-563,4302105,Bento Gonçalves - RS,109140,121697,12557,122530,89.07,99.32,10.25
sidra_9541_PercMoradDPPOColetTot_munic_22_pol.fid-703dc0a5_191866d88cb_-562,4302154,Boa Vista das Missões - RS,1367,1448,81,1932,70.76,74.95,4.19
sidra_9541_PercMoradDPPOColetTot_munic_22_pol.fid-703dc0a5_191866d88cb_-561,4302204,Boa Vista do Buricá - RS,2989,6276,3287,6913,43.24,90.79,47.55
sidra_9541_PercMoradDPPOColetTot_munic_22_pol.fid-703dc0a5_191866d88cb_-560,4302220,Boa Vista do Cadeado - RS,649,1072,423,2229,29.12,48.09,18.98
sidra_9541_PercMoradDPPOColetTot_munic_22_pol.fid-703dc0a5_191866d88cb_-55f,4302238,Boa Vista do Incra - RS,962,1123,161,2270,42.38,49.47,7.09
sidra_9541_PercMoradDPPOColetTot_munic_22_pol.fid-703dc0a5_191866d88cb_-55e,5005251,Laguna Carapã - MS,4260,4323,63,6794,62.7,63.63,0.93
sidra_9541_PercMoradDPPOColetTot_munic_22_pol.fid-703dc0a5_191866d88cb_-55d,5005400,Maracaju - MS,40963,41419,456,44886,91.26,92.28,1.02
sidra_9541_PercMoradDPPOColetTot_munic_22_pol.fid-703dc0a5_191866d88cb_-55b,5005608,Miranda - MS,15445,17587,2142,25324,60.99,69.45,8.46
sidra_9541_PercMoradDPPOColetTot_munic_22_pol.fid-703dc0a5_191866d88cb_-55a,5005681,Mundo Novo - MS,17030,17129,99,18818,90.5,91.02,0.53
sidra_9541_PercMoradDPPOColetTot_munic_22_pol.fid-703dc0a5_191866d88cb_-559,5005707,Naviraí - MS,47820,48146,326,49847,95.93,96.59,0.65
sidra_9541_PercMoradDPPOColetTot_munic_22_pol.fid-703dc0a5_191866d88cb_-558,5005806,Nioaque - MS,7251,7304,53,13204,54.92,55.32,0.4
sidra_9541_PercMoradDPPOColetTot_munic_22_pol.fid-703dc0a5_191866d88cb_-557,5006002,Nova Alvorada do Sul - MS,18465,18602,137,21802,84.69,85.32,0.63
sidra_9541_PercMoradDPPOColetTot_munic_22_pol.fid-703dc0a5_191866d88cb_-554,5006200,Nova Andradina - MS,42471,42995,524,48308,87.92,89,1.08
sidra_9541_PercMoradDPPOColetTot_munic_22_pol.fid-703dc0a5_191866d88cb_-553,5006259,Novo Horizonte do Sul - MS,3257,3257,,4719,69.02,69.02,
sidra_9541_PercMoradDPPOColetTot_munic_22_pol.fid-703dc0a5_191866d88cb_-552,5006275,Paraíso das Águas - MS,3477,3646,169,5484,63.4,66.48,3.08
sidra_9541_PercMoradDPPOColetTot_munic_22_pol.fid-703dc0a5_191866d88cb_-550,5006309,Paranaíba - MS,36232,37837,1605,40526,89.4,93.36,3.96
sidra_9541_PercMoradDPPOColetTot_munic_22_pol.fid-703dc0a5_191866d88cb_-54f,4302378,Bom Progresso - RS,2005,2023,18,2096,95.66,96.52,0.86
sidra_9541_PercMoradDPPOColetTot_munic_22_pol.fid-703dc0a5_191866d88cb_-54e,5006358,Paranhos - MS,6217,6222,5,12728,48.85,48.88,0.04
sidra_9541_PercMoradDPPOColetTot_munic_22_pol.fid-703dc0a5_191866d88cb_-54d,5006408,Pedro Gomes - MS,5402,5425,23,6882,78.49,78.83,0.33
sidra_9541_PercMoradDPPOColetTot_munic_22_pol.fid-703dc0a5_191866d88cb_-54c,5006606,Ponta Porã - MS,77278,78075,797,91385,84.56,85.44,0.87
sidra_9541_PercMoradDPPOColetTot_munic_22_pol.fid-703dc0a5_191866d88cb_-54a,5006903,Porto Murtinho - MS,8545,8759,214,12780,66.86,68.54,1.67
sidra_9541_PercMoradDPPOColetTot_munic_22_pol.fid-703dc0a5_191866d88cb_-549,5007109,Ribas do Rio Pardo - MS,17919,18487,568,22983,77.97,80.44,2.47
sidra_9541_PercMoradDPPOColetTot_munic_22_pol.fid-703dc0a5_191866d88cb_-547,5007208,Rio Brilhante - MS,32776,32929,153,37176,88.16,88.58,0.41
sidra_9541_PercMoradDPPOColetTot_munic_22_pol.fid-703dc0a5_191866d88cb_-546,5007307,Rio Negro - MS,3678,3842,164,4823,76.26,79.66,3.4
sidra_9541_PercMoradDPPOColetTot_munic_22_pol.fid-703dc0a5_191866d88cb_-545,5007406,Rio Verde de Mato Grosso - MS,16932,17245,313,19706,85.92,87.51,1.59
sidra_9541_PercMoradDPPOColetTot_munic_22_pol.fid-703dc0a5_191866d88cb_-543,5007505,Rochedo - MS,3659,3766,107,5172,70.75,72.82,2.07
sidra_9541_PercMoradDPPOColetTot_munic_22_pol.fid-703dc0a5_191866d88cb_-542,5007554,Santa Rita do Pardo - MS,3876,3990,114,6989,55.46,57.09,1.63
sidra_9541_PercMoradDPPOColetTot_munic_22_pol.fid-703dc0a5_191866d88cb_-541,5007695,São Gabriel do Oeste - MS,27077,27765,688,29456,91.92,94.26,2.34
sidra_9541_PercMoradDPPOColetTot_munic_22_pol.fid-703dc0a5_191866d88cb_-540,5007703,Sete Quedas - MS,9018,9148,130,10953,82.33,83.52,1.19
sidra_9541_PercMoradDPPOColetTot_munic_22_pol.fid-703dc0a5_191866d88cb_-53f,5007802,Selvíria - MS,6177,6449,272,8050,76.73,80.11,3.38
sidra_9541_PercMoradDPPOColetTot_munic_22_pol.fid-703dc0a5_191866d88cb_-53e,5007901,Sidrolândia - MS,32371,32742,371,47024,68.84,69.63,0.79
sidra_9541_PercMoradDPPOColetTot_munic_22_pol.fid-703dc0a5_191866d88cb_-53c,5007935,Sonora - MS,13455,13496,41,14442,93.17,93.45,0.28
sidra_9541_PercMoradDPPOColetTot_munic_22_pol.fid-703dc0a5_191866d88cb_-53b,5007950,Tacuru - MS,3706,3929,223,10786,34.36,36.43,2.07
sidra_9541_PercMoradDPPOColetTot_munic_22_pol.fid-703dc0a5_191866d88cb_-53a,4302659,Brochier - RS,3253,4688,1435,4934,65.93,95.01,29.08
sidra_9541_PercMoradDPPOColetTot_munic_22_pol.fid-703dc0a5_191866d88cb_-539,5007976,Taquarussu - MS,2820,2822,2,3619,77.92,77.98,0.06
sidra_9541_PercMoradDPPOColetTot_munic_22_pol.fid-703dc0a5_191866d88cb_-538,5008008,Terenos - MS,10343,10803,460,17539,58.97,61.59,2.62
sidra_9541_PercMoradDPPOColetTot_munic_22_pol.fid-703dc0a5_191866d88cb_-536,5008305,Três Lagoas - MS,124502,128406,3904,131075,94.99,97.96,2.98
sidra_9541_PercMoradDPPOColetTot_munic_22_pol.fid-703dc0a5_191866d88cb_-534,4302709,Butiá - RS,13819,18864,5045,19060,72.5,98.97,26.47
sidra_9541_PercMoradDPPOColetTot_munic_22_pol.fid-703dc0a5_191866d88cb_-533,4302808,Caçapava do Sul - RS,26505,28753,2248,32359,81.91,88.86,6.95
sidra_9541_PercMoradDPPOColetTot_munic_22_pol.fid-703dc0a5_191866d88cb_-532,4302907,Cacequi - RS,5680,9270,3590,11078,51.27,83.68,32.41
sidra_9541_PercMoradDPPOColetTot_munic_22_pol.fid-703dc0a5_191866d88cb_-531,4303004,Cachoeira do Sul - RS,53448,77049,23601,79475,67.25,96.95,29.7
sidra_9541_PercMoradDPPOColetTot_munic_22_pol.fid-703dc0a5_191866d88cb_-530,5104559,Itaúba - MT,4115,4211,96,5003,82.25,84.17,1.92
sidra_9541_PercMoradDPPOColetTot_munic_22_pol.fid-703dc0a5_191866d88cb_-52f,5104609,Itiquira - MT,9963,10531,568,12194,81.7,86.36,4.66
sidra_9541_PercMoradDPPOColetTot_munic_22_pol.fid-703dc0a5_191866d88cb_-52e,5104807,Jaciara - MT,26214,26633,419,28422,92.23,93.71,1.47
sidra_9541_PercMoradDPPOColetTot_munic_22_pol.fid-703dc0a5_191866d88cb_-52c,5104906,Jangada - MT,4181,4210,29,7420,56.35,56.74,0.39
sidra_9541_PercMoradDPPOColetTot_munic_22_pol.fid-703dc0a5_191866d88cb_-52b,5105002,Jauru - MT,5674,5829,155,8328,68.13,69.99,1.86
sidra_9541_PercMoradDPPOColetTot_munic_22_pol.fid-703dc0a5_191866d88cb_-52a,5105101,Juara - MT,27378,27723,345,34685,78.93,79.93,0.99
sidra_9541_PercMoradDPPOColetTot_munic_22_pol.fid-703dc0a5_191866d88cb_-529,5105150,Juína - MT,37522,37872,350,45594,82.3,83.06,0.77
sidra_9541_PercMoradDPPOColetTot_munic_22_pol.fid-703dc0a5_191866d88cb_-528,5105176,Juruena - MT,7652,7780,128,10209,74.95,76.21,1.25
sidra_9541_PercMoradDPPOColetTot_munic_22_pol.fid-703dc0a5_191866d88cb_-527,5105200,Juscimeira - MT,8700,8932,232,11408,76.26,78.3,2.03
sidra_9541_PercMoradDPPOColetTot_munic_22_pol.fid-703dc0a5_191866d88cb_-525,5105234,Lambari D'Oeste - MT,3582,3591,9,4780,74.94,75.13,0.19
sidra_9541_PercMoradDPPOColetTot_munic_22_pol.fid-703dc0a5_191866d88cb_-523,5105259,Lucas do Rio Verde - MT,10972,81724,70752,83576,13.13,97.78,84.66
sidra_9541_PercMoradDPPOColetTot_munic_22_pol.fid-703dc0a5_191866d88cb_-521,5105309,Luciara - MT,1644,1880,236,2503,65.68,75.11,9.43
sidra_9541_PercMoradDPPOColetTot_munic_22_pol.fid-703dc0a5_191866d88cb_-520,5105507,Vila Bela da Santíssima Trindade - MT,7624,7761,137,16665,45.75,46.57,0.82
sidra_9541_PercMoradDPPOColetTot_munic_22_pol.fid-703dc0a5_191866d88cb_-51f,5105580,Marcelândia - MT,8494,8953,459,11365,74.74,78.78,4.04
sidra_9541_PercMoradDPPOColetTot_munic_22_pol.fid-703dc0a5_191866d88cb_-51e,5105606,Matupá - MT,15404,15922,518,20030,76.9,79.49,2.59
sidra_9541_PercMoradDPPOColetTot_munic_22_pol.fid-703dc0a5_191866d88cb_-51d,5105622,Mirassol d'Oeste - MT,22886,22978,92,26528,86.27,86.62,0.35
sidra_9541_PercMoradDPPOColetTot_munic_22_pol.fid-703dc0a5_191866d88cb_-51c,5105903,Nobres - MT,13562,13629,67,15439,87.84,88.28,0.43
sidra_9541_PercMoradDPPOColetTot_munic_22_pol.fid-703dc0a5_191866d88cb_-51b,5106000,Nortelândia - MT,4406,5091,685,5838,75.47,87.2,11.73
sidra_9541_PercMoradDPPOColetTot_munic_22_pol.fid-703dc0a5_191866d88cb_-519,5106109,Nossa Senhora do Livramento - MT,6342,6470,128,12902,49.16,50.15,0.99
sidra_9541_PercMoradDPPOColetTot_munic_22_pol.fid-703dc0a5_191866d88cb_-518,5106158,Nova Bandeirantes - MT,6958,7054,96,13579,51.24,51.95,0.71
sidra_9541_PercMoradDPPOColetTot_munic_22_pol.fid-703dc0a5_191866d88cb_-516,5106174,Nova Nazaré - MT,1860,2015,155,4165,44.66,48.38,3.72
sidra_9541_PercMoradDPPOColetTot_munic_22_pol.fid-703dc0a5_191866d88cb_-515,5106182,Nova Lacerda - MT,3452,3500,48,6622,52.13,52.85,0.72
sidra_9541_PercMoradDPPOColetTot_munic_22_pol.fid-703dc0a5_191866d88cb_-514,4303103,Cachoeirinha - RS,74189,135520,61331,135865,54.6,99.75,45.14
sidra_9541_PercMoradDPPOColetTot_munic_22_pol.fid-703dc0a5_191866d88cb_-513,4303202,Cacique Doble - RS,3646,3696,50,4601,79.24,80.33,1.09
sidra_9541_PercMoradDPPOColetTot_munic_22_pol.fid-703dc0a5_191866d88cb_-512,4303301,Caibaté - RS,3323,3604,281,4684,70.94,76.94,6
sidra_9541_PercMoradDPPOColetTot_munic_22_pol.fid-703dc0a5_191866d88cb_-511,4303400,Caiçara - RS,3323,3414,91,4823,68.9,70.79,1.89
sidra_9541_PercMoradDPPOColetTot_munic_22_pol.fid-703dc0a5_191866d88cb_-510,4303509,Camaquã - RS,54673,55991,1318,61684,88.63,90.77,2.14
sidra_9541_PercMoradDPPOColetTot_munic_22_pol.fid-703dc0a5_191866d88cb_-50e,5106190,Nova Santa Helena - MT,2938,2951,13,4234,69.39,69.7,0.31
sidra_9541_PercMoradDPPOColetTot_munic_22_pol.fid-703dc0a5_191866d88cb_-50d,5106208,Nova Brasilândia - MT,2905,2934,29,3889,74.7,75.44,0.75
sidra_9541_PercMoradDPPOColetTot_munic_22_pol.fid-703dc0a5_191866d88cb_-50c,5106216,Nova Canaã do Norte - MT,7757,7896,139,11680,66.41,67.6,1.19
sidra_9541_PercMoradDPPOColetTot_munic_22_pol.fid-703dc0a5_191866d88cb_-50b,5106224,Nova Mutum - MT,49163,50581,1418,55556,88.49,91.05,2.55
sidra_9541_PercMoradDPPOColetTot_munic_22_pol.fid-703dc0a5_191866d88cb_-50a,5106232,Nova Olímpia - MT,14719,14844,125,16332,90.12,90.89,0.77
sidra_9541_PercMoradDPPOColetTot_munic_22_pol.fid-703dc0a5_191866d88cb_-509,5106240,Nova Ubiratã - MT,8394,8518,124,11440,73.37,74.46,1.08
sidra_9541_PercMoradDPPOColetTot_munic_22_pol.fid-703dc0a5_191866d88cb_-508,5106257,Nova Xavantina - MT,20249,20835,586,24176,83.76,86.18,2.42
sidra_9541_PercMoradDPPOColetTot_munic_22_pol.fid-703dc0a5_191866d88cb_-507,5106265,Novo Mundo - MT,3252,3335,83,6488,50.12,51.4,1.28
sidra_9541_PercMoradDPPOColetTot_munic_22_pol.fid-703dc0a5_191866d88cb_-506,5106273,Novo Horizonte do Norte - MT,2020,2035,15,3344,60.41,60.86,0.45
sidra_9541_PercMoradDPPOColetTot_munic_22_pol.fid-703dc0a5_191866d88cb_-505,5106281,Novo São Joaquim - MT,4650,4880,230,6818,68.2,71.58,3.37
sidra_9541_PercMoradDPPOColetTot_munic_22_pol.fid-703dc0a5_191866d88cb_-504,5106299,Paranaíta - MT,7687,7757,70,11627,66.11,66.72,0.6
sidra_9541_PercMoradDPPOColetTot_munic_22_pol.fid-703dc0a5_191866d88cb_-502,5106307,Paranatinga - MT,20146,20807,661,26306,76.58,79.1,2.51
sidra_9541_PercMoradDPPOColetTot_munic_22_pol.fid-703dc0a5_191866d88cb_-501,5106315,Novo Santo Antônio - MT,1521,1575,54,2015,75.48,78.16,2.68
sidra_9541_PercMoradDPPOColetTot_munic_22_pol.fid-703dc0a5_191866d88cb_-500,5106372,Pedra Preta - MT,15252,15462,210,17947,84.98,86.15,1.17
sidra_9541_PercMoradDPPOColetTot_munic_22_pol.fid-703dc0a5_191866d88cb_-4fe,5106422,Peixoto de Azevedo - MT,26819,26883,64,32533,82.44,82.63,0.2
sidra_9541_PercMoradDPPOColetTot_munic_22_pol.fid-703dc0a5_191866d88cb_-4fd,5106455,Planalto da Serra - MT,2614,2616,2,3164,82.62,82.68,0.06
sidra_9541_PercMoradDPPOColetTot_munic_22_pol.fid-703dc0a5_191866d88cb_-4fc,5106505,Poconé - MT,24047,24214,167,31184,77.11,77.65,0.54
sidra_9541_PercMoradDPPOColetTot_munic_22_pol.fid-703dc0a5_191866d88cb_-4fb,5106653,Pontal do Araguaia - MT,6020,6261,241,6932,86.84,90.32,3.48
sidra_9541_PercMoradDPPOColetTot_munic_22_pol.fid-703dc0a5_191866d88cb_-4fa,5106703,Ponte Branca - MT,1728,1729,1,2004,86.23,86.28,0.05
sidra_9541_PercMoradDPPOColetTot_munic_22_pol.fid-703dc0a5_191866d88cb_-4f9,5106752,Pontes e Lacerda - MT,44817,45243,426,51712,86.67,87.49,0.82
sidra_9541_PercMoradDPPOColetTot_munic_22_pol.fid-703dc0a5_191866d88cb_-4f7,5106778,Porto Alegre do Norte - MT,9166,9295,129,12011,76.31,77.39,1.07
sidra_9541_PercMoradDPPOColetTot_munic_22_pol.fid-703dc0a5_191866d88cb_-4f6,5106802,Porto dos Gaúchos - MT,4476,4752,276,5541,80.78,85.76,4.98
sidra_9541_PercMoradDPPOColetTot_munic_22_pol.fid-703dc0a5_191866d88cb_-4f5,5106828,Porto Esperidião - MT,5821,6103,282,10136,57.43,60.21,2.78
sidra_9541_PercMoradDPPOColetTot_munic_22_pol.fid-703dc0a5_191866d88cb_-4f4,5106851,Porto Estrela - MT,1745,1808,63,3224,54.13,56.08,1.95
sidra_9541_PercMoradDPPOColetTot_munic_22_pol.fid-703dc0a5_191866d88cb_-4f3,4303806,Campinas do Sul - RS,5024,5047,23,5250,95.7,96.13,0.44
sidra_9541_PercMoradDPPOColetTot_munic_22_pol.fid-703dc0a5_191866d88cb_-4f2,5107008,Poxoréu - MT,15415,17024,1609,23134,66.63,73.59,6.96
sidra_9541_PercMoradDPPOColetTot_munic_22_pol.fid-703dc0a5_191866d88cb_-4f1,5107040,Primavera do Leste - MT,81782,82512,730,84690,96.57,97.43,0.86
sidra_9541_PercMoradDPPOColetTot_munic_22_pol.fid-703dc0a5_191866d88cb_-4f0,5107065,Querência - MT,22531,22638,107,26310,85.64,86.04,0.41
sidra_9541_PercMoradDPPOColetTot_munic_22_pol.fid-703dc0a5_191866d88cb_-4ef,5107107,São José dos Quatro Marcos - MT,14299,14552,253,17815,80.26,81.68,1.42
sidra_9541_PercMoradDPPOColetTot_munic_22_pol.fid-703dc0a5_191866d88cb_-4ee,5107156,Reserva do Cabaçal - MT,1607,1655,48,2118,75.87,78.14,2.27
sidra_9541_PercMoradDPPOColetTot_munic_22_pol.fid-703dc0a5_191866d88cb_-4ed,5107180,Ribeirão Cascalheira - MT,6598,6702,104,10015,65.88,66.92,1.04
sidra_9541_PercMoradDPPOColetTot_munic_22_pol.fid-703dc0a5_191866d88cb_-4ec,5107198,Ribeirãozinho - MT,2240,2249,9,2582,86.75,87.1,0.35
sidra_9541_PercMoradDPPOColetTot_munic_22_pol.fid-703dc0a5_191866d88cb_-4eb,5107206,Rio Branco - MT,4015,4065,50,4523,88.77,89.87,1.11
sidra_9541_PercMoradDPPOColetTot_munic_22_pol.fid-703dc0a5_191866d88cb_-4ea,5107248,Santa Carmem - MT,4419,4563,144,5361,82.43,85.11,2.69
sidra_9541_PercMoradDPPOColetTot_munic_22_pol.fid-703dc0a5_191866d88cb_-4e9,5107263,Santo Afonso - MT,1734,1856,122,2518,68.86,73.71,4.85
sidra_9541_PercMoradDPPOColetTot_munic_22_pol.fid-703dc0a5_191866d88cb_-4e8,5107297,São José do Povo - MT,1568,1658,90,2875,54.54,57.67,3.13
sidra_9541_PercMoradDPPOColetTot_munic_22_pol.fid-703dc0a5_191866d88cb_-4e6,5107305,São José do Rio Claro - MT,12443,12546,103,14768,84.26,84.95,0.7
sidra_9541_PercMoradDPPOColetTot_munic_22_pol.fid-703dc0a5_191866d88cb_-4e5,5107354,São José do Xingu - MT,4374,4759,385,5930,73.76,80.25,6.49
sidra_9541_PercMoradDPPOColetTot_munic_22_pol.fid-703dc0a5_191866d88cb_-4e4,5107404,São Pedro da Cipa - MT,3679,3791,112,4181,87.99,90.67,2.68
sidra_9541_PercMoradDPPOColetTot_munic_22_pol.fid-703dc0a5_191866d88cb_-4e3,5107578,Rondolândia - MT,1052,1205,153,3477,30.26,34.66,4.4
sidra_9541_PercMoradDPPOColetTot_munic_22_pol.fid-703dc0a5_191866d88cb_-4e2,5107602,Rondonópolis - MT,234792,236683,1891,242747,96.72,97.5,0.78
sidra_9541_PercMoradDPPOColetTot_munic_22_pol.fid-703dc0a5_191866d88cb_-4e1,5107701,Rosário Oeste - MT,9521,10049,528,15340,62.07,65.51,3.44
sidra_9541_PercMoradDPPOColetTot_munic_22_pol.fid-703dc0a5_191866d88cb_-4e0,5107743,Santa Cruz do Xingu - MT,1843,1872,29,2625,70.21,71.31,1.1
sidra_9541_PercMoradDPPOColetTot_munic_22_pol.fid-703dc0a5_191866d88cb_-4de,5107750,Salto do Céu - MT,2281,2375,94,3670,62.15,64.71,2.56
sidra_9541_PercMoradDPPOColetTot_munic_22_pol.fid-703dc0a5_191866d88cb_-4dd,5107768,Santa Rita do Trivelato - MT,2264,2344,80,3254,69.58,72.03,2.46
sidra_9541_PercMoradDPPOColetTot_munic_22_pol.fid-703dc0a5_191866d88cb_-4dc,5107776,Santa Terezinha - MT,3241,3271,30,7568,42.83,43.22,0.4
sidra_9541_PercMoradDPPOColetTot_munic_22_pol.fid-703dc0a5_191866d88cb_-4db,4303905,Campo Bom - RS,61722,62728,1006,62743,98.37,99.98,1.6
sidra_9541_PercMoradDPPOColetTot_munic_22_pol.fid-703dc0a5_191866d88cb_-4da,4304630,Capão da Canoa - RS,60782,62849,2067,63362,95.93,99.19,3.26
sidra_9541_PercMoradDPPOColetTot_munic_22_pol.fid-703dc0a5_191866d88cb_-4d9,4304655,Capão do Cipó - RS,1212,1291,79,3113,38.93,41.47,2.54
sidra_9541_PercMoradDPPOColetTot_munic_22_pol.fid-703dc0a5_191866d88cb_-4d8,4304663,Capão do Leão - RS,25539,26122,583,26367,96.86,99.07,2.21
sidra_9541_PercMoradDPPOColetTot_munic_22_pol.fid-703dc0a5_191866d88cb_-4d7,5107792,Santo Antônio do Leste - MT,2689,2966,277,4093,65.7,72.47,6.77
sidra_9541_PercMoradDPPOColetTot_munic_22_pol.fid-703dc0a5_191866d88cb_-4d6,5107800,Santo Antônio de Leverger - MT,10353,10723,370,15181,68.2,70.63,2.44
sidra_9541_PercMoradDPPOColetTot_munic_22_pol.fid-703dc0a5_191866d88cb_-4d5,5107859,São Félix do Araguaia - MT,8649,9121,472,13106,65.99,69.59,3.6
sidra_9541_PercMoradDPPOColetTot_munic_22_pol.fid-703dc0a5_191866d88cb_-4d3,4304002,Campo Novo - RS,4620,4745,125,4968,93,95.51,2.52
sidra_9541_PercMoradDPPOColetTot_munic_22_pol.fid-703dc0a5_191866d88cb_-4d2,4304101,Campos Borges - RS,1643,3016,1373,3613,45.47,83.48,38
sidra_9541_PercMoradDPPOColetTot_munic_22_pol.fid-703dc0a5_191866d88cb_-4d0,4304200,Candelária - RS,23200,24472,1272,28687,80.87,85.31,4.43
sidra_9541_PercMoradDPPOColetTot_munic_22_pol.fid-703dc0a5_191866d88cb_-4cf,4304606,Canoas - RS,321222,344184,22962,344802,93.16,99.82,6.66
sidra_9541_PercMoradDPPOColetTot_munic_22_pol.fid-703dc0a5_191866d88cb_-4ce,4304614,Canudos do Vale - RS,1024,1507,483,1656,61.84,91,29.17
sidra_9541_PercMoradDPPOColetTot_munic_22_pol.fid-703dc0a5_191866d88cb_-4cc,4304622,Capão Bonito do Sul - RS,1074,1411,337,1733,61.97,81.42,19.45
sidra_9541_PercMoradDPPOColetTot_munic_22_pol.fid-703dc0a5_191866d88cb_-4cb,4305173,Cerro Grande do Sul - RS,2572,7528,4956,9125,28.19,82.5,54.31
sidra_9541_PercMoradDPPOColetTot_munic_22_pol.fid-703dc0a5_191866d88cb_-4ca,4305207,Cerro Largo - RS,11302,13327,2025,13528,83.55,98.51,14.97
sidra_9541_PercMoradDPPOColetTot_munic_22_pol.fid-703dc0a5_191866d88cb_-4c9,4305306,Chapada - RS,7079,7633,554,9517,74.38,80.2,5.82
sidra_9541_PercMoradDPPOColetTot_munic_22_pol.fid-703dc0a5_191866d88cb_-4c8,4305355,Charqueadas - RS,30844,30926,82,31161,98.98,99.25,0.26
sidra_9541_PercMoradDPPOColetTot_munic_22_pol.fid-703dc0a5_191866d88cb_-4c7,4305371,Charrua - RS,435,1362,927,2768,15.72,49.21,33.49
sidra_9541_PercMoradDPPOColetTot_munic_22_pol.fid-703dc0a5_191866d88cb_-4c6,4305405,Chiapetta - RS,3215,3276,61,3912,82.18,83.74,1.56
sidra_9541_PercMoradDPPOColetTot_munic_22_pol.fid-703dc0a5_191866d88cb_-4c5,5107875,Sapezal - MT,25610,26400,790,27747,92.3,95.15,2.85
sidra_9541_PercMoradDPPOColetTot_munic_22_pol.fid-703dc0a5_191866d88cb_-4c4,5107883,Serra Nova Dourada - MT,850,979,129,1799,47.25,54.42,7.17
sidra_9541_PercMoradDPPOColetTot_munic_22_pol.fid-703dc0a5_191866d88cb_-4c3,5107909,Sinop - MT,181126,188653,7527,195459,92.67,96.52,3.85
sidra_9541_PercMoradDPPOColetTot_munic_22_pol.fid-703dc0a5_191866d88cb_-4c2,5107925,Sorriso - MT,105047,105566,519,110143,95.37,95.84,0.47
sidra_9541_PercMoradDPPOColetTot_munic_22_pol.fid-703dc0a5_191866d88cb_-4c1,5107941,Tabaporã - MT,7547,7597,50,9667,78.07,78.59,0.52
sidra_9541_PercMoradDPPOColetTot_munic_22_pol.fid-703dc0a5_191866d88cb_-4c0,5107958,Tangará da Serra - MT,97840,98954,1114,105870,92.42,93.47,1.05
sidra_9541_PercMoradDPPOColetTot_munic_22_pol.fid-703dc0a5_191866d88cb_-4bf,5108006,Tapurah - MT,11732,11939,207,14048,83.51,84.99,1.47
sidra_9541_PercMoradDPPOColetTot_munic_22_pol.fid-703dc0a5_191866d88cb_-4be,5108055,Terra Nova do Norte - MT,5804,5870,66,10604,54.73,55.36,0.62
sidra_9541_PercMoradDPPOColetTot_munic_22_pol.fid-703dc0a5_191866d88cb_-4bd,5108105,Tesouro - MT,2307,2389,82,3021,76.37,79.08,2.71
sidra_9541_PercMoradDPPOColetTot_munic_22_pol.fid-703dc0a5_191866d88cb_-4bb,5108204,Torixoréu - MT,3089,3149,60,4145,74.52,75.97,1.45
sidra_9541_PercMoradDPPOColetTot_munic_22_pol.fid-703dc0a5_191866d88cb_-4ba,5108303,União do Sul - MT,2987,3028,41,3820,78.19,79.27,1.07
sidra_9541_PercMoradDPPOColetTot_munic_22_pol.fid-703dc0a5_191866d88cb_-4b9,5108352,Vale de São Domingos - MT,1715,1740,25,2904,59.06,59.92,0.86
sidra_9541_PercMoradDPPOColetTot_munic_22_pol.fid-703dc0a5_191866d88cb_-4b8,5108402,Várzea Grande - MT,285835,292547,6712,298978,95.6,97.85,2.24
sidra_9541_PercMoradDPPOColetTot_munic_22_pol.fid-703dc0a5_191866d88cb_-4b7,5108501,Vera - MT,10574,10661,87,12751,82.93,83.61,0.68
sidra_9541_PercMoradDPPOColetTot_munic_22_pol.fid-703dc0a5_191866d88cb_-4b6,5108600,Vila Rica - MT,14535,15121,586,19704,73.77,76.74,2.97
sidra_9541_PercMoradDPPOColetTot_munic_22_pol.fid-703dc0a5_191866d88cb_-4b5,5108808,Nova Guarita - MT,2909,2929,20,4536,64.13,64.57,0.44
sidra_9541_PercMoradDPPOColetTot_munic_22_pol.fid-703dc0a5_191866d88cb_-4b4,5108857,Nova Marilândia - MT,2806,2818,12,3521,79.69,80.03,0.34
sidra_9541_PercMoradDPPOColetTot_munic_22_pol.fid-703dc0a5_191866d88cb_-4b3,5108907,Nova Maringá - MT,4367,4395,28,5704,76.56,77.05,0.49
sidra_9541_PercMoradDPPOColetTot_munic_22_pol.fid-703dc0a5_191866d88cb_-4b2,5108956,Nova Monte Verde - MT,5648,5652,4,8290,68.13,68.18,0.05
sidra_9541_PercMoradDPPOColetTot_munic_22_pol.fid-703dc0a5_191866d88cb_-4b1,5200050,Abadia de Goiás - GO,17425,18395,970,18715,93.11,98.29,5.18
sidra_9541_PercMoradDPPOColetTot_munic_22_pol.fid-703dc0a5_191866d88cb_-4b0,5200100,Abadiânia - GO,10846,14456,3610,16924,64.09,85.42,21.33
sidra_9541_PercMoradDPPOColetTot_munic_22_pol.fid-703dc0a5_191866d88cb_-4ae,5200134,Acreúna - GO,20060,20138,78,21318,94.1,94.46,0.37
sidra_9541_PercMoradDPPOColetTot_munic_22_pol.fid-703dc0a5_191866d88cb_-4ad,5200159,Adelândia - GO,1925,2038,113,2278,84.5,89.46,4.96
sidra_9541_PercMoradDPPOColetTot_munic_22_pol.fid-703dc0a5_191866d88cb_-4ac,5200175,Água Fria de Goiás - GO,3174,3270,96,4911,64.63,66.59,1.95
sidra_9541_PercMoradDPPOColetTot_munic_22_pol.fid-703dc0a5_191866d88cb_-4ab,5200209,Água Limpa - GO,1459,1552,93,1842,79.21,84.26,5.05
sidra_9541_PercMoradDPPOColetTot_munic_22_pol.fid-703dc0a5_191866d88cb_-4a9,5200258,Águas Lindas de Goiás - GO,216916,220499,3583,225263,96.29,97.89,1.59
sidra_9541_PercMoradDPPOColetTot_munic_22_pol.fid-703dc0a5_191866d88cb_-4a8,5200308,Alexânia - GO,21729,24669,2940,26893,80.8,91.73,10.93
sidra_9541_PercMoradDPPOColetTot_munic_22_pol.fid-703dc0a5_191866d88cb_-4a6,5200506,Aloândia - GO,1734,1777,43,1968,88.11,90.29,2.18
sidra_9541_PercMoradDPPOColetTot_munic_22_pol.fid-703dc0a5_191866d88cb_-4a5,5200555,Alto Horizonte - GO,5287,5520,233,6052,87.36,91.21,3.85
sidra_9541_PercMoradDPPOColetTot_munic_22_pol.fid-703dc0a5_191866d88cb_-4a4,5200605,Alto Paraíso de Goiás - GO,7350,8557,1207,10013,73.4,85.46,12.05
sidra_9541_PercMoradDPPOColetTot_munic_22_pol.fid-703dc0a5_191866d88cb_-4a3,5200803,Alvorada do Norte - GO,6998,7381,383,8444,82.88,87.41,4.54
sidra_9541_PercMoradDPPOColetTot_munic_22_pol.fid-703dc0a5_191866d88cb_-4a2,4304671,Capivari do Sul - RS,3780,3950,170,3991,94.71,98.97,4.26
sidra_9541_PercMoradDPPOColetTot_munic_22_pol.fid-703dc0a5_191866d88cb_-4a1,4304689,Capela de Santana - RS,10958,11033,75,11133,98.43,99.1,0.67
sidra_9541_PercMoradDPPOColetTot_munic_22_pol.fid-703dc0a5_191866d88cb_-49f,4304697,Capitão - RS,2583,2637,54,2921,88.43,90.28,1.85
sidra_9541_PercMoradDPPOColetTot_munic_22_pol.fid-703dc0a5_191866d88cb_-49e,4304705,Carazinho - RS,29145,60710,31565,61362,47.5,98.94,51.44
sidra_9541_PercMoradDPPOColetTot_munic_22_pol.fid-703dc0a5_191866d88cb_-49d,4306452,Dois Lajeados - RS,2838,2886,48,3086,91.96,93.52,1.56
sidra_9541_PercMoradDPPOColetTot_munic_22_pol.fid-703dc0a5_191866d88cb_-49c,4306502,Dom Feliciano - RS,4452,8865,4413,13026,34.18,68.06,33.88
sidra_9541_PercMoradDPPOColetTot_munic_22_pol.fid-703dc0a5_191866d88cb_-49b,4304713,Caraá - RS,6454,6834,380,7393,87.3,92.44,5.14
sidra_9541_PercMoradDPPOColetTot_munic_22_pol.fid-703dc0a5_191866d88cb_-49a,4306551,Dom Pedro de Alcântara - RS,2538,2550,12,2555,99.33,99.8,0.47
sidra_9541_PercMoradDPPOColetTot_munic_22_pol.fid-703dc0a5_191866d88cb_-499,4306601,Dom Pedrito - RS,33555,34178,623,36551,91.8,93.51,1.7
sidra_9541_PercMoradDPPOColetTot_munic_22_pol.fid-703dc0a5_191866d88cb_-498,5200829,Amaralina - GO,1539,1571,32,3259,47.22,48.2,0.98
sidra_9541_PercMoradDPPOColetTot_munic_22_pol.fid-703dc0a5_191866d88cb_-497,5200852,Americano do Brasil - GO,4839,4919,80,5247,92.22,93.75,1.52
sidra_9541_PercMoradDPPOColetTot_munic_22_pol.fid-703dc0a5_191866d88cb_-496,5200902,Amorinópolis - GO,2338,2502,164,2998,77.99,83.46,5.47
sidra_9541_PercMoradDPPOColetTot_munic_22_pol.fid-703dc0a5_191866d88cb_-495,5201108,Anápolis - GO,379119,392828,13709,397062,95.48,98.93,3.45
sidra_9541_PercMoradDPPOColetTot_munic_22_pol.fid-703dc0a5_191866d88cb_-494,5201207,Anhanguera - GO,885,912,27,924,95.78,98.7,2.92
sidra_9541_PercMoradDPPOColetTot_munic_22_pol.fid-703dc0a5_191866d88cb_-493,4304804,Carlos Barbosa - RS,25376,29770,4394,30363,83.58,98.05,14.47
sidra_9541_PercMoradDPPOColetTot_munic_22_pol.fid-703dc0a5_191866d88cb_-492,4304853,Carlos Gomes - RS,473,489,16,1368,34.58,35.75,1.17
sidra_9541_PercMoradDPPOColetTot_munic_22_pol.fid-703dc0a5_191866d88cb_-491,5201306,Anicuns - GO,15565,16663,1098,18459,84.32,90.27,5.95
sidra_9541_PercMoradDPPOColetTot_munic_22_pol.fid-703dc0a5_191866d88cb_-490,5201405,Aparecida de Goiânia - GO,502140,520105,17965,522397,96.12,99.56,3.44
sidra_9541_PercMoradDPPOColetTot_munic_22_pol.fid-703dc0a5_191866d88cb_-48f,5201454,Aparecida do Rio Doce - GO,2336,2636,300,2872,81.34,91.78,10.45
sidra_9541_PercMoradDPPOColetTot_munic_22_pol.fid-703dc0a5_191866d88cb_-48e,5201504,Aporé - GO,3311,3452,141,4318,76.68,79.94,3.27
sidra_9541_PercMoradDPPOColetTot_munic_22_pol.fid-703dc0a5_191866d88cb_-48d,5201603,Araçu - GO,3368,3552,184,3759,89.6,94.49,4.89
sidra_9541_PercMoradDPPOColetTot_munic_22_pol.fid-703dc0a5_191866d88cb_-48c,5201702,Aragarças - GO,17101,17457,356,18193,94,95.95,1.96
sidra_9541_PercMoradDPPOColetTot_munic_22_pol.fid-703dc0a5_191866d88cb_-48b,5201801,Aragoiânia - GO,10292,11129,837,11846,86.88,93.95,7.07
sidra_9541_PercMoradDPPOColetTot_munic_22_pol.fid-703dc0a5_191866d88cb_-48a,5202155,Araguapaz - GO,5134,5140,6,7130,72.01,72.09,0.08
sidra_9541_PercMoradDPPOColetTot_munic_22_pol.fid-703dc0a5_191866d88cb_-488,5202353,Arenópolis - GO,470,2420,1950,2946,15.95,82.15,66.19
sidra_9541_PercMoradDPPOColetTot_munic_22_pol.fid-703dc0a5_191866d88cb_-487,5202502,Aruanã - GO,6923,7289,366,8224,84.18,88.63,4.45
sidra_9541_PercMoradDPPOColetTot_munic_22_pol.fid-703dc0a5_191866d88cb_-486,5202601,Aurilândia - GO,2594,2871,277,3266,79.42,87.91,8.48
sidra_9541_PercMoradDPPOColetTot_munic_22_pol.fid-703dc0a5_191866d88cb_-485,5202809,Avelinópolis - GO,2142,2478,336,2868,74.69,86.4,11.72
sidra_9541_PercMoradDPPOColetTot_munic_22_pol.fid-703dc0a5_191866d88cb_-484,5203104,Baliza - GO,1233,1307,74,3341,36.91,39.12,2.21
sidra_9541_PercMoradDPPOColetTot_munic_22_pol.fid-703dc0a5_191866d88cb_-482,5203203,Barro Alto - GO,9438,9673,235,10316,91.49,93.77,2.28
sidra_9541_PercMoradDPPOColetTot_munic_22_pol.fid-703dc0a5_191866d88cb_-481,5203302,Bela Vista de Goiás - GO,26790,31491,4701,34320,78.06,91.76,13.7
sidra_9541_PercMoradDPPOColetTot_munic_22_pol.fid-703dc0a5_191866d88cb_-480,5203401,Bom Jardim de Goiás - GO,6190,6386,196,7780,79.56,82.08,2.52
sidra_9541_PercMoradDPPOColetTot_munic_22_pol.fid-703dc0a5_191866d88cb_-47f,5203500,Bom Jesus de Goiás - GO,22794,22906,112,23831,95.65,96.12,0.47
sidra_9541_PercMoradDPPOColetTot_munic_22_pol.fid-703dc0a5_191866d88cb_-47e,5203559,Bonfinópolis - GO,9388,9984,596,10257,91.53,97.34,5.81
sidra_9541_PercMoradDPPOColetTot_munic_22_pol.fid-703dc0a5_191866d88cb_-47c,5203575,Bonópolis - GO,2100,2158,58,3282,63.99,65.75,1.77
sidra_9541_PercMoradDPPOColetTot_munic_22_pol.fid-703dc0a5_191866d88cb_-47b,4304903,Casca - RS,7614,9155,1541,9443,80.63,96.95,16.32
sidra_9541_PercMoradDPPOColetTot_munic_22_pol.fid-703dc0a5_191866d88cb_-47a,4304952,Caseiros - RS,2129,2690,561,2998,71.01,89.73,18.71
sidra_9541_PercMoradDPPOColetTot_munic_22_pol.fid-703dc0a5_191866d88cb_-479,4305009,Catuípe - RS,6090,6787,697,8666,70.27,78.32,8.04
sidra_9541_PercMoradDPPOColetTot_munic_22_pol.fid-703dc0a5_191866d88cb_-478,4305108,Caxias do Sul - RS,342140,458656,116516,461773,74.09,99.32,25.23
sidra_9541_PercMoradDPPOColetTot_munic_22_pol.fid-703dc0a5_191866d88cb_-477,4305116,Centenário - RS,1513,1520,7,2715,55.73,55.99,0.26
sidra_9541_PercMoradDPPOColetTot_munic_22_pol.fid-703dc0a5_191866d88cb_-476,5203609,Brazabrantes - GO,3488,3752,264,3991,87.4,94.01,6.61
sidra_9541_PercMoradDPPOColetTot_munic_22_pol.fid-703dc0a5_191866d88cb_-475,5203807,Britânia - GO,5005,5371,366,5657,88.47,94.94,6.47
sidra_9541_PercMoradDPPOColetTot_munic_22_pol.fid-703dc0a5_191866d88cb_-474,5203906,Buriti Alegre - GO,9753,9811,58,10433,93.48,94.04,0.56
sidra_9541_PercMoradDPPOColetTot_munic_22_pol.fid-703dc0a5_191866d88cb_-473,5203939,Buriti de Goiás - GO,2328,2463,135,2732,85.21,90.15,4.94
sidra_9541_PercMoradDPPOColetTot_munic_22_pol.fid-703dc0a5_191866d88cb_-472,5203962,Buritinópolis - GO,2508,2512,4,3141,79.85,79.97,0.13
sidra_9541_PercMoradDPPOColetTot_munic_22_pol.fid-703dc0a5_191866d88cb_-471,5204003,Cabeceiras - GO,6492,6582,90,7547,86.02,87.21,1.19
sidra_9541_PercMoradDPPOColetTot_munic_22_pol.fid-703dc0a5_191866d88cb_-470,5204102,Cachoeira Alta - GO,9365,10109,744,11344,82.55,89.11,6.56
sidra_9541_PercMoradDPPOColetTot_munic_22_pol.fid-703dc0a5_191866d88cb_-46e,5204201,Cachoeira de Goiás - GO,1137,1195,58,1405,80.93,85.05,4.13
sidra_9541_PercMoradDPPOColetTot_munic_22_pol.fid-703dc0a5_191866d88cb_-46d,5204250,Cachoeira Dourada - GO,7115,7148,33,7771,91.56,91.98,0.42
sidra_9541_PercMoradDPPOColetTot_munic_22_pol.fid-703dc0a5_191866d88cb_-46c,5204300,Caçu - GO,11596,12878,1282,13703,84.62,93.98,9.36
sidra_9541_PercMoradDPPOColetTot_munic_22_pol.fid-703dc0a5_191866d88cb_-46b,5204409,Caiapônia - GO,12659,13369,710,16409,77.15,81.47,4.33
sidra_9541_PercMoradDPPOColetTot_munic_22_pol.fid-703dc0a5_191866d88cb_-46a,5204508,Caldas Novas - GO,91898,96264,4366,98234,93.55,97.99,4.44
sidra_9541_PercMoradDPPOColetTot_munic_22_pol.fid-703dc0a5_191866d88cb_-469,5204557,Caldazinha - GO,2800,3856,1056,4503,62.18,85.63,23.45
sidra_9541_PercMoradDPPOColetTot_munic_22_pol.fid-703dc0a5_191866d88cb_-468,5204607,Campestre de Goiás - GO,2889,3076,187,3751,77.02,82,4.99
sidra_9541_PercMoradDPPOColetTot_munic_22_pol.fid-703dc0a5_191866d88cb_-467,5204656,Campinaçu - GO,2348,2353,5,3708,63.32,63.46,0.13
sidra_9541_PercMoradDPPOColetTot_munic_22_pol.fid-703dc0a5_191866d88cb_-465,5204706,Campinorte - GO,11039,11176,137,12489,88.39,89.49,1.1
sidra_9541_PercMoradDPPOColetTot_munic_22_pol.fid-703dc0a5_191866d88cb_-464,5204805,Campo Alegre de Goiás - GO,5966,6440,474,7397,80.65,87.06,6.41
sidra_9541_PercMoradDPPOColetTot_munic_22_pol.fid-703dc0a5_191866d88cb_-463,5204854,Campo Limpo de Goiás - GO,5522,7257,1735,8062,68.49,90.01,21.52
sidra_9541_PercMoradDPPOColetTot_munic_22_pol.fid-703dc0a5_191866d88cb_-462,5204904,Campos Belos - GO,16873,17057,184,17996,93.76,94.78,1.02
sidra_9541_PercMoradDPPOColetTot_munic_22_pol.fid-703dc0a5_191866d88cb_-461,5204953,Campos Verdes - GO,3533,3572,39,4003,88.26,89.23,0.97
sidra_9541_PercMoradDPPOColetTot_munic_22_pol.fid-703dc0a5_191866d88cb_-460,5205000,Carmo do Rio Verde - GO,8007,8232,225,9680,82.72,85.04,2.32
sidra_9541_PercMoradDPPOColetTot_munic_22_pol.fid-703dc0a5_191866d88cb_-45f,5205059,Castelândia - GO,2772,2776,4,2970,93.33,93.47,0.13
sidra_9541_PercMoradDPPOColetTot_munic_22_pol.fid-703dc0a5_191866d88cb_-45e,5205109,Catalão - GO,105214,111772,6558,113909,92.37,98.12,5.76
sidra_9541_PercMoradDPPOColetTot_munic_22_pol.fid-703dc0a5_191866d88cb_-45d,4305124,Cerrito - RS,3883,4035,152,5782,67.16,69.79,2.63
sidra_9541_PercMoradDPPOColetTot_munic_22_pol.fid-703dc0a5_191866d88cb_-45c,4305132,Cerro Branco - RS,3291,3419,128,3800,86.61,89.97,3.37
sidra_9541_PercMoradDPPOColetTot_munic_22_pol.fid-703dc0a5_191866d88cb_-45b,4305157,Cerro Grande - RS,1214,1273,59,2379,51.03,53.51,2.48
sidra_9541_PercMoradDPPOColetTot_munic_22_pol.fid-703dc0a5_191866d88cb_-45a,4305439,Chuí - RS,5183,6168,985,6256,82.85,98.59,15.74
sidra_9541_PercMoradDPPOColetTot_munic_22_pol.fid-703dc0a5_191866d88cb_-459,4306700,Dona Francisca - RS,386,2925,2539,3077,12.54,95.06,82.52
sidra_9541_PercMoradDPPOColetTot_munic_22_pol.fid-703dc0a5_191866d88cb_-458,4306734,Doutor Maurício Cardoso - RS,3494,3572,78,4443,78.64,80.4,1.76
sidra_9541_PercMoradDPPOColetTot_munic_22_pol.fid-703dc0a5_191866d88cb_-457,4306759,Doutor Ricardo - RS,1669,1728,59,1888,88.4,91.53,3.13
sidra_9541_PercMoradDPPOColetTot_munic_22_pol.fid-703dc0a5_191866d88cb_-456,4306767,Eldorado do Sul - RS,38592,38829,237,39416,97.91,98.51,0.6
sidra_9541_PercMoradDPPOColetTot_munic_22_pol.fid-703dc0a5_191866d88cb_-454,5205208,Caturaí - GO,4311,4515,204,5178,83.26,87.2,3.94
sidra_9541_PercMoradDPPOColetTot_munic_22_pol.fid-703dc0a5_191866d88cb_-453,4305447,Chuvisca - RS,1380,1549,169,4597,30.02,33.7,3.68
sidra_9541_PercMoradDPPOColetTot_munic_22_pol.fid-703dc0a5_191866d88cb_-452,4306924,Engenho Velho - RS,947,947,,1292,73.3,73.3,
sidra_9541_PercMoradDPPOColetTot_munic_22_pol.fid-703dc0a5_191866d88cb_-451,4306932,Entre-Ijuís - RS,5689,6396,707,9113,62.43,70.19,7.76
sidra_9541_PercMoradDPPOColetTot_munic_22_pol.fid-703dc0a5_191866d88cb_-450,4306957,Entre Rios do Sul - RS,2630,2632,2,2674,98.35,98.43,0.07
sidra_9541_PercMoradDPPOColetTot_munic_22_pol.fid-703dc0a5_191866d88cb_-44f,4306973,Erebango - RS,2412,2437,25,3028,79.66,80.48,0.83
sidra_9541_PercMoradDPPOColetTot_munic_22_pol.fid-703dc0a5_191866d88cb_-44e,4307005,Erechim - RS,102244,103558,1314,105023,97.35,98.61,1.25
sidra_9541_PercMoradDPPOColetTot_munic_22_pol.fid-703dc0a5_191866d88cb_-44d,5205307,Cavalcante - GO,5274,5945,671,9548,55.24,62.26,7.03
sidra_9541_PercMoradDPPOColetTot_munic_22_pol.fid-703dc0a5_191866d88cb_-44c,5205406,Ceres - GO,20628,21271,643,21937,94.03,96.96,2.93
sidra_9541_PercMoradDPPOColetTot_munic_22_pol.fid-703dc0a5_191866d88cb_-44b,5205455,Cezarina - GO,6331,6861,530,8086,78.3,84.85,6.55
sidra_9541_PercMoradDPPOColetTot_munic_22_pol.fid-703dc0a5_191866d88cb_-44a,5205471,Chapadão do Céu - GO,11898,12544,646,12840,92.66,97.69,5.03
sidra_9541_PercMoradDPPOColetTot_munic_22_pol.fid-703dc0a5_191866d88cb_-448,5205497,Cidade Ocidental - GO,80220,89698,9478,91614,87.56,97.91,10.35
sidra_9541_PercMoradDPPOColetTot_munic_22_pol.fid-703dc0a5_191866d88cb_-447,5205513,Cocalzinho de Goiás - GO,18398,19464,1066,24853,74.03,78.32,4.29
sidra_9541_PercMoradDPPOColetTot_munic_22_pol.fid-703dc0a5_191866d88cb_-420,5205521,Colinas do Sul - GO,2847,3044,197,4013,70.94,75.85,4.91
sidra_9541_PercMoradDPPOColetTot_munic_22_pol.fid-703dc0a5_191866d88cb_-41f,5205703,Córrego do Ouro - GO,1534,1976,442,2454,62.51,80.52,18.01
sidra_9541_PercMoradDPPOColetTot_munic_22_pol.fid-703dc0a5_191866d88cb_-41d,5205802,Corumbá de Goiás - GO,7159,7719,560,10351,69.16,74.57,5.41
sidra_9541_PercMoradDPPOColetTot_munic_22_pol.fid-703dc0a5_191866d88cb_-41c,5205901,Corumbaíba - GO,7604,8125,521,9103,83.53,89.26,5.72
sidra_9541_PercMoradDPPOColetTot_munic_22_pol.fid-703dc0a5_191866d88cb_-41b,4305454,Cidreira - RS,16340,16964,624,17009,96.07,99.74,3.67
sidra_9541_PercMoradDPPOColetTot_munic_22_pol.fid-703dc0a5_191866d88cb_-41a,4307450,Esperança do Sul - RS,1734,2089,355,3226,53.75,64.76,11
sidra_9541_PercMoradDPPOColetTot_munic_22_pol.fid-703dc0a5_191866d88cb_-419,4307500,Espumoso - RS,7824,13249,5425,15007,52.14,88.29,36.15
sidra_9541_PercMoradDPPOColetTot_munic_22_pol.fid-703dc0a5_191866d88cb_-418,5206206,Cristalina - GO,53571,54543,972,62083,86.29,87.85,1.57
sidra_9541_PercMoradDPPOColetTot_munic_22_pol.fid-703dc0a5_191866d88cb_-417,5206305,Cristianópolis - GO,3049,3159,110,3477,87.69,90.85,3.16
sidra_9541_PercMoradDPPOColetTot_munic_22_pol.fid-703dc0a5_191866d88cb_-416,5206404,Crixás - GO,13382,13704,322,17006,78.69,80.58,1.89
sidra_9541_PercMoradDPPOColetTot_munic_22_pol.fid-703dc0a5_191866d88cb_-414,4305504,Ciríaco - RS,3818,3822,4,4146,92.09,92.19,0.1
sidra_9541_PercMoradDPPOColetTot_munic_22_pol.fid-703dc0a5_191866d88cb_-413,4307708,Esteio - RS,69580,75890,6310,75957,91.6,99.91,8.31
sidra_9541_PercMoradDPPOColetTot_munic_22_pol.fid-703dc0a5_191866d88cb_-412,5206503,Cromínia - GO,3078,3533,455,3879,79.35,91.08,11.73
sidra_9541_PercMoradDPPOColetTot_munic_22_pol.fid-703dc0a5_191866d88cb_-411,5206602,Cumari - GO,2341,2709,368,2908,80.5,93.16,12.65
sidra_9541_PercMoradDPPOColetTot_munic_22_pol.fid-703dc0a5_191866d88cb_-410,4305587,Colinas - RS,2381,2381,,2421,98.35,98.35,
sidra_9541_PercMoradDPPOColetTot_munic_22_pol.fid-703dc0a5_191866d88cb_-40f,4305603,Colorado - RS,1666,2838,1172,3253,51.21,87.24,36.03
sidra_9541_PercMoradDPPOColetTot_munic_22_pol.fid-703dc0a5_191866d88cb_-40e,4305702,Condor - RS,5316,5722,406,6406,82.98,89.32,6.34
sidra_9541_PercMoradDPPOColetTot_munic_22_pol.fid-703dc0a5_191866d88cb_-40d,4308003,Faxinal do Soturno - RS,4882,6225,1343,6698,72.89,92.94,20.05
sidra_9541_PercMoradDPPOColetTot_munic_22_pol.fid-703dc0a5_191866d88cb_-40c,4308052,Faxinalzinho - RS,1965,2250,285,2515,78.13,89.46,11.33
sidra_9541_PercMoradDPPOColetTot_munic_22_pol.fid-703dc0a5_191866d88cb_-40b,5206701,Damianópolis - GO,3015,3027,12,3768,80.02,80.33,0.32
sidra_9541_PercMoradDPPOColetTot_munic_22_pol.fid-703dc0a5_191866d88cb_-40a,5206800,Damolândia - GO,2265,2507,242,2717,83.36,92.27,8.91
sidra_9541_PercMoradDPPOColetTot_munic_22_pol.fid-703dc0a5_191866d88cb_-409,5206909,Davinópolis - GO,1514,1788,274,1899,79.73,94.15,14.43
sidra_9541_PercMoradDPPOColetTot_munic_22_pol.fid-703dc0a5_191866d88cb_-408,5207105,Diorama - GO,1410,1537,127,2054,68.65,74.83,6.18
sidra_9541_PercMoradDPPOColetTot_munic_22_pol.fid-703dc0a5_191866d88cb_-407,5207253,Doverlândia - GO,4878,4992,114,6939,70.3,71.94,1.64
sidra_9541_PercMoradDPPOColetTot_munic_22_pol.fid-703dc0a5_191866d88cb_-405,5207352,Edealina - GO,3115,3484,369,3981,78.25,87.52,9.27
sidra_9541_PercMoradDPPOColetTot_munic_22_pol.fid-703dc0a5_191866d88cb_-404,4305801,Constantina - RS,7915,8903,988,10377,76.27,85.8,9.52
sidra_9541_PercMoradDPPOColetTot_munic_22_pol.fid-703dc0a5_191866d88cb_-403,4305835,Coqueiro Baixo - RS,1236,1241,5,1290,95.81,96.2,0.39
sidra_9541_PercMoradDPPOColetTot_munic_22_pol.fid-703dc0a5_191866d88cb_-402,4305850,Coqueiros do Sul - RS,1490,1740,250,2209,67.45,78.77,11.32
sidra_9541_PercMoradDPPOColetTot_munic_22_pol.fid-703dc0a5_191866d88cb_-401,4305871,Coronel Barros - RS,1585,1848,263,2808,56.45,65.81,9.37
sidra_9541_PercMoradDPPOColetTot_munic_22_pol.fid-703dc0a5_191866d88cb_-400,4305900,Coronel Bicaco - RS,4721,4974,253,6137,76.93,81.05,4.12
sidra_9541_PercMoradDPPOColetTot_munic_22_pol.fid-703dc0a5_191866d88cb_-3ff,5207402,Edéia - GO,10315,10765,450,11640,88.62,92.48,3.87
sidra_9541_PercMoradDPPOColetTot_munic_22_pol.fid-703dc0a5_191866d88cb_-3fe,5207501,Estrela do Norte - GO,2903,2930,27,3205,90.58,91.42,0.84
sidra_9541_PercMoradDPPOColetTot_munic_22_pol.fid-703dc0a5_191866d88cb_-3fc,5207535,Faina - GO,3969,4336,367,7036,56.41,61.63,5.22
sidra_9541_PercMoradDPPOColetTot_munic_22_pol.fid-703dc0a5_191866d88cb_-3fb,5207600,Fazenda Nova - GO,3883,4059,176,5864,66.22,69.22,3
sidra_9541_PercMoradDPPOColetTot_munic_22_pol.fid-703dc0a5_191866d88cb_-3fa,5207808,Firminópolis - GO,9171,9495,324,10359,88.53,91.66,3.13
sidra_9541_PercMoradDPPOColetTot_munic_22_pol.fid-703dc0a5_191866d88cb_-3f9,5207907,Flores de Goiás - GO,4662,4711,49,13395,34.8,35.17,0.37
sidra_9541_PercMoradDPPOColetTot_munic_22_pol.fid-703dc0a5_191866d88cb_-3f8,4305934,Coronel Pilar - RS,1194,1417,223,1607,74.3,88.18,13.88
sidra_9541_PercMoradDPPOColetTot_munic_22_pol.fid-703dc0a5_191866d88cb_-3f7,4305959,Cotiporã - RS,2600,3738,1138,3833,67.83,97.52,29.69
sidra_9541_PercMoradDPPOColetTot_munic_22_pol.fid-703dc0a5_191866d88cb_-3f6,4305975,Coxilha - RS,2077,2136,59,2667,77.88,80.09,2.21
sidra_9541_PercMoradDPPOColetTot_munic_22_pol.fid-703dc0a5_191866d88cb_-3f5,4306007,Crissiumal - RS,9033,9720,687,12814,70.49,75.85,5.36
sidra_9541_PercMoradDPPOColetTot_munic_22_pol.fid-703dc0a5_191866d88cb_-3f4,5208004,Formosa - GO,105294,106842,1548,114798,91.72,93.07,1.35
sidra_9541_PercMoradDPPOColetTot_munic_22_pol.fid-703dc0a5_191866d88cb_-3f2,5208103,Formoso - GO,3784,3790,6,4658,81.24,81.37,0.13
sidra_9541_PercMoradDPPOColetTot_munic_22_pol.fid-703dc0a5_191866d88cb_-3f1,5208152,Gameleira de Goiás - GO,1855,2061,206,3455,53.69,59.65,5.96
sidra_9541_PercMoradDPPOColetTot_munic_22_pol.fid-703dc0a5_191866d88cb_-3f0,5208301,Divinópolis de Goiás - GO,3597,3722,125,4457,80.7,83.51,2.8
sidra_9541_PercMoradDPPOColetTot_munic_22_pol.fid-703dc0a5_191866d88cb_-3ef,5208400,Goianápolis - GO,13230,13494,264,13876,95.34,97.25,1.9
sidra_9541_PercMoradDPPOColetTot_munic_22_pol.fid-703dc0a5_191866d88cb_-3ee,5208509,Goiandira - GO,4438,4759,321,4958,89.51,95.99,6.47
sidra_9541_PercMoradDPPOColetTot_munic_22_pol.fid-703dc0a5_191866d88cb_-3ed,5208608,Goianésia - GO,69911,71015,1104,73263,95.42,96.93,1.51
sidra_9541_PercMoradDPPOColetTot_munic_22_pol.fid-703dc0a5_191866d88cb_-3ec,5208707,Goiânia - GO,1336254,1430949,94695,1434426,93.16,99.76,6.6
sidra_9541_PercMoradDPPOColetTot_munic_22_pol.fid-703dc0a5_191866d88cb_-3eb,5208806,Goianira - GO,70444,71154,710,71826,98.08,99.06,0.99
sidra_9541_PercMoradDPPOColetTot_munic_22_pol.fid-703dc0a5_191866d88cb_-3ea,5208905,Goiás - GO,17879,18908,1029,23919,74.75,79.05,4.3
sidra_9541_PercMoradDPPOColetTot_munic_22_pol.fid-703dc0a5_191866d88cb_-3e9,4306056,Cristal - RS,6407,6472,65,7281,88,88.89,0.89
sidra_9541_PercMoradDPPOColetTot_munic_22_pol.fid-703dc0a5_191866d88cb_-3e8,4306072,Cristal do Sul - RS,1477,1529,52,2689,54.93,56.86,1.93
sidra_9541_PercMoradDPPOColetTot_munic_22_pol.fid-703dc0a5_191866d88cb_-3e7,4306106,Cruz Alta - RS,53655,56946,3291,58594,91.57,97.19,5.62
sidra_9541_PercMoradDPPOColetTot_munic_22_pol.fid-703dc0a5_191866d88cb_-3e6,5209101,Goiatuba - GO,33419,33613,194,35481,94.19,94.74,0.55
sidra_9541_PercMoradDPPOColetTot_munic_22_pol.fid-703dc0a5_191866d88cb_-3e5,5209150,Gouvelândia - GO,3756,3910,154,4381,85.73,89.25,3.52
sidra_9541_PercMoradDPPOColetTot_munic_22_pol.fid-703dc0a5_191866d88cb_-3e4,5209200,Guapó - GO,17582,18642,1060,19530,90.03,95.45,5.43
sidra_9541_PercMoradDPPOColetTot_munic_22_pol.fid-703dc0a5_191866d88cb_-3e2,5209291,Guaraíta - GO,1431,1632,201,2188,65.4,74.59,9.19
sidra_9541_PercMoradDPPOColetTot_munic_22_pol.fid-703dc0a5_191866d88cb_-3e1,5209408,Guarani de Goiás - GO,2275,2354,79,4082,55.73,57.67,1.94
sidra_9541_PercMoradDPPOColetTot_munic_22_pol.fid-703dc0a5_191866d88cb_-3e0,5209457,Guarinos - GO,1372,1438,66,2159,63.55,66.6,3.06
sidra_9541_PercMoradDPPOColetTot_munic_22_pol.fid-703dc0a5_191866d88cb_-3df,5209606,Heitoraí - GO,2277,2723,446,3344,68.09,81.43,13.34
sidra_9541_PercMoradDPPOColetTot_munic_22_pol.fid-703dc0a5_191866d88cb_-3de,4306130,Cruzaltense - RS,579,579,,1635,35.41,35.41,
sidra_9541_PercMoradDPPOColetTot_munic_22_pol.fid-703dc0a5_191866d88cb_-3dd,4306205,Cruzeiro do Sul - RS,6266,11340,5074,11468,54.64,98.88,44.24
sidra_9541_PercMoradDPPOColetTot_munic_22_pol.fid-703dc0a5_191866d88cb_-3dc,4308078,Fazenda Vilanova - RS,4128,4252,124,4281,96.43,99.32,2.9
sidra_9541_PercMoradDPPOColetTot_munic_22_pol.fid-703dc0a5_191866d88cb_-3db,5209705,Hidrolândia - GO,23128,25271,2143,27625,83.72,91.48,7.76
sidra_9541_PercMoradDPPOColetTot_munic_22_pol.fid-703dc0a5_191866d88cb_-3da,5209804,Hidrolina - GO,2806,2953,147,3543,79.2,83.35,4.15
sidra_9541_PercMoradDPPOColetTot_munic_22_pol.fid-703dc0a5_191866d88cb_-3d9,5209903,Iaciara - GO,8950,9289,339,10564,84.72,87.93,3.21
sidra_9541_PercMoradDPPOColetTot_munic_22_pol.fid-703dc0a5_191866d88cb_-3d8,5209937,Inaciolândia - GO,5217,5315,98,5886,88.63,90.3,1.66
sidra_9541_PercMoradDPPOColetTot_munic_22_pol.fid-703dc0a5_191866d88cb_-3d7,5209952,Indiara - GO,15119,15513,394,16997,88.95,91.27,2.32
sidra_9541_PercMoradDPPOColetTot_munic_22_pol.fid-703dc0a5_191866d88cb_-3d5,5210000,Inhumas - GO,49338,49852,514,51892,95.08,96.07,0.99
sidra_9541_PercMoradDPPOColetTot_munic_22_pol.fid-703dc0a5_191866d88cb_-3d3,5210109,Ipameri - GO,22318,23447,1129,25407,87.84,92.29,4.44
sidra_9541_PercMoradDPPOColetTot_munic_22_pol.fid-703dc0a5_191866d88cb_-3d2,5210158,Ipiranga de Goiás - GO,1958,2127,169,2912,67.24,73.04,5.8
sidra_9541_PercMoradDPPOColetTot_munic_22_pol.fid-703dc0a5_191866d88cb_-3d1,5210208,Iporá - GO,32671,33113,442,35341,92.45,93.7,1.25
sidra_9541_PercMoradDPPOColetTot_munic_22_pol.fid-703dc0a5_191866d88cb_-3d0,5210307,Israelândia - GO,1911,2094,183,2502,76.38,83.69,7.31
sidra_9541_PercMoradDPPOColetTot_munic_22_pol.fid-703dc0a5_191866d88cb_-3cf,5210406,Itaberaí - GO,39113,40170,1057,44616,87.67,90.03,2.37
sidra_9541_PercMoradDPPOColetTot_munic_22_pol.fid-703dc0a5_191866d88cb_-3ce,5210562,Itaguari - GO,4572,4716,144,4963,92.12,95.02,2.9
sidra_9541_PercMoradDPPOColetTot_munic_22_pol.fid-703dc0a5_191866d88cb_-3cd,5210604,Itaguaru - GO,4234,4339,105,4894,86.51,88.66,2.15
sidra_9541_PercMoradDPPOColetTot_munic_22_pol.fid-703dc0a5_191866d88cb_-3cb,5210802,Itajá - GO,3392,3709,317,4366,77.69,84.95,7.26
sidra_9541_PercMoradDPPOColetTot_munic_22_pol.fid-703dc0a5_191866d88cb_-3ca,5210901,Itapaci - GO,19351,19515,164,21056,91.9,92.68,0.78
sidra_9541_PercMoradDPPOColetTot_munic_22_pol.fid-703dc0a5_191866d88cb_-3c9,5211008,Itapirapuã - GO,5972,6423,451,7979,74.85,80.5,5.65
sidra_9541_PercMoradDPPOColetTot_munic_22_pol.fid-703dc0a5_191866d88cb_-3c8,5211206,Itapuranga - GO,21012,22916,1904,25933,81.02,88.37,7.34
sidra_9541_PercMoradDPPOColetTot_munic_22_pol.fid-703dc0a5_191866d88cb_-3c7,5211305,Itarumã - GO,3972,4629,657,6069,65.45,76.27,10.83
sidra_9541_PercMoradDPPOColetTot_munic_22_pol.fid-703dc0a5_191866d88cb_-3c6,5211404,Itauçu - GO,6773,7028,255,7647,88.57,91.91,3.33
sidra_9541_PercMoradDPPOColetTot_munic_22_pol.fid-703dc0a5_191866d88cb_-3c5,5211503,Itumbiara - GO,103528,104828,1300,107289,96.49,97.71,1.21
sidra_9541_PercMoradDPPOColetTot_munic_22_pol.fid-703dc0a5_191866d88cb_-3c4,5211602,Ivolândia - GO,1459,1582,123,2679,54.46,59.05,4.59
sidra_9541_PercMoradDPPOColetTot_munic_22_pol.fid-703dc0a5_191866d88cb_-3c3,5211701,Jandaia - GO,4682,4980,298,6269,74.68,79.44,4.75
sidra_9541_PercMoradDPPOColetTot_munic_22_pol.fid-703dc0a5_191866d88cb_-3c2,5211800,Jaraguá - GO,39328,40562,1234,45058,87.28,90.02,2.74
sidra_9541_PercMoradDPPOColetTot_munic_22_pol.fid-703dc0a5_191866d88cb_-3c1,5211909,Jataí - GO,99046,100866,1820,104967,94.36,96.09,1.73
sidra_9541_PercMoradDPPOColetTot_munic_22_pol.fid-703dc0a5_191866d88cb_-3bf,4306304,David Canabarro - RS,3882,3945,63,4318,89.9,91.36,1.46
sidra_9541_PercMoradDPPOColetTot_munic_22_pol.fid-703dc0a5_191866d88cb_-3be,4306320,Derrubadas - RS,1585,1652,67,2751,57.62,60.05,2.44
sidra_9541_PercMoradDPPOColetTot_munic_22_pol.fid-703dc0a5_191866d88cb_-3bd,4306353,Dezesseis de Novembro - RS,1497,2104,607,2507,59.71,83.93,24.21
sidra_9541_PercMoradDPPOColetTot_munic_22_pol.fid-703dc0a5_191866d88cb_-3bc,4306379,Dilermando de Aguiar - RS,1042,2372,1330,2806,37.13,84.53,47.4
sidra_9541_PercMoradDPPOColetTot_munic_22_pol.fid-703dc0a5_191866d88cb_-3ba,4306403,Dois Irmãos - RS,30109,30519,410,30596,98.41,99.75,1.34
sidra_9541_PercMoradDPPOColetTot_munic_22_pol.fid-703dc0a5_191866d88cb_-3b9,4306429,Dois Irmãos das Missões - RS,1623,1632,9,2090,77.66,78.09,0.43
sidra_9541_PercMoradDPPOColetTot_munic_22_pol.fid-703dc0a5_191866d88cb_-3b8,5212006,Jaupaci - GO,2204,2244,40,2837,77.69,79.1,1.41
sidra_9541_PercMoradDPPOColetTot_munic_22_pol.fid-703dc0a5_191866d88cb_-3b7,5212055,Jesúpolis - GO,1837,1956,119,2123,86.53,92.13,5.61
sidra_9541_PercMoradDPPOColetTot_munic_22_pol.fid-703dc0a5_191866d88cb_-3b6,5212105,Joviânia - GO,6548,6835,287,7106,92.15,96.19,4.04
sidra_9541_PercMoradDPPOColetTot_munic_22_pol.fid-703dc0a5_191866d88cb_-3b5,5212204,Jussara - GO,15875,16689,814,19491,81.45,85.62,4.18
sidra_9541_PercMoradDPPOColetTot_munic_22_pol.fid-703dc0a5_191866d88cb_-3b3,5212253,Lagoa Santa - GO,1013,1199,186,1389,72.93,86.32,13.39
sidra_9541_PercMoradDPPOColetTot_munic_22_pol.fid-703dc0a5_191866d88cb_-3b2,5212303,Leopoldo de Bulhões - GO,5726,6756,1030,8641,66.27,78.19,11.92
sidra_9541_PercMoradDPPOColetTot_munic_22_pol.fid-703dc0a5_191866d88cb_-3b1,5212501,Luziânia - GO,189050,194835,5785,207911,90.93,93.71,2.78
sidra_9541_PercMoradDPPOColetTot_munic_22_pol.fid-703dc0a5_191866d88cb_-3b0,5212600,Mairipotaba - GO,1769,2132,363,2538,69.7,84,14.3
sidra_9541_PercMoradDPPOColetTot_munic_22_pol.fid-703dc0a5_191866d88cb_-3af,5212709,Mambaí - GO,6759,6807,48,8107,83.37,83.96,0.59
sidra_9541_PercMoradDPPOColetTot_munic_22_pol.fid-703dc0a5_191866d88cb_-3ae,5212808,Mara Rosa - GO,8763,8862,99,10651,82.27,83.2,0.93
sidra_9541_PercMoradDPPOColetTot_munic_22_pol.fid-703dc0a5_191866d88cb_-3ac,5212907,Marzagão - GO,2416,2567,151,2758,87.6,93.07,5.47
sidra_9541_PercMoradDPPOColetTot_munic_22_pol.fid-703dc0a5_191866d88cb_-3ab,5212956,Matrinchã - GO,2840,3168,328,4024,70.58,78.73,8.15
sidra_9541_PercMoradDPPOColetTot_munic_22_pol.fid-703dc0a5_191866d88cb_-3a9,5213004,Maurilândia - GO,9833,9884,51,10203,96.37,96.87,0.5
sidra_9541_PercMoradDPPOColetTot_munic_22_pol.fid-703dc0a5_191866d88cb_-3a8,5213053,Mimoso de Goiás - GO,1259,1325,66,2614,48.16,50.69,2.52
sidra_9541_PercMoradDPPOColetTot_munic_22_pol.fid-703dc0a5_191866d88cb_-3a7,5213087,Minaçu - GO,22903,23565,662,26706,85.76,88.24,2.48
sidra_9541_PercMoradDPPOColetTot_munic_22_pol.fid-703dc0a5_191866d88cb_-3a6,4306809,Encantado - RS,22266,22367,101,22785,97.72,98.17,0.44
sidra_9541_PercMoradDPPOColetTot_munic_22_pol.fid-703dc0a5_191866d88cb_-3a5,4306908,Encruzilhada do Sul - RS,18929,19589,660,23736,79.75,82.53,2.78
sidra_9541_PercMoradDPPOColetTot_munic_22_pol.fid-703dc0a5_191866d88cb_-3a4,5213103,Mineiros - GO,64808,66435,1627,69766,92.89,95.23,2.33
sidra_9541_PercMoradDPPOColetTot_munic_22_pol.fid-703dc0a5_191866d88cb_-3a3,5213400,Moiporá - GO,1150,1323,173,1684,68.29,78.56,10.27
sidra_9541_PercMoradDPPOColetTot_munic_22_pol.fid-703dc0a5_191866d88cb_-3a2,5213509,Monte Alegre de Goiás - GO,3652,3762,110,6684,54.64,56.28,1.65
sidra_9541_PercMoradDPPOColetTot_munic_22_pol.fid-703dc0a5_191866d88cb_-3a0,5213707,Montes Claros de Goiás - GO,6595,6833,238,8733,75.52,78.24,2.73
sidra_9541_PercMoradDPPOColetTot_munic_22_pol.fid-703dc0a5_191866d88cb_-39f,5213756,Montividiu - GO,10493,11421,928,12424,84.46,91.93,7.47
sidra_9541_PercMoradDPPOColetTot_munic_22_pol.fid-703dc0a5_191866d88cb_-39e,5213772,Montividiu do Norte - GO,1873,1877,4,3775,49.62,49.72,0.11
sidra_9541_PercMoradDPPOColetTot_munic_22_pol.fid-703dc0a5_191866d88cb_-39c,5213806,Morrinhos - GO,46294,48302,2008,51017,90.74,94.68,3.94
sidra_9541_PercMoradDPPOColetTot_munic_22_pol.fid-703dc0a5_191866d88cb_-39b,5213855,Morro Agudo de Goiás - GO,1902,1990,88,2427,78.37,81.99,3.63
sidra_9541_PercMoradDPPOColetTot_munic_22_pol.fid-703dc0a5_191866d88cb_-39a,5213905,Mossâmedes - GO,3463,4035,572,4650,74.47,86.77,12.3
sidra_9541_PercMoradDPPOColetTot_munic_22_pol.fid-703dc0a5_191866d88cb_-399,5214002,Mozarlândia - GO,13419,13784,365,14627,91.74,94.24,2.5
sidra_9541_PercMoradDPPOColetTot_munic_22_pol.fid-703dc0a5_191866d88cb_-398,5214051,Mundo Novo - GO,3705,3823,118,6163,60.12,62.03,1.91
sidra_9541_PercMoradDPPOColetTot_munic_22_pol.fid-703dc0a5_191866d88cb_-397,5214101,Mutunópolis - GO,2476,2535,59,3534,70.06,71.73,1.67
sidra_9541_PercMoradDPPOColetTot_munic_22_pol.fid-703dc0a5_191866d88cb_-396,5214408,Nazário - GO,7518,7861,343,8176,91.95,96.15,4.2
sidra_9541_PercMoradDPPOColetTot_munic_22_pol.fid-703dc0a5_191866d88cb_-395,5214507,Nerópolis - GO,30314,31291,977,31879,95.09,98.16,3.06
sidra_9541_PercMoradDPPOColetTot_munic_22_pol.fid-703dc0a5_191866d88cb_-394,5214606,Niquelândia - GO,26815,28554,1739,34723,77.23,82.23,5.01
sidra_9541_PercMoradDPPOColetTot_munic_22_pol.fid-703dc0a5_191866d88cb_-393,5214705,Nova América - GO,1650,1830,180,2337,70.6,78.31,7.7
sidra_9541_PercMoradDPPOColetTot_munic_22_pol.fid-703dc0a5_191866d88cb_-392,5214804,Nova Aurora - GO,1835,2021,186,2087,87.93,96.84,8.91
sidra_9541_PercMoradDPPOColetTot_munic_22_pol.fid-703dc0a5_191866d88cb_-391,5214838,Nova Crixás - GO,9244,9503,259,12709,72.74,74.77,2.04
sidra_9541_PercMoradDPPOColetTot_munic_22_pol.fid-703dc0a5_191866d88cb_-38f,5214861,Nova Glória - GO,6968,6985,17,8291,84.04,84.25,0.21
sidra_9541_PercMoradDPPOColetTot_munic_22_pol.fid-703dc0a5_191866d88cb_-38e,5214879,Nova Iguaçu de Goiás - GO,2290,2376,86,3007,76.16,79.02,2.86
sidra_9541_PercMoradDPPOColetTot_munic_22_pol.fid-703dc0a5_191866d88cb_-38c,5214903,Nova Roma - GO,1385,1433,48,3069,45.13,46.69,1.56
sidra_9541_PercMoradDPPOColetTot_munic_22_pol.fid-703dc0a5_191866d88cb_-38b,5215009,Nova Veneza - GO,8439,8802,363,9444,89.36,93.2,3.84
sidra_9541_PercMoradDPPOColetTot_munic_22_pol.fid-703dc0a5_191866d88cb_-389,4307054,Ernestina - RS,1408,2461,1053,3019,46.64,81.52,34.88
sidra_9541_PercMoradDPPOColetTot_munic_22_pol.fid-703dc0a5_191866d88cb_-388,4307104,Herval - RS,4368,4625,257,6170,70.79,74.96,4.17
sidra_9541_PercMoradDPPOColetTot_munic_22_pol.fid-703dc0a5_191866d88cb_-386,4307203,Erval Grande - RS,3827,4569,742,4930,77.63,92.68,15.05
sidra_9541_PercMoradDPPOColetTot_munic_22_pol.fid-703dc0a5_191866d88cb_-385,4307302,Erval Seco - RS,5575,5712,137,6778,82.25,84.27,2.02
sidra_9541_PercMoradDPPOColetTot_munic_22_pol.fid-703dc0a5_191866d88cb_-384,4307401,Esmeralda - RS,363,2795,2432,3195,11.36,87.48,76.12
sidra_9541_PercMoradDPPOColetTot_munic_22_pol.fid-703dc0a5_191866d88cb_-383,5215207,Novo Brasil - GO,2715,2880,165,3527,76.98,81.66,4.68
sidra_9541_PercMoradDPPOColetTot_munic_22_pol.fid-703dc0a5_191866d88cb_-382,5215231,Novo Gama - GO,94858,98339,3481,103562,91.6,94.96,3.36
sidra_9541_PercMoradDPPOColetTot_munic_22_pol.fid-703dc0a5_191866d88cb_-381,5215256,Novo Planalto - GO,2727,2737,10,3710,73.5,73.77,0.27
sidra_9541_PercMoradDPPOColetTot_munic_22_pol.fid-703dc0a5_191866d88cb_-380,5215306,Orizona - GO,10125,13212,3087,16299,62.12,81.06,18.94
sidra_9541_PercMoradDPPOColetTot_munic_22_pol.fid-703dc0a5_191866d88cb_-37f,5215405,Ouro Verde de Goiás - GO,2853,3229,376,4057,70.32,79.59,9.27
sidra_9541_PercMoradDPPOColetTot_munic_22_pol.fid-703dc0a5_191866d88cb_-37e,5215504,Ouvidor - GO,6398,6837,439,7174,89.18,95.3,6.12
sidra_9541_PercMoradDPPOColetTot_munic_22_pol.fid-703dc0a5_191866d88cb_-37d,5215603,Padre Bernardo - GO,24986,27964,2978,34693,72.02,80.6,8.58
sidra_9541_PercMoradDPPOColetTot_munic_22_pol.fid-703dc0a5_191866d88cb_-37c,5215652,Palestina de Goiás - GO,2091,2139,48,3129,66.83,68.36,1.53
sidra_9541_PercMoradDPPOColetTot_munic_22_pol.fid-703dc0a5_191866d88cb_-37a,5215702,Palmeiras de Goiás - GO,28255,28889,634,31802,88.85,90.84,1.99
sidra_9541_PercMoradDPPOColetTot_munic_22_pol.fid-703dc0a5_191866d88cb_-378,5215801,Palmelo - GO,2151,2178,27,2227,96.59,97.8,1.21
sidra_9541_PercMoradDPPOColetTot_munic_22_pol.fid-703dc0a5_191866d88cb_-377,5215900,Palminópolis - GO,2946,3003,57,3851,76.5,77.98,1.48
sidra_9541_PercMoradDPPOColetTot_munic_22_pol.fid-703dc0a5_191866d88cb_-376,5216007,Panamá - GO,1935,2025,90,2449,79.01,82.69,3.67
sidra_9541_PercMoradDPPOColetTot_munic_22_pol.fid-703dc0a5_191866d88cb_-375,4307559,Estação - RS,5120,5183,63,5582,91.72,92.85,1.13
sidra_9541_PercMoradDPPOColetTot_munic_22_pol.fid-703dc0a5_191866d88cb_-374,4308805,General Câmara - RS,2589,6762,4173,7612,34.01,88.83,54.82
sidra_9541_PercMoradDPPOColetTot_munic_22_pol.fid-703dc0a5_191866d88cb_-373,4307609,Estância Velha - RS,47223,47714,491,47814,98.76,99.79,1.03
sidra_9541_PercMoradDPPOColetTot_munic_22_pol.fid-703dc0a5_191866d88cb_-372,5216304,Paranaiguara - GO,6900,7105,205,7544,91.46,94.18,2.72
sidra_9541_PercMoradDPPOColetTot_munic_22_pol.fid-703dc0a5_191866d88cb_-371,5216403,Paraúna - GO,8651,8888,237,10640,81.31,83.53,2.23
sidra_9541_PercMoradDPPOColetTot_munic_22_pol.fid-703dc0a5_191866d88cb_-370,5216452,Perolândia - GO,2337,2605,268,2958,79.01,88.07,9.06
sidra_9541_PercMoradDPPOColetTot_munic_22_pol.fid-703dc0a5_191866d88cb_-36f,5216809,Petrolina de Goiás - GO,6697,7101,404,9532,70.26,74.5,4.24
sidra_9541_PercMoradDPPOColetTot_munic_22_pol.fid-703dc0a5_191866d88cb_-36e,5216908,Pilar de Goiás - GO,1349,1398,49,2328,57.95,60.05,2.1
sidra_9541_PercMoradDPPOColetTot_munic_22_pol.fid-703dc0a5_191866d88cb_-36c,5217104,Piracanjuba - GO,19753,21004,1251,24697,79.98,85.05,5.07
sidra_9541_PercMoradDPPOColetTot_munic_22_pol.fid-703dc0a5_191866d88cb_-36b,5217203,Piranhas - GO,9610,10544,934,11635,82.6,90.62,8.03
sidra_9541_PercMoradDPPOColetTot_munic_22_pol.fid-703dc0a5_191866d88cb_-36a,5217302,Pirenópolis - GO,17679,22872,5193,26518,66.67,86.25,19.58
sidra_9541_PercMoradDPPOColetTot_munic_22_pol.fid-703dc0a5_191866d88cb_-369,5217401,Pires do Rio - GO,29231,30984,1753,32061,91.17,96.64,5.47
sidra_9541_PercMoradDPPOColetTot_munic_22_pol.fid-703dc0a5_191866d88cb_-368,5217609,Planaltina - GO,93025,95563,2538,104157,89.31,91.75,2.44
sidra_9541_PercMoradDPPOColetTot_munic_22_pol.fid-703dc0a5_191866d88cb_-366,5217708,Pontalina - GO,15755,16648,893,18147,86.82,91.74,4.92
sidra_9541_PercMoradDPPOColetTot_munic_22_pol.fid-703dc0a5_191866d88cb_-365,5218003,Porangatu - GO,39184,39531,347,44090,88.87,89.66,0.79
sidra_9541_PercMoradDPPOColetTot_munic_22_pol.fid-703dc0a5_191866d88cb_-364,5218052,Porteirão - GO,3801,3852,51,4066,93.48,94.74,1.25
sidra_9541_PercMoradDPPOColetTot_munic_22_pol.fid-703dc0a5_191866d88cb_-363,5218102,Portelândia - GO,2903,3157,254,3280,88.51,96.25,7.74
sidra_9541_PercMoradDPPOColetTot_munic_22_pol.fid-703dc0a5_191866d88cb_-362,5218300,Posse - GO,28749,29253,504,34764,82.7,84.15,1.45
sidra_9541_PercMoradDPPOColetTot_munic_22_pol.fid-703dc0a5_191866d88cb_-360,5218391,Professor Jamil - GO,2661,3058,397,3638,73.14,84.06,10.91
sidra_9541_PercMoradDPPOColetTot_munic_22_pol.fid-703dc0a5_191866d88cb_-35e,5218508,Quirinópolis - GO,44389,45763,1374,48155,92.18,95.03,2.85
sidra_9541_PercMoradDPPOColetTot_munic_22_pol.fid-703dc0a5_191866d88cb_-35d,5218607,Rialma - GO,11386,11519,133,12071,94.33,95.43,1.1
sidra_9541_PercMoradDPPOColetTot_munic_22_pol.fid-703dc0a5_191866d88cb_-35c,4307807,Estrela - RS,31753,31963,210,32077,98.99,99.64,0.65
sidra_9541_PercMoradDPPOColetTot_munic_22_pol.fid-703dc0a5_191866d88cb_-35b,4307815,Estrela Velha - RS,1794,2107,313,3070,58.44,68.63,10.2
sidra_9541_PercMoradDPPOColetTot_munic_22_pol.fid-703dc0a5_191866d88cb_-35a,4307831,Eugênio de Castro - RS,1701,1766,65,2608,65.22,67.71,2.49
sidra_9541_PercMoradDPPOColetTot_munic_22_pol.fid-703dc0a5_191866d88cb_-359,4307864,Fagundes Varela - RS,1744,2504,760,2566,67.97,97.58,29.62
sidra_9541_PercMoradDPPOColetTot_munic_22_pol.fid-703dc0a5_191866d88cb_-358,5218706,Rianápolis - GO,3600,3711,111,3970,90.68,93.48,2.8
sidra_9541_PercMoradDPPOColetTot_munic_22_pol.fid-703dc0a5_191866d88cb_-357,5218789,Rio Quente - GO,3330,3628,298,3824,87.08,94.87,7.79
sidra_9541_PercMoradDPPOColetTot_munic_22_pol.fid-703dc0a5_191866d88cb_-355,5218805,Rio Verde - GO,212009,216197,4188,224756,94.33,96.19,1.86
sidra_9541_PercMoradDPPOColetTot_munic_22_pol.fid-703dc0a5_191866d88cb_-354,5218904,Rubiataba - GO,17363,18275,912,19676,88.24,92.88,4.64
sidra_9541_PercMoradDPPOColetTot_munic_22_pol.fid-703dc0a5_191866d88cb_-353,5219001,Sanclerlândia - GO,7007,7276,269,7870,89.03,92.45,3.42
sidra_9541_PercMoradDPPOColetTot_munic_22_pol.fid-703dc0a5_191866d88cb_-352,5219100,Santa Bárbara de Goiás - GO,5712,5755,43,6149,92.89,93.59,0.7
sidra_9541_PercMoradDPPOColetTot_munic_22_pol.fid-703dc0a5_191866d88cb_-351,5219209,Santa Cruz de Goiás - GO,1356,2047,691,2999,45.22,68.26,23.04
sidra_9541_PercMoradDPPOColetTot_munic_22_pol.fid-703dc0a5_191866d88cb_-350,5219258,Santa Fé de Goiás - GO,3999,4258,259,4936,81.02,86.26,5.25
sidra_9541_PercMoradDPPOColetTot_munic_22_pol.fid-703dc0a5_191866d88cb_-34f,5219308,Santa Helena de Goiás - GO,36677,36868,191,38287,95.79,96.29,0.5
sidra_9541_PercMoradDPPOColetTot_munic_22_pol.fid-703dc0a5_191866d88cb_-34d,5219357,Santa Isabel - GO,2599,2663,64,3530,73.63,75.44,1.81
sidra_9541_PercMoradDPPOColetTot_munic_22_pol.fid-703dc0a5_191866d88cb_-34c,5219407,Santa Rita do Araguaia - GO,5383,5436,53,5910,91.08,91.98,0.9
sidra_9541_PercMoradDPPOColetTot_munic_22_pol.fid-703dc0a5_191866d88cb_-34a,5219456,Santa Rita do Novo Destino - GO,1490,1557,67,2688,55.43,57.92,2.49
sidra_9541_PercMoradDPPOColetTot_munic_22_pol.fid-703dc0a5_191866d88cb_-349,5219506,Santa Rosa de Goiás - GO,2283,2376,93,2814,81.13,84.43,3.3
sidra_9541_PercMoradDPPOColetTot_munic_22_pol.fid-703dc0a5_191866d88cb_-348,5219605,Santa Tereza de Goiás - GO,2891,2891,,3293,87.79,87.79,
sidra_9541_PercMoradDPPOColetTot_munic_22_pol.fid-703dc0a5_191866d88cb_-347,5219704,Santa Terezinha de Goiás - GO,8209,8345,136,10603,77.42,78.7,1.28
sidra_9541_PercMoradDPPOColetTot_munic_22_pol.fid-703dc0a5_191866d88cb_-346,5219712,Santo Antônio da Barra - GO,3682,3879,197,4262,86.39,91.01,4.62
sidra_9541_PercMoradDPPOColetTot_munic_22_pol.fid-703dc0a5_191866d88cb_-345,5219738,Santo Antônio de Goiás - GO,6574,7181,607,7381,89.07,97.29,8.22
sidra_9541_PercMoradDPPOColetTot_munic_22_pol.fid-703dc0a5_191866d88cb_-344,5219753,Santo Antônio do Descoberto - GO,66163,67749,1586,71867,92.06,94.27,2.21
sidra_9541_PercMoradDPPOColetTot_munic_22_pol.fid-703dc0a5_191866d88cb_-342,5219803,São Domingos - GO,6246,6306,60,9671,64.58,65.21,0.62
sidra_9541_PercMoradDPPOColetTot_munic_22_pol.fid-703dc0a5_191866d88cb_-341,4307906,Farroupilha - RS,50404,69276,18872,70148,71.85,98.76,26.9
sidra_9541_PercMoradDPPOColetTot_munic_22_pol.fid-703dc0a5_191866d88cb_-340,5219902,São Francisco de Goiás - GO,4380,5038,658,6358,68.89,79.24,10.35
sidra_9541_PercMoradDPPOColetTot_munic_22_pol.fid-703dc0a5_191866d88cb_-33f,5220009,São João d'Aliança - GO,9088,9321,233,13526,67.19,68.91,1.72
sidra_9541_PercMoradDPPOColetTot_munic_22_pol.fid-703dc0a5_191866d88cb_-33d,5220058,São João da Paraúna - GO,1374,1414,40,1774,77.45,79.71,2.25
sidra_9541_PercMoradDPPOColetTot_munic_22_pol.fid-703dc0a5_191866d88cb_-33c,5220108,São Luís de Montes Belos - GO,31127,32078,951,33653,92.49,95.32,2.83
sidra_9541_PercMoradDPPOColetTot_munic_22_pol.fid-703dc0a5_191866d88cb_-33b,5220157,São Luiz do Norte - GO,3945,4173,228,4832,81.64,86.36,4.72
sidra_9541_PercMoradDPPOColetTot_munic_22_pol.fid-703dc0a5_191866d88cb_-33a,5220207,São Miguel do Araguaia - GO,18964,19221,257,21729,87.28,88.46,1.18
sidra_9541_PercMoradDPPOColetTot_munic_22_pol.fid-703dc0a5_191866d88cb_-338,5220264,São Miguel do Passa Quatro - GO,2396,3593,1197,4366,54.88,82.3,27.42
sidra_9541_PercMoradDPPOColetTot_munic_22_pol.fid-703dc0a5_191866d88cb_-337,4308102,Feliz - RS,12586,13627,1041,13679,92.01,99.62,7.61
sidra_9541_PercMoradDPPOColetTot_munic_22_pol.fid-703dc0a5_191866d88cb_-336,4308201,Flores da Cunha - RS,12771,30432,17661,30862,41.38,98.61,57.23
sidra_9541_PercMoradDPPOColetTot_munic_22_pol.fid-703dc0a5_191866d88cb_-335,4308250,Floriano Peixoto - RS,501,554,53,1667,30.05,33.23,3.18
sidra_9541_PercMoradDPPOColetTot_munic_22_pol.fid-703dc0a5_191866d88cb_-334,4308300,Fontoura Xavier - RS,5285,6543,1258,9543,55.38,68.56,13.18
sidra_9541_PercMoradDPPOColetTot_munic_22_pol.fid-703dc0a5_191866d88cb_-333,4308409,Formigueiro - RS,4251,5840,1589,6301,67.47,92.68,25.22
sidra_9541_PercMoradDPPOColetTot_munic_22_pol.fid-703dc0a5_191866d88cb_-332,4308433,Forquetinha - RS,1722,2344,622,2393,71.96,97.95,25.99
sidra_9541_PercMoradDPPOColetTot_munic_22_pol.fid-703dc0a5_191866d88cb_-331,4308458,Fortaleza dos Valos - RS,3630,3984,354,4456,81.46,89.41,7.94
sidra_9541_PercMoradDPPOColetTot_munic_22_pol.fid-703dc0a5_191866d88cb_-330,4308508,Frederico Westphalen - RS,29085,30235,1150,32392,89.79,93.34,3.55
sidra_9541_PercMoradDPPOColetTot_munic_22_pol.fid-703dc0a5_191866d88cb_-32f,5220280,São Patrício - GO,1440,1682,242,2136,67.42,78.75,11.33
sidra_9541_PercMoradDPPOColetTot_munic_22_pol.fid-703dc0a5_191866d88cb_-32e,5220405,São Simão - GO,16261,16634,373,16978,95.78,97.97,2.2
sidra_9541_PercMoradDPPOColetTot_munic_22_pol.fid-703dc0a5_191866d88cb_-32d,5220454,Senador Canedo - GO,148682,154337,5655,155345,95.71,99.35,3.64
sidra_9541_PercMoradDPPOColetTot_munic_22_pol.fid-703dc0a5_191866d88cb_-32c,5220504,Serranópolis - GO,6460,6753,293,7933,81.43,85.13,3.69
sidra_9541_PercMoradDPPOColetTot_munic_22_pol.fid-703dc0a5_191866d88cb_-32b,5220603,Silvânia - GO,14549,16931,2382,22098,65.84,76.62,10.78
sidra_9541_PercMoradDPPOColetTot_munic_22_pol.fid-703dc0a5_191866d88cb_-32a,5220686,Simolândia - GO,4827,4867,40,5725,84.31,85.01,0.7
sidra_9541_PercMoradDPPOColetTot_munic_22_pol.fid-703dc0a5_191866d88cb_-329,5220702,Sítio d'Abadia - GO,1269,1638,369,2914,43.55,56.21,12.66
sidra_9541_PercMoradDPPOColetTot_munic_22_pol.fid-703dc0a5_191866d88cb_-328,5221007,Taquaral de Goiás - GO,3348,3803,455,4018,83.33,94.65,11.32
sidra_9541_PercMoradDPPOColetTot_munic_22_pol.fid-703dc0a5_191866d88cb_-327,5221080,Teresina de Goiás - GO,1732,1896,164,2698,64.2,70.27,6.08
sidra_9541_PercMoradDPPOColetTot_munic_22_pol.fid-703dc0a5_191866d88cb_-326,5221197,Terezópolis de Goiás - GO,7655,7679,24,7935,96.47,96.77,0.3
sidra_9541_PercMoradDPPOColetTot_munic_22_pol.fid-703dc0a5_191866d88cb_-325,5221304,Três Ranchos - GO,2643,2805,162,2914,90.7,96.26,5.56
sidra_9541_PercMoradDPPOColetTot_munic_22_pol.fid-703dc0a5_191866d88cb_-324,5221403,Trindade - GO,137586,139976,2390,141568,97.19,98.88,1.69
sidra_9541_PercMoradDPPOColetTot_munic_22_pol.fid-703dc0a5_191866d88cb_-322,5221452,Trombas - GO,2096,2105,9,3116,67.27,67.55,0.29
sidra_9541_PercMoradDPPOColetTot_munic_22_pol.fid-703dc0a5_191866d88cb_-321,5221502,Turvânia - GO,3743,3873,130,4470,83.74,86.64,2.91
sidra_9541_PercMoradDPPOColetTot_munic_22_pol.fid-703dc0a5_191866d88cb_-320,5221551,Turvelândia - GO,4112,4127,15,4985,82.49,82.79,0.3
sidra_9541_PercMoradDPPOColetTot_munic_22_pol.fid-703dc0a5_191866d88cb_-31f,5221577,Uirapuru - GO,1879,2013,134,2797,67.18,71.97,4.79
sidra_9541_PercMoradDPPOColetTot_munic_22_pol.fid-703dc0a5_191866d88cb_-31e,5221601,Uruaçu - GO,38896,39371,475,42343,91.86,92.98,1.12
sidra_9541_PercMoradDPPOColetTot_munic_22_pol.fid-703dc0a5_191866d88cb_-31d,5221700,Uruana - GO,11567,12258,691,13620,84.93,90,5.07
sidra_9541_PercMoradDPPOColetTot_munic_22_pol.fid-703dc0a5_191866d88cb_-31c,4308607,Garibaldi - RS,32643,34170,1527,34279,95.23,99.68,4.45
sidra_9541_PercMoradDPPOColetTot_munic_22_pol.fid-703dc0a5_191866d88cb_-31b,4309126,Gramado dos Loureiros - RS,1936,1943,7,2014,96.13,96.47,0.35
sidra_9541_PercMoradDPPOColetTot_munic_22_pol.fid-703dc0a5_191866d88cb_-31a,4309159,Gramado Xavier - RS,1810,1985,175,3303,54.8,60.1,5.3
sidra_9541_PercMoradDPPOColetTot_munic_22_pol.fid-703dc0a5_191866d88cb_-319,4309209,Gravataí - RS,258638,263164,4526,264325,97.85,99.56,1.71
sidra_9541_PercMoradDPPOColetTot_munic_22_pol.fid-703dc0a5_191866d88cb_-318,4309258,Guabiju - RS,1276,1286,10,1414,90.24,90.95,0.71
sidra_9541_PercMoradDPPOColetTot_munic_22_pol.fid-703dc0a5_191866d88cb_-317,4309308,Guaíba - RS,85514,92086,6572,92642,92.31,99.4,7.09
sidra_9541_PercMoradDPPOColetTot_munic_22_pol.fid-703dc0a5_191866d88cb_-316,5221809,Urutaí - GO,2672,2872,200,3547,75.33,80.97,5.64
sidra_9541_PercMoradDPPOColetTot_munic_22_pol.fid-703dc0a5_191866d88cb_-314,5221858,Valparaíso de Goiás - GO,171481,197273,25792,198531,86.37,99.37,12.99
sidra_9541_PercMoradDPPOColetTot_munic_22_pol.fid-703dc0a5_191866d88cb_-313,5221908,Varjão - GO,2445,2812,367,3716,65.8,75.67,9.88
sidra_9541_PercMoradDPPOColetTot_munic_22_pol.fid-703dc0a5_191866d88cb_-312,5222005,Vianópolis - GO,12342,12679,337,14889,82.89,85.16,2.26
sidra_9541_PercMoradDPPOColetTot_munic_22_pol.fid-703dc0a5_191866d88cb_-311,5222054,Vicentinópolis - GO,7979,8060,81,8665,92.08,93.02,0.93
sidra_9541_PercMoradDPPOColetTot_munic_22_pol.fid-703dc0a5_191866d88cb_-310,5222203,Vila Boa - GO,3491,3491,,4181,83.5,83.5,
sidra_9541_PercMoradDPPOColetTot_munic_22_pol.fid-703dc0a5_191866d88cb_-30f,5222302,Vila Propício - GO,3552,3738,186,5808,61.16,64.36,3.2
sidra_9541_PercMoradDPPOColetTot_munic_22_pol.fid-703dc0a5_191866d88cb_-30e,4308656,Garruchos - RS,1277,1330,53,2684,47.58,49.55,1.97
sidra_9541_PercMoradDPPOColetTot_munic_22_pol.fid-703dc0a5_191866d88cb_-30d,4308706,Gaurama - RS,4830,4846,16,5579,86.57,86.86,0.29
sidra_9541_PercMoradDPPOColetTot_munic_22_pol.fid-703dc0a5_191866d88cb_-30c,5300108,Brasília - DF,2402496,2760405,357909,2792811,86.02,98.84,12.82
sidra_9541_PercMoradDPPOColetTot_munic_22_pol.fid-703dc0a5_191866d88cb_-30b,4308854,Gentil - RS,398,1476,1078,1744,22.82,84.63,61.81
sidra_9541_PercMoradDPPOColetTot_munic_22_pol.fid-703dc0a5_191866d88cb_-30a,4308904,Getúlio Vargas - RS,14892,15185,293,16433,90.62,92.41,1.78
sidra_9541_PercMoradDPPOColetTot_munic_22_pol.fid-703dc0a5_191866d88cb_-309,4309001,Giruá - RS,13140,13270,130,15927,82.5,83.32,0.82
sidra_9541_PercMoradDPPOColetTot_munic_22_pol.fid-703dc0a5_191866d88cb_-308,4309050,Glorinha - RS,7341,7513,172,7654,95.91,98.16,2.25
sidra_9541_PercMoradDPPOColetTot_munic_22_pol.fid-703dc0a5_191866d88cb_-307,4309100,Gramado - RS,36084,39947,3863,40024,90.16,99.81,9.65
sidra_9541_PercMoradDPPOColetTot_munic_22_pol.fid-703dc0a5_191866d88cb_-306,4309571,Herveiras - RS,1705,1818,113,2538,67.18,71.63,4.45
sidra_9541_PercMoradDPPOColetTot_munic_22_pol.fid-703dc0a5_191866d88cb_-305,4309605,Horizontina - RS,16982,17737,755,18788,90.39,94.41,4.02
sidra_9541_PercMoradDPPOColetTot_munic_22_pol.fid-703dc0a5_191866d88cb_-304,4309654,Hulha Negra - RS,3173,4188,1015,5974,53.11,70.1,16.99
sidra_9541_PercMoradDPPOColetTot_munic_22_pol.fid-703dc0a5_191866d88cb_-303,4309704,Humaitá - RS,3938,4203,265,4680,84.15,89.81,5.66
sidra_9541_PercMoradDPPOColetTot_munic_22_pol.fid-703dc0a5_191866d88cb_-302,4309753,Ibarama - RS,2988,3005,17,3730,80.11,80.56,0.46
sidra_9541_PercMoradDPPOColetTot_munic_22_pol.fid-703dc0a5_191866d88cb_-301,4309803,Ibiaçá - RS,3281,3561,280,4408,74.43,80.78,6.35
sidra_9541_PercMoradDPPOColetTot_munic_22_pol.fid-703dc0a5_191866d88cb_-300,4309902,Ibiraiaras - RS,5607,6191,584,6776,82.75,91.37,8.62
sidra_9541_PercMoradDPPOColetTot_munic_22_pol.fid-703dc0a5_191866d88cb_-2ff,4309951,Ibirapuitã - RS,2687,2748,61,3723,72.17,73.81,1.64
sidra_9541_PercMoradDPPOColetTot_munic_22_pol.fid-703dc0a5_191866d88cb_-2fe,4310009,Ibirubá - RS,17892,18394,502,21491,83.25,85.59,2.34
sidra_9541_PercMoradDPPOColetTot_munic_22_pol.fid-703dc0a5_191866d88cb_-2fd,4310108,Igrejinha - RS,32083,32545,462,32666,98.22,99.63,1.41
sidra_9541_PercMoradDPPOColetTot_munic_22_pol.fid-703dc0a5_191866d88cb_-2fc,4310207,Ijuí - RS,76621,79110,2489,83879,91.35,94.31,2.97
sidra_9541_PercMoradDPPOColetTot_munic_22_pol.fid-703dc0a5_191866d88cb_-2fb,4310306,Ilópolis - RS,3845,3855,10,4124,93.23,93.48,0.24
sidra_9541_PercMoradDPPOColetTot_munic_22_pol.fid-703dc0a5_191866d88cb_-2fa,4310330,Imbé - RS,26682,26739,57,26765,99.69,99.9,0.21
sidra_9541_PercMoradDPPOColetTot_munic_22_pol.fid-703dc0a5_191866d88cb_-2f9,4310538,Itaara - RS,1844,5365,3521,5541,33.28,96.82,63.54
sidra_9541_PercMoradDPPOColetTot_munic_22_pol.fid-703dc0a5_191866d88cb_-2f8,4310553,Itacurubi - RS,702,1454,752,2990,23.48,48.63,25.15
sidra_9541_PercMoradDPPOColetTot_munic_22_pol.fid-703dc0a5_191866d88cb_-2f7,4312005,Mariano Moro - RS,1735,1739,4,1858,93.38,93.6,0.22
sidra_9541_PercMoradDPPOColetTot_munic_22_pol.fid-703dc0a5_191866d88cb_-2f6,4310579,Itapuca - RS,1593,1597,4,1937,82.24,82.45,0.21
sidra_9541_PercMoradDPPOColetTot_munic_22_pol.fid-703dc0a5_191866d88cb_-2f5,4310603,Itaqui - RS,30319,32574,2255,35571,85.24,91.57,6.34
sidra_9541_PercMoradDPPOColetTot_munic_22_pol.fid-703dc0a5_191866d88cb_-2f4,4310652,Itati - RS,2475,2566,91,2629,94.14,97.6,3.46
sidra_9541_PercMoradDPPOColetTot_munic_22_pol.fid-703dc0a5_191866d88cb_-2f2,4310702,Itatiba do Sul - RS,2412,2416,4,3188,75.66,75.78,0.13
sidra_9541_PercMoradDPPOColetTot_munic_22_pol.fid-703dc0a5_191866d88cb_-2f1,4310751,Ivorá - RS,1571,1670,99,1916,81.99,87.16,5.17
sidra_9541_PercMoradDPPOColetTot_munic_22_pol.fid-703dc0a5_191866d88cb_-2f0,4312054,Marques de Souza - RS,2445,3767,1322,3968,61.62,94.93,33.32
sidra_9541_PercMoradDPPOColetTot_munic_22_pol.fid-703dc0a5_191866d88cb_-2ef,4312104,Mata - RS,3966,4053,87,4669,84.94,86.81,1.86
sidra_9541_PercMoradDPPOColetTot_munic_22_pol.fid-703dc0a5_191866d88cb_-2ee,4312138,Mato Castelhano - RS,1938,2119,181,2442,79.36,86.77,7.41
sidra_9541_PercMoradDPPOColetTot_munic_22_pol.fid-703dc0a5_191866d88cb_-2ed,4311130,Jari - RS,943,1252,309,3348,28.17,37.4,9.23
sidra_9541_PercMoradDPPOColetTot_munic_22_pol.fid-703dc0a5_191866d88cb_-2ec,4311155,Jóia - RS,2976,3135,159,7166,41.53,43.75,2.22
sidra_9541_PercMoradDPPOColetTot_munic_22_pol.fid-703dc0a5_191866d88cb_-2eb,4311205,Júlio de Castilhos - RS,14952,16275,1323,18086,82.67,89.99,7.32
sidra_9541_PercMoradDPPOColetTot_munic_22_pol.fid-703dc0a5_191866d88cb_-2ea,4311239,Lagoa Bonita do Sul - RS,1689,1704,15,2248,75.13,75.8,0.67
sidra_9541_PercMoradDPPOColetTot_munic_22_pol.fid-703dc0a5_191866d88cb_-2e9,4311254,Lagoão - RS,1991,2181,190,5337,37.31,40.87,3.56
sidra_9541_PercMoradDPPOColetTot_munic_22_pol.fid-703dc0a5_191866d88cb_-2e8,4311270,Lagoa dos Três Cantos - RS,1438,1646,208,1731,83.07,95.09,12.02
sidra_9541_PercMoradDPPOColetTot_munic_22_pol.fid-703dc0a5_191866d88cb_-2e7,4311304,Lagoa Vermelha - RS,25486,26482,996,27406,92.99,96.63,3.63
sidra_9541_PercMoradDPPOColetTot_munic_22_pol.fid-703dc0a5_191866d88cb_-2e6,4311403,Lajeado - RS,85150,92714,7564,93021,91.54,99.67,8.13
sidra_9541_PercMoradDPPOColetTot_munic_22_pol.fid-703dc0a5_191866d88cb_-2e5,4311429,Lajeado do Bugre - RS,1183,1249,66,2598,45.54,48.08,2.54
sidra_9541_PercMoradDPPOColetTot_munic_22_pol.fid-703dc0a5_191866d88cb_-2e4,4311502,Lavras do Sul - RS,5938,6199,261,7082,83.85,87.53,3.69
sidra_9541_PercMoradDPPOColetTot_munic_22_pol.fid-703dc0a5_191866d88cb_-2e3,4311601,Liberato Salzano - RS,3642,3692,50,4778,76.22,77.27,1.05
sidra_9541_PercMoradDPPOColetTot_munic_22_pol.fid-703dc0a5_191866d88cb_-2e2,4311627,Lindolfo Collor - RS,6186,6224,38,6233,99.25,99.86,0.61
sidra_9541_PercMoradDPPOColetTot_munic_22_pol.fid-703dc0a5_191866d88cb_-2e1,4312385,Monte Belo do Sul - RS,2522,2525,3,2557,98.63,98.75,0.12
sidra_9541_PercMoradDPPOColetTot_munic_22_pol.fid-703dc0a5_191866d88cb_-2e0,4312401,Montenegro - RS,59501,62014,2513,62372,95.4,99.43,4.03
sidra_9541_PercMoradDPPOColetTot_munic_22_pol.fid-703dc0a5_191866d88cb_-2df,4311718,Maçambará - RS,2359,2410,51,4425,53.31,54.46,1.15
sidra_9541_PercMoradDPPOColetTot_munic_22_pol.fid-703dc0a5_191866d88cb_-2de,4311734,Mampituba - RS,3043,3059,16,3125,97.38,97.89,0.51
sidra_9541_PercMoradDPPOColetTot_munic_22_pol.fid-703dc0a5_191866d88cb_-2dd,4311908,Marcelino Ramos - RS,3430,3536,106,4305,79.67,82.14,2.46
sidra_9541_PercMoradDPPOColetTot_munic_22_pol.fid-703dc0a5_191866d88cb_-2dc,4311981,Mariana Pimentel - RS,929,3713,2784,3907,23.78,95.03,71.26
sidra_9541_PercMoradDPPOColetTot_munic_22_pol.fid-703dc0a5_191866d88cb_-2db,4312153,Mato Leitão - RS,4784,4794,10,4843,98.78,98.99,0.21
sidra_9541_PercMoradDPPOColetTot_munic_22_pol.fid-703dc0a5_191866d88cb_-2da,4312179,Mato Queimado - RS,980,1407,427,1788,54.81,78.69,23.88
sidra_9541_PercMoradDPPOColetTot_munic_22_pol.fid-703dc0a5_191866d88cb_-2d9,4312450,Morro Redondo - RS,4736,5060,324,6035,78.48,83.84,5.37
sidra_9541_PercMoradDPPOColetTot_munic_22_pol.fid-703dc0a5_191866d88cb_-2d8,4312203,Maximiliano de Almeida - RS,3384,3741,357,4186,80.84,89.37,8.53
sidra_9541_PercMoradDPPOColetTot_munic_22_pol.fid-703dc0a5_191866d88cb_-2d7,4312252,Minas do Leão - RS,7250,7409,159,7502,96.64,98.76,2.12
sidra_9541_PercMoradDPPOColetTot_munic_22_pol.fid-703dc0a5_191866d88cb_-2d6,4312302,Miraguaí - RS,2250,3014,764,4427,50.82,68.08,17.26
sidra_9541_PercMoradDPPOColetTot_munic_22_pol.fid-703dc0a5_191866d88cb_-2d5,4312476,Morro Reuter - RS,5978,5999,21,6022,99.27,99.62,0.35
sidra_9541_PercMoradDPPOColetTot_munic_22_pol.fid-703dc0a5_191866d88cb_-2d4,4312351,Montauri - RS,1385,1456,71,1493,92.77,97.52,4.76
sidra_9541_PercMoradDPPOColetTot_munic_22_pol.fid-703dc0a5_191866d88cb_-2d3,4312377,Monte Alegre dos Campos - RS,1176,2191,1015,3180,36.98,68.9,31.92
sidra_9541_PercMoradDPPOColetTot_munic_22_pol.fid-703dc0a5_191866d88cb_-2d2,4312427,Mormaço - RS,2474,2484,10,2754,89.83,90.2,0.36
sidra_9541_PercMoradDPPOColetTot_munic_22_pol.fid-703dc0a5_191866d88cb_-2d1,4312443,Morrinhos do Sul - RS,3011,3021,10,3070,98.08,98.4,0.33
sidra_9541_PercMoradDPPOColetTot_munic_22_pol.fid-703dc0a5_191866d88cb_-2d0,4312500,Mostardas - RS,9459,11111,1652,12076,78.33,92.01,13.68
sidra_9541_PercMoradDPPOColetTot_munic_22_pol.fid-703dc0a5_191866d88cb_-2cf,4312658,Não-Me-Toque - RS,16606,16857,251,17797,93.31,94.72,1.41
sidra_9541_PercMoradDPPOColetTot_munic_22_pol.fid-703dc0a5_191866d88cb_-2ce,4312674,Nicolau Vergueiro - RS,1391,1624,233,1924,72.3,84.41,12.11
sidra_9541_PercMoradDPPOColetTot_munic_22_pol.fid-703dc0a5_191866d88cb_-2cd,4312708,Nonoai - RS,10285,11556,1271,13660,75.29,84.6,9.3
sidra_9541_PercMoradDPPOColetTot_munic_22_pol.fid-703dc0a5_191866d88cb_-2cc,4312757,Nova Alvorada - RS,959,2865,1906,3163,30.32,90.58,60.26
sidra_9541_PercMoradDPPOColetTot_munic_22_pol.fid-703dc0a5_191866d88cb_-2cb,4312807,Nova Araçá - RS,742,4929,4187,4954,14.98,99.5,84.52
sidra_9541_PercMoradDPPOColetTot_munic_22_pol.fid-703dc0a5_191866d88cb_-2ca,4312906,Nova Bassano - RS,5689,9554,3865,9606,59.22,99.46,40.24
sidra_9541_PercMoradDPPOColetTot_munic_22_pol.fid-703dc0a5_191866d88cb_-2c9,4312955,Nova Boa Vista - RS,1005,1308,303,2042,49.22,64.05,14.84
sidra_9541_PercMoradDPPOColetTot_munic_22_pol.fid-703dc0a5_191866d88cb_-2c8,4313003,Nova Bréscia - RS,2877,2890,13,3044,94.51,94.94,0.43
sidra_9541_PercMoradDPPOColetTot_munic_22_pol.fid-703dc0a5_191866d88cb_-2c7,4313011,Nova Candelária - RS,2565,2651,86,3061,83.8,86.61,2.81
sidra_9541_PercMoradDPPOColetTot_munic_22_pol.fid-703dc0a5_191866d88cb_-2c6,4313037,Nova Esperança do Sul - RS,4219,4543,324,4863,86.76,93.42,6.66
sidra_9541_PercMoradDPPOColetTot_munic_22_pol.fid-703dc0a5_191866d88cb_-2c5,4313060,Nova Hartz - RS,19303,19974,671,20039,96.33,99.68,3.35
sidra_9541_PercMoradDPPOColetTot_munic_22_pol.fid-703dc0a5_191866d88cb_-2c4,4313086,Nova Pádua - RS,1492,2233,741,2343,63.68,95.31,31.63
sidra_9541_PercMoradDPPOColetTot_munic_22_pol.fid-703dc0a5_191866d88cb_-2c3,4313102,Nova Palma - RS,3517,5160,1643,5584,62.98,92.41,29.42
sidra_9541_PercMoradDPPOColetTot_munic_22_pol.fid-703dc0a5_191866d88cb_-2c2,4313201,Nova Petrópolis - RS,21148,22751,1603,23109,91.51,98.45,6.94
sidra_9541_PercMoradDPPOColetTot_munic_22_pol.fid-703dc0a5_191866d88cb_-2c1,4313300,Nova Prata - RS,23626,25331,1705,25552,92.46,99.14,6.67
sidra_9541_PercMoradDPPOColetTot_munic_22_pol.fid-703dc0a5_191866d88cb_-2bf,4313375,Nova Santa Rita - RS,28397,28749,352,28982,97.98,99.2,1.21
sidra_9541_PercMoradDPPOColetTot_munic_22_pol.fid-703dc0a5_191866d88cb_-2be,4313391,Novo Cabrais - RS,3390,3466,76,3560,95.22,97.36,2.13
sidra_9541_PercMoradDPPOColetTot_munic_22_pol.fid-703dc0a5_191866d88cb_-2bd,4313409,Novo Hamburgo - RS,215354,226041,10687,226453,95.1,99.82,4.72
sidra_9541_PercMoradDPPOColetTot_munic_22_pol.fid-703dc0a5_191866d88cb_-2bc,4313425,Novo Machado - RS,2468,2472,4,3179,77.63,77.76,0.13
sidra_9541_PercMoradDPPOColetTot_munic_22_pol.fid-703dc0a5_191866d88cb_-2bb,4313953,Pantano Grande - RS,9499,9610,111,10185,93.26,94.35,1.09
sidra_9541_PercMoradDPPOColetTot_munic_22_pol.fid-703dc0a5_191866d88cb_-2ba,4314001,Paraí - RS,5856,7182,1326,7194,81.4,99.83,18.43
sidra_9541_PercMoradDPPOColetTot_munic_22_pol.fid-703dc0a5_191866d88cb_-2b9,4314027,Paraíso do Sul - RS,4713,5905,1192,6468,72.87,91.3,18.43
sidra_9541_PercMoradDPPOColetTot_munic_22_pol.fid-703dc0a5_191866d88cb_-2b8,4314035,Pareci Novo - RS,4059,4276,217,4297,94.46,99.51,5.05
sidra_9541_PercMoradDPPOColetTot_munic_22_pol.fid-703dc0a5_191866d88cb_-2b7,4314050,Parobé - RS,50549,51491,942,51863,97.47,99.28,1.82
sidra_9541_PercMoradDPPOColetTot_munic_22_pol.fid-703dc0a5_191866d88cb_-2b6,4314068,Passa Sete - RS,1962,2040,78,3956,49.6,51.57,1.97
sidra_9541_PercMoradDPPOColetTot_munic_22_pol.fid-703dc0a5_191866d88cb_-2b5,4314548,Pinto Bandeira - RS,1718,2523,805,2693,63.8,93.69,29.89
sidra_9541_PercMoradDPPOColetTot_munic_22_pol.fid-703dc0a5_191866d88cb_-2b4,4314555,Pirapó - RS,842,1957,1115,2247,37.47,87.09,49.62
sidra_9541_PercMoradDPPOColetTot_munic_22_pol.fid-703dc0a5_191866d88cb_-2b3,4314605,Piratini - RS,9579,12442,2863,17472,54.82,71.21,16.39
sidra_9541_PercMoradDPPOColetTot_munic_22_pol.fid-703dc0a5_191866d88cb_-2b2,4314704,Planalto - RS,7410,7526,116,10397,71.27,72.39,1.12
sidra_9541_PercMoradDPPOColetTot_munic_22_pol.fid-703dc0a5_191866d88cb_-2b1,4314753,Poço das Antas - RS,144,2161,2017,2171,6.63,99.54,92.91
sidra_9541_PercMoradDPPOColetTot_munic_22_pol.fid-703dc0a5_191866d88cb_-2b0,4314779,Pontão - RS,1784,2063,279,3296,54.13,62.59,8.46
sidra_9541_PercMoradDPPOColetTot_munic_22_pol.fid-703dc0a5_191866d88cb_-2af,4315149,Presidente Lucena - RS,3067,3077,10,3077,99.68,100,0.32
sidra_9541_PercMoradDPPOColetTot_munic_22_pol.fid-703dc0a5_191866d88cb_-2ae,4315156,Progresso - RS,3530,3975,445,5340,66.1,74.44,8.33
sidra_9541_PercMoradDPPOColetTot_munic_22_pol.fid-703dc0a5_191866d88cb_-2ad,4315172,Protásio Alves - RS,1903,1919,16,2025,93.98,94.77,0.79
sidra_9541_PercMoradDPPOColetTot_munic_22_pol.fid-703dc0a5_191866d88cb_-2ac,4315206,Putinga - RS,2894,2919,25,3747,77.24,77.9,0.67
sidra_9541_PercMoradDPPOColetTot_munic_22_pol.fid-703dc0a5_191866d88cb_-2ab,4315305,Quaraí - RS,17749,22100,4351,23356,75.99,94.62,18.63
sidra_9541_PercMoradDPPOColetTot_munic_22_pol.fid-703dc0a5_191866d88cb_-2aa,4315313,Quatro Irmãos - RS,1088,1102,14,1552,70.1,71.01,0.9
sidra_9541_PercMoradDPPOColetTot_munic_22_pol.fid-703dc0a5_191866d88cb_-2a9,4315321,Quevedos - RS,695,1644,949,2501,27.79,65.73,37.94
sidra_9541_PercMoradDPPOColetTot_munic_22_pol.fid-703dc0a5_191866d88cb_-2a8,4315354,Quinze de Novembro - RS,2654,3793,1139,3898,68.09,97.31,29.22
sidra_9541_PercMoradDPPOColetTot_munic_22_pol.fid-703dc0a5_191866d88cb_-2a7,4315404,Redentora - RS,3949,4293,344,9722,40.62,44.16,3.54
sidra_9541_PercMoradDPPOColetTot_munic_22_pol.fid-703dc0a5_191866d88cb_-2a6,4315453,Relvado - RS,1303,1594,291,1783,73.08,89.4,16.32
sidra_9541_PercMoradDPPOColetTot_munic_22_pol.fid-703dc0a5_191866d88cb_-2a5,4315503,Restinga Sêca - RS,13489,14438,949,14890,90.59,96.96,6.37
sidra_9541_PercMoradDPPOColetTot_munic_22_pol.fid-703dc0a5_191866d88cb_-2a4,4315800,Roca Sales - RS,9569,10021,452,10351,92.45,96.81,4.37
sidra_9541_PercMoradDPPOColetTot_munic_22_pol.fid-703dc0a5_191866d88cb_-2a3,4315909,Rodeio Bonito - RS,5685,6041,356,6647,85.53,90.88,5.36
sidra_9541_PercMoradDPPOColetTot_munic_22_pol.fid-703dc0a5_191866d88cb_-2a2,4315958,Rolador - RS,1402,1578,176,2288,61.28,68.97,7.69
sidra_9541_PercMoradDPPOColetTot_munic_22_pol.fid-703dc0a5_191866d88cb_-2a1,4316006,Rolante - RS,19285,20695,1410,21219,90.89,97.53,6.64
sidra_9541_PercMoradDPPOColetTot_munic_22_pol.fid-703dc0a5_191866d88cb_-2a0,4316105,Ronda Alta - RS,8265,8781,516,9731,84.93,90.24,5.3
sidra_9541_PercMoradDPPOColetTot_munic_22_pol.fid-703dc0a5_191866d88cb_-29f,4317954,Santo Expedito do Sul - RS,43,1301,1258,2349,1.83,55.39,53.55
sidra_9541_PercMoradDPPOColetTot_munic_22_pol.fid-703dc0a5_191866d88cb_-29e,4318002,São Borja - RS,53355,54163,808,59172,90.17,91.53,1.37
sidra_9541_PercMoradDPPOColetTot_munic_22_pol.fid-703dc0a5_191866d88cb_-29d,4316204,Rondinha - RS,3233,3364,131,4980,64.92,67.55,2.63
sidra_9541_PercMoradDPPOColetTot_munic_22_pol.fid-703dc0a5_191866d88cb_-29c,4316303,Roque Gonzales - RS,5208,5456,248,6562,79.37,83.15,3.78
sidra_9541_PercMoradDPPOColetTot_munic_22_pol.fid-703dc0a5_191866d88cb_-29a,4316402,Rosário do Sul - RS,30879,33260,2381,36414,84.8,91.34,6.54
sidra_9541_PercMoradDPPOColetTot_munic_22_pol.fid-703dc0a5_191866d88cb_-299,4316428,Sagrada Família - RS,1436,1650,214,2480,57.9,66.53,8.63
sidra_9541_PercMoradDPPOColetTot_munic_22_pol.fid-703dc0a5_191866d88cb_-298,4316436,Saldanha Marinho - RS,1956,2376,420,2565,76.26,92.63,16.37
sidra_9541_PercMoradDPPOColetTot_munic_22_pol.fid-703dc0a5_191866d88cb_-297,4316451,Salto do Jacuí - RS,8755,8798,43,10148,86.27,86.7,0.42
sidra_9541_PercMoradDPPOColetTot_munic_22_pol.fid-703dc0a5_191866d88cb_-296,4320651,Silveira Martins - RS,1698,1945,247,2019,84.1,96.33,12.23
sidra_9541_PercMoradDPPOColetTot_munic_22_pol.fid-703dc0a5_191866d88cb_-295,4320677,Sinimbu - RS,5754,6925,1171,8558,67.24,80.92,13.68
sidra_9541_PercMoradDPPOColetTot_munic_22_pol.fid-703dc0a5_191866d88cb_-294,4320701,Sobradinho - RS,13011,13076,65,14053,92.59,93.05,0.46
sidra_9541_PercMoradDPPOColetTot_munic_22_pol.fid-703dc0a5_191866d88cb_-293,4320800,Soledade - RS,26064,26950,886,29769,87.55,90.53,2.98
sidra_9541_PercMoradDPPOColetTot_munic_22_pol.fid-703dc0a5_191866d88cb_-292,4316477,Salvador das Missões - RS,2780,2780,,2871,96.83,96.83,
sidra_9541_PercMoradDPPOColetTot_munic_22_pol.fid-703dc0a5_191866d88cb_-291,4316501,Salvador do Sul - RS,5051,6736,1685,6860,73.63,98.19,24.56
sidra_9541_PercMoradDPPOColetTot_munic_22_pol.fid-703dc0a5_191866d88cb_-290,4316600,Sananduva - RS,12384,13451,1067,16382,75.6,82.11,6.51
sidra_9541_PercMoradDPPOColetTot_munic_22_pol.fid-703dc0a5_191866d88cb_-28f,4316709,Santa Bárbara do Sul - RS,6765,7323,558,8116,83.35,90.23,6.88
sidra_9541_PercMoradDPPOColetTot_munic_22_pol.fid-703dc0a5_191866d88cb_-28e,4317756,Santo Antônio do Planalto - RS,1953,1974,21,2089,93.49,94.49,1.01
sidra_9541_PercMoradDPPOColetTot_munic_22_pol.fid-703dc0a5_191866d88cb_-28d,4317806,Santo Augusto - RS,12460,12999,539,13897,89.66,93.54,3.88
sidra_9541_PercMoradDPPOColetTot_munic_22_pol.fid-703dc0a5_191866d88cb_-28c,4317905,Santo Cristo - RS,12118,13434,1316,15271,79.35,87.97,8.62
sidra_9541_PercMoradDPPOColetTot_munic_22_pol.fid-703dc0a5_191866d88cb_-28b,4320859,Tabaí - RS,4211,4244,33,4461,94.4,95.14,0.74
sidra_9541_PercMoradDPPOColetTot_munic_22_pol.fid-703dc0a5_191866d88cb_-28a,4320909,Tapejara - RS,21165,24096,2931,24493,86.41,98.38,11.97
sidra_9541_PercMoradDPPOColetTot_munic_22_pol.fid-703dc0a5_191866d88cb_-289,4321006,Tapera - RS,6051,10122,4071,10560,57.3,95.85,38.55
sidra_9541_PercMoradDPPOColetTot_munic_22_pol.fid-703dc0a5_191866d88cb_-288,4318051,São Domingos do Sul - RS,2243,2722,479,2749,81.59,99.02,17.42
sidra_9541_PercMoradDPPOColetTot_munic_22_pol.fid-703dc0a5_191866d88cb_-287,4318101,São Francisco de Assis - RS,13146,13955,809,17532,74.98,79.6,4.61
sidra_9541_PercMoradDPPOColetTot_munic_22_pol.fid-703dc0a5_191866d88cb_-286,4318200,São Francisco de Paula - RS,17732,20246,2514,21108,84.01,95.92,11.91
sidra_9541_PercMoradDPPOColetTot_munic_22_pol.fid-703dc0a5_191866d88cb_-285,4318309,São Gabriel - RS,50628,53190,2562,58110,87.12,91.53,4.41
sidra_9541_PercMoradDPPOColetTot_munic_22_pol.fid-703dc0a5_191866d88cb_-284,4318408,São Jerônimo - RS,10454,17921,7467,20912,49.99,85.7,35.71
sidra_9541_PercMoradDPPOColetTot_munic_22_pol.fid-703dc0a5_191866d88cb_-283,4318424,São João da Urtiga - RS,3628,3889,261,4461,81.33,87.18,5.85
sidra_9541_PercMoradDPPOColetTot_munic_22_pol.fid-703dc0a5_191866d88cb_-282,4318432,São João do Polêsine - RS,2501,2574,73,2617,95.57,98.36,2.79
sidra_9541_PercMoradDPPOColetTot_munic_22_pol.fid-703dc0a5_191866d88cb_-281,4318440,São Jorge - RS,2509,2865,356,2909,86.25,98.49,12.24
sidra_9541_PercMoradDPPOColetTot_munic_22_pol.fid-703dc0a5_191866d88cb_-280,4318457,São José das Missões - RS,1366,1370,4,2362,57.83,58,0.17
sidra_9541_PercMoradDPPOColetTot_munic_22_pol.fid-703dc0a5_191866d88cb_-27f,4318465,São José do Herval - RS,1226,1591,365,1902,64.46,83.65,19.19
sidra_9541_PercMoradDPPOColetTot_munic_22_pol.fid-703dc0a5_191866d88cb_-27e,4318481,São José do Hortêncio - RS,4410,4410,,4444,99.23,99.23,
sidra_9541_PercMoradDPPOColetTot_munic_22_pol.fid-703dc0a5_191866d88cb_-27d,4318499,São José do Inhacorá - RS,2113,2142,29,2406,87.82,89.03,1.21
sidra_9541_PercMoradDPPOColetTot_munic_22_pol.fid-703dc0a5_191866d88cb_-27c,4318507,São José do Norte - RS,21910,24368,2458,25361,86.39,96.08,9.69
sidra_9541_PercMoradDPPOColetTot_munic_22_pol.fid-703dc0a5_191866d88cb_-27b,4318606,São José do Ouro - RS,4746,5781,1035,6834,69.45,84.59,15.14
sidra_9541_PercMoradDPPOColetTot_munic_22_pol.fid-703dc0a5_191866d88cb_-27a,4318614,São José do Sul - RS,1929,2326,397,2356,81.88,98.73,16.85
sidra_9541_PercMoradDPPOColetTot_munic_22_pol.fid-703dc0a5_191866d88cb_-279,4318622,São José dos Ausentes - RS,2447,3830,1383,4159,58.84,92.09,33.25
sidra_9541_PercMoradDPPOColetTot_munic_22_pol.fid-703dc0a5_191866d88cb_-278,4318705,São Leopoldo - RS,208359,214476,6117,216263,96.35,99.17,2.83
sidra_9541_PercMoradDPPOColetTot_munic_22_pol.fid-703dc0a5_191866d88cb_-277,4318804,São Lourenço do Sul - RS,21762,29006,7244,41882,51.96,69.26,17.3
sidra_9541_PercMoradDPPOColetTot_munic_22_pol.fid-703dc0a5_191866d88cb_-276,4318903,São Luiz Gonzaga - RS,31744,32642,898,34455,92.13,94.74,2.61
sidra_9541_PercMoradDPPOColetTot_munic_22_pol.fid-703dc0a5_191866d88cb_-275,4319000,São Marcos - RS,19286,20612,1326,21072,91.52,97.82,6.29
sidra_9541_PercMoradDPPOColetTot_munic_22_pol.fid-703dc0a5_191866d88cb_-274,4319109,São Martinho - RS,4143,4368,225,5478,75.63,79.74,4.11
sidra_9541_PercMoradDPPOColetTot_munic_22_pol.fid-703dc0a5_191866d88cb_-273,4319125,São Martinho da Serra - RS,1750,2017,267,2860,61.19,70.52,9.34
sidra_9541_PercMoradDPPOColetTot_munic_22_pol.fid-703dc0a5_191866d88cb_-272,4319158,São Miguel das Missões - RS,4318,4457,139,7043,61.31,63.28,1.97
sidra_9541_PercMoradDPPOColetTot_munic_22_pol.fid-703dc0a5_191866d88cb_-270,4319208,São Nicolau - RS,3479,4194,715,5105,68.15,82.15,14.01
sidra_9541_PercMoradDPPOColetTot_munic_22_pol.fid-703dc0a5_191866d88cb_-26f,4319307,São Paulo das Missões - RS,5063,5072,9,5835,86.77,86.92,0.15
sidra_9541_PercMoradDPPOColetTot_munic_22_pol.fid-703dc0a5_191866d88cb_-26e,4319356,São Pedro da Serra - RS,3380,3535,155,3548,95.26,99.63,4.37
sidra_9541_PercMoradDPPOColetTot_munic_22_pol.fid-703dc0a5_191866d88cb_-26d,4319364,São Pedro das Missões - RS,1123,1187,64,1755,63.99,67.64,3.65
sidra_9541_PercMoradDPPOColetTot_munic_22_pol.fid-703dc0a5_191866d88cb_-26c,4319372,São Pedro do Butiá - RS,2983,2985,2,3069,97.2,97.26,0.07
sidra_9541_PercMoradDPPOColetTot_munic_22_pol.fid-703dc0a5_191866d88cb_-26b,4319406,São Pedro do Sul - RS,11830,13324,1494,15535,76.15,85.77,9.62
sidra_9541_PercMoradDPPOColetTot_munic_22_pol.fid-703dc0a5_191866d88cb_-26a,4319505,São Sebastião do Caí - RS,18830,24159,5329,24311,77.45,99.37,21.92
sidra_9541_PercMoradDPPOColetTot_munic_22_pol.fid-703dc0a5_191866d88cb_-269,4319604,São Sepé - RS,18510,19042,532,21077,87.82,90.34,2.52
sidra_9541_PercMoradDPPOColetTot_munic_22_pol.fid-703dc0a5_191866d88cb_-268,4319703,São Valentim - RS,2600,2600,,3201,81.22,81.22,
sidra_9541_PercMoradDPPOColetTot_munic_22_pol.fid-703dc0a5_191866d88cb_-267,4319711,São Valentim do Sul - RS,2026,2116,90,2204,91.92,96.01,4.08
sidra_9541_PercMoradDPPOColetTot_munic_22_pol.fid-703dc0a5_191866d88cb_-266,4319737,São Valério do Sul - RS,1105,1212,107,2543,43.45,47.66,4.21
sidra_9541_PercMoradDPPOColetTot_munic_22_pol.fid-703dc0a5_191866d88cb_-265,4319752,São Vendelino - RS,2134,2215,81,2251,94.8,98.4,3.6
sidra_9541_PercMoradDPPOColetTot_munic_22_pol.fid-703dc0a5_191866d88cb_-264,4319802,São Vicente do Sul - RS,5910,7163,1253,8036,73.54,89.14,15.59
sidra_9541_PercMoradDPPOColetTot_munic_22_pol.fid-703dc0a5_191866d88cb_-263,4319901,Sapiranga - RS,73278,75015,1737,75328,97.28,99.58,2.31
sidra_9541_PercMoradDPPOColetTot_munic_22_pol.fid-703dc0a5_191866d88cb_-262,4321451,Teutônia - RS,31955,32546,591,32594,98.04,99.85,1.81
sidra_9541_PercMoradDPPOColetTot_munic_22_pol.fid-703dc0a5_191866d88cb_-261,4321469,Tio Hugo - RS,2955,3081,126,3258,90.7,94.57,3.87
sidra_9541_PercMoradDPPOColetTot_munic_22_pol.fid-703dc0a5_191866d88cb_-260,4321477,Tiradentes do Sul - RS,3596,3820,224,5129,70.11,74.48,4.37
sidra_9541_PercMoradDPPOColetTot_munic_22_pol.fid-703dc0a5_191866d88cb_-25f,4321493,Toropi - RS,1586,2181,595,2549,62.22,85.56,23.34
sidra_9541_PercMoradDPPOColetTot_munic_22_pol.fid-703dc0a5_191866d88cb_-25e,4320008,Sapucaia do Sul - RS,121146,131470,10324,131857,91.88,99.71,7.83
sidra_9541_PercMoradDPPOColetTot_munic_22_pol.fid-703dc0a5_191866d88cb_-25d,4320107,Sarandi - RS,18429,21508,3079,22695,81.2,94.77,13.57
sidra_9541_PercMoradDPPOColetTot_munic_22_pol.fid-703dc0a5_191866d88cb_-25c,4320206,Seberi - RS,9126,10024,898,11932,76.48,84.01,7.53
sidra_9541_PercMoradDPPOColetTot_munic_22_pol.fid-703dc0a5_191866d88cb_-25b,4321501,Torres - RS,40315,41420,1105,41501,97.14,99.8,2.66
sidra_9541_PercMoradDPPOColetTot_munic_22_pol.fid-703dc0a5_191866d88cb_-25a,4320230,Sede Nova - RS,1943,1949,6,2688,72.28,72.51,0.22
sidra_9541_PercMoradDPPOColetTot_munic_22_pol.fid-703dc0a5_191866d88cb_-259,4320263,Segredo - RS,2184,2303,119,5999,36.41,38.39,1.98
sidra_9541_PercMoradDPPOColetTot_munic_22_pol.fid-703dc0a5_191866d88cb_-258,4320305,Selbach - RS,4674,4785,111,5082,91.97,94.16,2.18
sidra_9541_PercMoradDPPOColetTot_munic_22_pol.fid-703dc0a5_191866d88cb_-257,4320321,Senador Salgado Filho - RS,1778,1821,43,2667,66.67,68.28,1.61
sidra_9541_PercMoradDPPOColetTot_munic_22_pol.fid-703dc0a5_191866d88cb_-256,4320354,Sentinela do Sul - RS,3797,4623,826,5234,72.54,88.33,15.78
sidra_9541_PercMoradDPPOColetTot_munic_22_pol.fid-703dc0a5_191866d88cb_-255,4320404,Serafina Corrêa - RS,15594,16538,944,16939,92.06,97.63,5.57
sidra_9541_PercMoradDPPOColetTot_munic_22_pol.fid-703dc0a5_191866d88cb_-254,4320453,Sério - RS,1737,1739,2,1941,89.49,89.59,0.1
sidra_9541_PercMoradDPPOColetTot_munic_22_pol.fid-703dc0a5_191866d88cb_-253,4320503,Sertão - RS,3712,3967,255,5523,67.21,71.83,4.62
sidra_9541_PercMoradDPPOColetTot_munic_22_pol.fid-703dc0a5_191866d88cb_-252,4320552,Sertão Santana - RS,4442,5503,1061,5788,76.74,95.08,18.33
sidra_9541_PercMoradDPPOColetTot_munic_22_pol.fid-703dc0a5_191866d88cb_-251,4320578,Sete de Setembro - RS,951,955,4,1805,52.69,52.91,0.22
sidra_9541_PercMoradDPPOColetTot_munic_22_pol.fid-703dc0a5_191866d88cb_-250,4320602,Severiano de Almeida - RS,2287,2998,711,3402,67.23,88.12,20.9
sidra_9541_PercMoradDPPOColetTot_munic_22_pol.fid-703dc0a5_191866d88cb_-24f,4321105,Tapes - RS,12460,14192,1732,14661,84.99,96.8,11.81
sidra_9541_PercMoradDPPOColetTot_munic_22_pol.fid-703dc0a5_191866d88cb_-24e,4321204,Taquara - RS,48355,52075,3720,52661,91.82,98.89,7.06
sidra_9541_PercMoradDPPOColetTot_munic_22_pol.fid-703dc0a5_191866d88cb_-24d,4321303,Taquari - RS,22932,24757,1825,25040,91.58,98.87,7.29
sidra_9541_PercMoradDPPOColetTot_munic_22_pol.fid-703dc0a5_191866d88cb_-24c,4321600,Tramandaí - RS,53250,53741,491,54094,98.44,99.35,0.91
sidra_9541_PercMoradDPPOColetTot_munic_22_pol.fid-703dc0a5_191866d88cb_-24b,4321329,Taquaruçu do Sul - RS,2706,2984,278,3119,86.76,95.67,8.91
sidra_9541_PercMoradDPPOColetTot_munic_22_pol.fid-703dc0a5_191866d88cb_-24a,4321352,Tavares - RS,4279,4557,278,5197,82.34,87.69,5.35
sidra_9541_PercMoradDPPOColetTot_munic_22_pol.fid-703dc0a5_191866d88cb_-249,4321402,Tenente Portela - RS,10105,10548,443,14471,69.83,72.89,3.06
sidra_9541_PercMoradDPPOColetTot_munic_22_pol.fid-703dc0a5_191866d88cb_-248,4322186,Tupanci do Sul - RS,934,1021,87,1371,68.13,74.47,6.35
sidra_9541_PercMoradDPPOColetTot_munic_22_pol.fid-703dc0a5_191866d88cb_-247,4322202,Tupanciretã - RS,15185,16971,1786,19943,76.14,85.1,8.96
sidra_9541_PercMoradDPPOColetTot_munic_22_pol.fid-703dc0a5_191866d88cb_-246,4321436,Terra de Areia - RS,10119,10286,167,10318,98.07,99.69,1.62
sidra_9541_PercMoradDPPOColetTot_munic_22_pol.fid-703dc0a5_191866d88cb_-245,4321626,Travesseiro - RS,2131,2138,7,2148,99.21,99.53,0.33
sidra_9541_PercMoradDPPOColetTot_munic_22_pol.fid-703dc0a5_191866d88cb_-243,4321634,Três Arroios - RS,1977,2125,148,2591,76.3,82.01,5.71
sidra_9541_PercMoradDPPOColetTot_munic_22_pol.fid-703dc0a5_191866d88cb_-242,4321667,Três Cachoeiras - RS,10788,10879,91,10928,98.72,99.55,0.83
sidra_9541_PercMoradDPPOColetTot_munic_22_pol.fid-703dc0a5_191866d88cb_-241,4321709,Três Coroas - RS,22908,24023,1115,24235,94.52,99.13,4.6
sidra_9541_PercMoradDPPOColetTot_munic_22_pol.fid-703dc0a5_191866d88cb_-240,4321808,Três de Maio - RS,22127,22578,451,24824,89.14,90.95,1.82
sidra_9541_PercMoradDPPOColetTot_munic_22_pol.fid-703dc0a5_191866d88cb_-23f,4321832,Três Forquilhas - RS,2708,2714,6,2760,98.12,98.33,0.22
sidra_9541_PercMoradDPPOColetTot_munic_22_pol.fid-703dc0a5_191866d88cb_-23e,4321857,Três Palmeiras - RS,3301,3850,549,4716,70,81.64,11.64
sidra_9541_PercMoradDPPOColetTot_munic_22_pol.fid-703dc0a5_191866d88cb_-23d,4321907,Três Passos - RS,24142,24551,409,24995,96.59,98.22,1.64
sidra_9541_PercMoradDPPOColetTot_munic_22_pol.fid-703dc0a5_191866d88cb_-23c,4322525,Vale Verde - RS,2611,2743,132,3150,82.89,87.08,4.19
sidra_9541_PercMoradDPPOColetTot_munic_22_pol.fid-703dc0a5_191866d88cb_-23b,4321956,Trindade do Sul - RS,6373,6647,274,7548,84.43,88.06,3.63
sidra_9541_PercMoradDPPOColetTot_munic_22_pol.fid-703dc0a5_191866d88cb_-23a,4322855,Vespasiano Corrêa - RS,1674,1690,16,1813,92.33,93.22,0.88
sidra_9541_PercMoradDPPOColetTot_munic_22_pol.fid-703dc0a5_191866d88cb_-239,4322905,Viadutos - RS,4073,4080,7,4769,85.41,85.55,0.15
sidra_9541_PercMoradDPPOColetTot_munic_22_pol.fid-703dc0a5_191866d88cb_-238,4323002,Viamão - RS,212607,220752,8145,223493,95.13,98.77,3.64
sidra_9541_PercMoradDPPOColetTot_munic_22_pol.fid-703dc0a5_191866d88cb_-237,4322004,Triunfo - RS,25368,27089,1721,27295,92.94,99.25,6.31
sidra_9541_PercMoradDPPOColetTot_munic_22_pol.fid-703dc0a5_191866d88cb_-236,4322103,Tucunduva - RS,5107,5161,54,5533,92.3,93.28,0.98
sidra_9541_PercMoradDPPOColetTot_munic_22_pol.fid-703dc0a5_191866d88cb_-235,4322152,Tunas - RS,1564,1599,35,3681,42.49,43.44,0.95
sidra_9541_PercMoradDPPOColetTot_munic_22_pol.fid-703dc0a5_191866d88cb_-234,4322251,Tupandi - RS,2686,5005,2319,5029,53.41,99.52,46.11
sidra_9541_PercMoradDPPOColetTot_munic_22_pol.fid-703dc0a5_191866d88cb_-233,4322301,Tuparendi - RS,6179,6580,401,8351,73.99,78.79,4.8
sidra_9541_PercMoradDPPOColetTot_munic_22_pol.fid-703dc0a5_191866d88cb_-232,4322327,Turuçu - RS,2854,2861,7,3413,83.62,83.83,0.21
sidra_9541_PercMoradDPPOColetTot_munic_22_pol.fid-703dc0a5_191866d88cb_-231,4322343,Ubiretama - RS,584,603,19,1982,29.47,30.42,0.96
sidra_9541_PercMoradDPPOColetTot_munic_22_pol.fid-703dc0a5_191866d88cb_-230,4322350,União da Serra - RS,524,873,349,1170,44.79,74.62,29.83
sidra_9541_PercMoradDPPOColetTot_munic_22_pol.fid-703dc0a5_191866d88cb_-22f,4322376,Unistalda - RS,1263,1425,162,1992,63.4,71.54,8.13
sidra_9541_PercMoradDPPOColetTot_munic_22_pol.fid-703dc0a5_191866d88cb_-22e,4322400,Uruguaiana - RS,110581,112842,2261,116405,95,96.94,1.94
sidra_9541_PercMoradDPPOColetTot_munic_22_pol.fid-703dc0a5_191866d88cb_-22d,4322509,Vacaria - RS,60847,62089,1242,63802,95.37,97.32,1.95
sidra_9541_PercMoradDPPOColetTot_munic_22_pol.fid-703dc0a5_191866d88cb_-22c,4323309,Vila Flores - RS,3344,3551,207,3634,92.02,97.72,5.7
sidra_9541_PercMoradDPPOColetTot_munic_22_pol.fid-703dc0a5_191866d88cb_-22b,4323358,Vila Lângaro - RS,1634,1876,242,2079,78.6,90.24,11.64
sidra_9541_PercMoradDPPOColetTot_munic_22_pol.fid-703dc0a5_191866d88cb_-22a,4322533,Vale do Sol - RS,8873,9072,199,9873,89.87,91.89,2.02
sidra_9541_PercMoradDPPOColetTot_munic_22_pol.fid-703dc0a5_191866d88cb_-229,4322541,Vale Real - RS,6028,6033,5,6057,99.52,99.6,0.08
sidra_9541_PercMoradDPPOColetTot_munic_22_pol.fid-703dc0a5_191866d88cb_-228,4322558,Vanini - RS,1658,1916,258,2004,82.73,95.61,12.87
sidra_9541_PercMoradDPPOColetTot_munic_22_pol.fid-703dc0a5_191866d88cb_-227,4322608,Venâncio Aires - RS,36027,64328,28301,68100,52.9,94.46,41.56
sidra_9541_PercMoradDPPOColetTot_munic_22_pol.fid-703dc0a5_191866d88cb_-226,4322707,Vera Cruz - RS,24619,25939,1320,26613,92.51,97.47,4.96
sidra_9541_PercMoradDPPOColetTot_munic_22_pol.fid-703dc0a5_191866d88cb_-225,4323770,Westfália - RS,3061,3064,3,3094,98.93,99.03,0.1
sidra_9541_PercMoradDPPOColetTot_munic_22_pol.fid-703dc0a5_191866d88cb_-224,4322806,Veranópolis - RS,21024,23752,2728,23961,87.74,99.13,11.39
sidra_9541_PercMoradDPPOColetTot_munic_22_pol.fid-703dc0a5_191866d88cb_-223,4323101,Vicente Dutra - RS,2441,3050,609,4658,52.4,65.48,13.07
sidra_9541_PercMoradDPPOColetTot_munic_22_pol.fid-703dc0a5_191866d88cb_-222,4323200,Victor Graeff - RS,2001,2309,308,2771,72.21,83.33,11.12
sidra_9541_PercMoradDPPOColetTot_munic_22_pol.fid-703dc0a5_191866d88cb_-221,5003454,Deodápolis - MS,12041,12076,35,13657,88.17,88.42,0.26
sidra_9541_PercMoradDPPOColetTot_munic_22_pol.fid-703dc0a5_191866d88cb_-220,5003488,Dois Irmãos do Buriti - MS,6031,6089,58,10623,56.77,57.32,0.55
sidra_9541_PercMoradDPPOColetTot_munic_22_pol.fid-703dc0a5_191866d88cb_-21e,4323408,Vila Maria - RS,1690,4409,2719,4412,38.3,99.93,61.63
sidra_9541_PercMoradDPPOColetTot_munic_22_pol.fid-703dc0a5_191866d88cb_-21d,4323457,Vila Nova do Sul - RS,3174,3192,18,3850,82.44,82.91,0.47
sidra_9541_PercMoradDPPOColetTot_munic_22_pol.fid-703dc0a5_191866d88cb_-21c,4323507,Vista Alegre - RS,1835,1855,20,2659,69.01,69.76,0.75
sidra_9541_PercMoradDPPOColetTot_munic_22_pol.fid-703dc0a5_191866d88cb_-21b,4323606,Vista Alegre do Prata - RS,110,1409,1299,1586,6.94,88.84,81.9
sidra_9541_PercMoradDPPOColetTot_munic_22_pol.fid-703dc0a5_191866d88cb_-21a,5003702,Dourados - MS,219076,226133,7057,241107,90.86,93.79,2.93
sidra_9541_PercMoradDPPOColetTot_munic_22_pol.fid-703dc0a5_191866d88cb_-219,5003751,Eldorado - MS,9785,9932,147,11331,86.36,87.65,1.3
sidra_9541_PercMoradDPPOColetTot_munic_22_pol.fid-703dc0a5_191866d88cb_-218,5003801,Fátima do Sul - MS,19227,19432,205,20563,93.5,94.5,1
sidra_9541_PercMoradDPPOColetTot_munic_22_pol.fid-703dc0a5_191866d88cb_-217,5003900,Figueirão - MS,2056,2376,320,3528,58.28,67.35,9.07
sidra_9541_PercMoradDPPOColetTot_munic_22_pol.fid-703dc0a5_191866d88cb_-216,5004007,Glória de Dourados - MS,8484,8605,121,10414,81.47,82.63,1.16
sidra_9541_PercMoradDPPOColetTot_munic_22_pol.fid-703dc0a5_191866d88cb_-215,5004106,Guia Lopes da Laguna - MS,8493,8550,57,9911,85.69,86.27,0.58
sidra_9541_PercMoradDPPOColetTot_munic_22_pol.fid-703dc0a5_191866d88cb_-214,5004304,Iguatemi - MS,10739,10852,113,13766,78.01,78.83,0.82
sidra_9541_PercMoradDPPOColetTot_munic_22_pol.fid-703dc0a5_191866d88cb_-213,4323705,Vista Gaúcha - RS,1699,1716,17,2783,61.05,61.66,0.61
sidra_9541_PercMoradDPPOColetTot_munic_22_pol.fid-703dc0a5_191866d88cb_-212,4323754,Vitória das Missões - RS,1087,1157,70,3254,33.41,35.56,2.15
sidra_9541_PercMoradDPPOColetTot_munic_22_pol.fid-703dc0a5_191866d88cb_-211,4323804,Xangri-lá - RS,16175,16427,252,16451,98.32,99.85,1.53
sidra_9541_PercMoradDPPOColetTot_munic_22_pol.fid-703dc0a5_191866d88cb_-210,5000203,Água Clara - MS,14288,14699,411,16673,85.7,88.16,2.47
sidra_9541_PercMoradDPPOColetTot_munic_22_pol.fid-703dc0a5_191866d88cb_-20e,5000252,Alcinópolis - MS,3133,3704,571,4522,69.28,81.91,12.63
sidra_9541_PercMoradDPPOColetTot_munic_22_pol.fid-703dc0a5_191866d88cb_-20d,5000609,Amambai - MS,25978,26272,294,39042,66.54,67.29,0.75
sidra_9541_PercMoradDPPOColetTot_munic_22_pol.fid-703dc0a5_191866d88cb_-20b,5000708,Anastácio - MS,20796,20980,184,24093,86.32,87.08,0.76
sidra_9541_PercMoradDPPOColetTot_munic_22_pol.fid-703dc0a5_191866d88cb_-20a,5000807,Anaurilândia - MS,5071,5136,65,7583,66.87,67.73,0.86
sidra_9541_PercMoradDPPOColetTot_munic_22_pol.fid-703dc0a5_191866d88cb_-209,5000856,Angélica - MS,9332,9454,122,10693,87.27,88.41,1.14
sidra_9541_PercMoradDPPOColetTot_munic_22_pol.fid-703dc0a5_191866d88cb_-208,5000906,Antônio João - MS,6607,6839,232,9293,71.1,73.59,2.5
sidra_9541_PercMoradDPPOColetTot_munic_22_pol.fid-703dc0a5_191866d88cb_-207,5001003,Aparecida do Taboado - MS,24925,25472,547,27596,90.32,92.3,1.98
sidra_9541_PercMoradDPPOColetTot_munic_22_pol.fid-703dc0a5_191866d88cb_-206,5001102,Aquidauana - MS,36439,37316,877,46541,78.29,80.18,1.88
sidra_9541_PercMoradDPPOColetTot_munic_22_pol.fid-703dc0a5_191866d88cb_-205,5001243,Aral Moreira - MS,7621,7804,183,10653,71.54,73.26,1.72
sidra_9541_PercMoradDPPOColetTot_munic_22_pol.fid-703dc0a5_191866d88cb_-204,5001508,Bandeirantes - MS,5759,6028,269,7889,73,76.41,3.41
sidra_9541_PercMoradDPPOColetTot_munic_22_pol.fid-703dc0a5_191866d88cb_-203,5001904,Bataguassu - MS,20643,20746,103,22835,90.4,90.85,0.45
sidra_9541_PercMoradDPPOColetTot_munic_22_pol.fid-703dc0a5_191866d88cb_-202,5002001,Batayporã - MS,8618,8744,126,10684,80.66,81.84,1.18
sidra_9541_PercMoradDPPOColetTot_munic_22_pol.fid-703dc0a5_191866d88cb_-201,5002100,Bela Vista - MS,17098,17283,185,21442,79.74,80.6,0.86
sidra_9541_PercMoradDPPOColetTot_munic_22_pol.fid-703dc0a5_191866d88cb_-200,5002159,Bodoquena - MS,6154,6245,91,8520,72.23,73.3,1.07
sidra_9541_PercMoradDPPOColetTot_munic_22_pol.fid-703dc0a5_191866d88cb_-1ff,5002209,Bonito - MS,19477,20864,1387,23415,83.18,89.11,5.92
sidra_9541_PercMoradDPPOColetTot_munic_22_pol.fid-703dc0a5_191866d88cb_-1fe,5002308,Brasilândia - MS,9157,9521,364,11494,79.67,82.83,3.17
sidra_9541_PercMoradDPPOColetTot_munic_22_pol.fid-703dc0a5_191866d88cb_-1fd,5002407,Caarapó - MS,23458,23714,256,30524,76.85,77.69,0.84
sidra_9541_PercMoradDPPOColetTot_munic_22_pol.fid-703dc0a5_191866d88cb_-1fc,5002605,Camapuã - MS,10628,11009,381,13526,78.57,81.39,2.82
sidra_9541_PercMoradDPPOColetTot_munic_22_pol.fid-703dc0a5_191866d88cb_-1fb,5002704,Campo Grande - MS,868866,884311,15445,891135,97.5,99.23,1.73
sidra_9541_PercMoradDPPOColetTot_munic_22_pol.fid-703dc0a5_191866d88cb_-1f9,5002803,Caracol - MS,3528,3637,109,5024,70.22,72.39,2.17
sidra_9541_PercMoradDPPOColetTot_munic_22_pol.fid-703dc0a5_191866d88cb_-1f8,5002902,Cassilândia - MS,18729,19285,556,20756,90.23,92.91,2.68
sidra_9541_PercMoradDPPOColetTot_munic_22_pol.fid-703dc0a5_191866d88cb_-1f6,5002951,Chapadão do Sul - MS,29213,29625,412,30752,95,96.34,1.34
sidra_9541_PercMoradDPPOColetTot_munic_22_pol.fid-703dc0a5_191866d88cb_-1f4,5003108,Corguinho - MS,2746,3154,408,4780,57.45,65.98,8.54
sidra_9541_PercMoradDPPOColetTot_munic_22_pol.fid-703dc0a5_191866d88cb_-1f2,5003157,Coronel Sapucaia - MS,9762,9764,2,14207,68.71,68.73,0.01
sidra_9541_PercMoradDPPOColetTot_munic_22_pol.fid-703dc0a5_191866d88cb_-1f1,5003207,Corumbá - MS,83815,86734,2919,95184,88.06,91.12,3.07
sidra_9541_PercMoradDPPOColetTot_munic_22_pol.fid-703dc0a5_191866d88cb_-1ef,5003256,Costa Rica - MS,23259,25048,1789,25947,89.64,96.54,6.89
sidra_9541_PercMoradDPPOColetTot_munic_22_pol.fid-703dc0a5_191866d88cb_-1ee,5003306,Coxim - MS,29053,29227,174,31940,90.96,91.51,0.54
sidra_9541_PercMoradDPPOColetTot_munic_22_pol.fid-703dc0a5_191866d88cb_-1ec,5003504,Douradina - MS,3773,3849,76,5573,67.7,69.07,1.36
sidra_9541_PercMoradDPPOColetTot_munic_22_pol.fid-703dc0a5_191866d88cb_-1eb,5008404,Vicentina - MS,5149,5159,10,6307,81.64,81.8,0.16
sidra_9541_PercMoradDPPOColetTot_munic_22_pol.fid-703dc0a5_191866d88cb_-1e9,5100102,Acorizal - MT,3544,3712,168,5005,70.81,74.17,3.36
sidra_9541_PercMoradDPPOColetTot_munic_22_pol.fid-703dc0a5_191866d88cb_-1e8,5100201,Água Boa - MT,24589,25123,534,28665,85.78,87.64,1.86
sidra_9541_PercMoradDPPOColetTot_munic_22_pol.fid-703dc0a5_191866d88cb_-1e7,5100250,Alta Floresta - MT,51293,51734,441,58475,87.72,88.47,0.75
sidra_9541_PercMoradDPPOColetTot_munic_22_pol.fid-703dc0a5_191866d88cb_-1e6,5100300,Alto Araguaia - MT,14988,15259,271,17040,87.96,89.55,1.59
sidra_9541_PercMoradDPPOColetTot_munic_22_pol.fid-703dc0a5_191866d88cb_-1e5,5100359,Alto Boa Vista - MT,4239,4267,28,5703,74.33,74.82,0.49
sidra_9541_PercMoradDPPOColetTot_munic_22_pol.fid-703dc0a5_191866d88cb_-1e4,5100409,Alto Garças - MT,12133,12186,53,12979,93.48,93.89,0.41
sidra_9541_PercMoradDPPOColetTot_munic_22_pol.fid-703dc0a5_191866d88cb_-1e3,5100508,Alto Paraguai - MT,5939,5946,7,8004,74.2,74.29,0.09
sidra_9541_PercMoradDPPOColetTot_munic_22_pol.fid-703dc0a5_191866d88cb_-1e2,5100607,Alto Taquari - MT,10255,10305,50,10855,94.47,94.93,0.46
sidra_9541_PercMoradDPPOColetTot_munic_22_pol.fid-703dc0a5_191866d88cb_-1e1,5100805,Apiacás - MT,6233,6261,28,8540,72.99,73.31,0.33
sidra_9541_PercMoradDPPOColetTot_munic_22_pol.fid-703dc0a5_191866d88cb_-1e0,5101001,Araguaiana - MT,2771,2807,36,3795,73.02,73.97,0.95
sidra_9541_PercMoradDPPOColetTot_munic_22_pol.fid-703dc0a5_191866d88cb_-1df,5101209,Araguainha - MT,871,871,,1005,86.67,86.67,
sidra_9541_PercMoradDPPOColetTot_munic_22_pol.fid-703dc0a5_191866d88cb_-1de,5101258,Araputanga - MT,13040,13093,53,14664,88.93,89.29,0.36
sidra_9541_PercMoradDPPOColetTot_munic_22_pol.fid-703dc0a5_191866d88cb_-1dd,5101308,Arenápolis - MT,9626,9760,134,10533,91.39,92.66,1.27
sidra_9541_PercMoradDPPOColetTot_munic_22_pol.fid-703dc0a5_191866d88cb_-1dc,5101407,Aripuanã - MT,17206,17427,221,24340,70.69,71.6,0.91
sidra_9541_PercMoradDPPOColetTot_munic_22_pol.fid-703dc0a5_191866d88cb_-1db,5101605,Barão de Melgaço - MT,3364,3401,37,7235,46.5,47.01,0.51
sidra_9541_PercMoradDPPOColetTot_munic_22_pol.fid-703dc0a5_191866d88cb_-1d9,5101704,Barra do Bugres - MT,26041,26329,288,29255,89.01,90,0.98
sidra_9541_PercMoradDPPOColetTot_munic_22_pol.fid-703dc0a5_191866d88cb_-1d7,5101803,Barra do Garças - MT,62319,63328,1009,69011,90.3,91.77,1.46
sidra_9541_PercMoradDPPOColetTot_munic_22_pol.fid-703dc0a5_191866d88cb_-1d4,5101852,Bom Jesus do Araguaia - MT,4766,4984,218,7230,65.92,68.93,3.02
sidra_9541_PercMoradDPPOColetTot_munic_22_pol.fid-703dc0a5_191866d88cb_-1d2,5101902,Brasnorte - MT,11445,11564,119,16949,67.53,68.23,0.7
sidra_9541_PercMoradDPPOColetTot_munic_22_pol.fid-703dc0a5_191866d88cb_-1d1,5102504,Cáceres - MT,77882,78745,863,89228,87.28,88.25,0.97
sidra_9541_PercMoradDPPOColetTot_munic_22_pol.fid-703dc0a5_191866d88cb_-1d0,5102603,Campinápolis - MT,5721,5776,55,15320,37.34,37.7,0.36
sidra_9541_PercMoradDPPOColetTot_munic_22_pol.fid-703dc0a5_191866d88cb_-1cf,5102637,Campo Novo do Parecis - MT,42716,43817,1101,45382,94.13,96.55,2.43
sidra_9541_PercMoradDPPOColetTot_munic_22_pol.fid-703dc0a5_191866d88cb_-1ce,5102678,Campo Verde - MT,39521,40744,1223,44439,88.93,91.69,2.75
sidra_9541_PercMoradDPPOColetTot_munic_22_pol.fid-703dc0a5_191866d88cb_-1cd,5102686,Campos de Júlio - MT,7438,7529,91,8595,86.54,87.6,1.06
sidra_9541_PercMoradDPPOColetTot_munic_22_pol.fid-703dc0a5_191866d88cb_-1cc,5102694,Canabrava do Norte - MT,3044,3053,9,4461,68.24,68.44,0.2
sidra_9541_PercMoradDPPOColetTot_munic_22_pol.fid-703dc0a5_191866d88cb_-1cb,5102702,Canarana - MT,21327,21591,264,25789,82.7,83.72,1.02
sidra_9541_PercMoradDPPOColetTot_munic_22_pol.fid-703dc0a5_191866d88cb_-1c9,5102793,Carlinda - MT,5680,5875,195,10318,55.05,56.94,1.89
sidra_9541_PercMoradDPPOColetTot_munic_22_pol.fid-703dc0a5_191866d88cb_-1c8,5102850,Castanheira - MT,4027,4064,37,7457,54,54.5,0.5
sidra_9541_PercMoradDPPOColetTot_munic_22_pol.fid-703dc0a5_191866d88cb_-1c7,5103007,Chapada dos Guimarães - MT,12785,13595,810,18911,67.61,71.89,4.28
sidra_9541_PercMoradDPPOColetTot_munic_22_pol.fid-703dc0a5_191866d88cb_-1c5,5103056,Cláudia - MT,7156,7206,50,9586,74.65,75.17,0.52
sidra_9541_PercMoradDPPOColetTot_munic_22_pol.fid-703dc0a5_191866d88cb_-1c4,5103106,Cocalinho - MT,4589,4845,256,6197,74.05,78.18,4.13
sidra_9541_PercMoradDPPOColetTot_munic_22_pol.fid-703dc0a5_191866d88cb_-1c3,5103205,Colíder - MT,25679,25945,266,31222,82.25,83.1,0.85
sidra_9541_PercMoradDPPOColetTot_munic_22_pol.fid-703dc0a5_191866d88cb_-1c2,5103254,Colniza - MT,14756,14933,177,25439,58.01,58.7,0.7
sidra_9541_PercMoradDPPOColetTot_munic_22_pol.fid-703dc0a5_191866d88cb_-1c1,5103304,Comodoro - MT,12617,12767,150,18150,69.52,70.34,0.83
sidra_9541_PercMoradDPPOColetTot_munic_22_pol.fid-703dc0a5_191866d88cb_-1bf,5103353,Confresa - MT,26104,27089,985,34994,74.6,77.41,2.81
sidra_9541_PercMoradDPPOColetTot_munic_22_pol.fid-703dc0a5_191866d88cb_-1be,5103361,Conquista D'Oeste - MT,2483,2561,78,3754,66.14,68.22,2.08
sidra_9541_PercMoradDPPOColetTot_munic_22_pol.fid-703dc0a5_191866d88cb_-1bd,5103379,Cotriguaçu - MT,5718,5817,99,10994,52.01,52.91,0.9
sidra_9541_PercMoradDPPOColetTot_munic_22_pol.fid-703dc0a5_191866d88cb_-1bc,5103403,Cuiabá - MT,609076,631647,22571,646568,94.2,97.69,3.49
sidra_9541_PercMoradDPPOColetTot_munic_22_pol.fid-703dc0a5_191866d88cb_-1ba,5103437,Curvelândia - MT,3597,3618,21,4899,73.42,73.85,0.43
sidra_9541_PercMoradDPPOColetTot_munic_22_pol.fid-703dc0a5_191866d88cb_-1b9,5103452,Denise - MT,6309,6317,8,7013,89.96,90.08,0.11
sidra_9541_PercMoradDPPOColetTot_munic_22_pol.fid-703dc0a5_191866d88cb_-1b8,5103502,Diamantino - MT,18642,19020,378,21790,85.55,87.29,1.73
sidra_9541_PercMoradDPPOColetTot_munic_22_pol.fid-703dc0a5_191866d88cb_-1b7,5103601,Dom Aquino - MT,6282,6386,104,7827,80.26,81.59,1.33
sidra_9541_PercMoradDPPOColetTot_munic_22_pol.fid-703dc0a5_191866d88cb_-1b6,5103700,Feliz Natal - MT,7377,7645,268,10455,70.56,73.12,2.56
sidra_9541_PercMoradDPPOColetTot_munic_22_pol.fid-703dc0a5_191866d88cb_-1b5,5103809,Figueirópolis D'Oeste - MT,2045,2181,136,3174,64.43,68.71,4.28
sidra_9541_PercMoradDPPOColetTot_munic_22_pol.fid-703dc0a5_191866d88cb_-1b4,5103858,Gaúcha do Norte - MT,4490,4743,253,8636,51.99,54.92,2.93
sidra_9541_PercMoradDPPOColetTot_munic_22_pol.fid-703dc0a5_191866d88cb_-1b2,5103908,General Carneiro - MT,2665,2735,70,6004,44.39,45.55,1.17
sidra_9541_PercMoradDPPOColetTot_munic_22_pol.fid-703dc0a5_191866d88cb_-1b1,5103957,Glória D'Oeste - MT,2058,2163,105,2874,71.61,75.26,3.65
sidra_9541_PercMoradDPPOColetTot_munic_22_pol.fid-703dc0a5_191866d88cb_-1b0,5104104,Guarantã do Norte - MT,26318,26392,74,30993,84.92,85.15,0.24
sidra_9541_PercMoradDPPOColetTot_munic_22_pol.fid-703dc0a5_191866d88cb_-1af,5104203,Guiratinga - MT,9075,9230,155,10769,84.27,85.71,1.44
sidra_9541_PercMoradDPPOColetTot_munic_22_pol.fid-703dc0a5_191866d88cb_-1ae,5104500,Indiavaí - MT,1637,1660,23,2200,74.41,75.45,1.05
sidra_9541_PercMoradDPPOColetTot_munic_22_pol.fid-703dc0a5_191866d88cb_-1ad,5104526,Ipiranga do Norte - MT,6107,6178,71,7638,79.96,80.89,0.93
sidra_9541_PercMoradDPPOColetTot_munic_22_pol.fid-703dc0a5_191866d88cb_-1ac,5104542,Itanhangá - MT,5595,5755,160,7490,74.7,76.84,2.14
